season_day,dteday,hour,casual_hour,registered_hour,count_hour,count_day,time_group
springer,2011-01-01,0,3,13,16,985,
springer,2011-01-01,1,8,32,40,985,01:00 - 02:59
springer,2011-01-01,2,5,27,32,985,01:00 - 02:59
springer,2011-01-01,3,3,10,13,985,03:00 - 04:59
springer,2011-01-01,4,0,1,1,985,03:00 - 04:59
springer,2011-01-01,5,0,1,1,985,05:00 - 06:59
springer,2011-01-01,6,2,0,2,985,05:00 - 06:59
springer,2011-01-01,7,1,2,3,985,07:00 - 08:59
springer,2011-01-01,8,1,7,8,985,07:00 - 08:59
springer,2011-01-01,9,8,6,14,985,09:00 - 10:59
springer,2011-01-01,10,12,24,36,985,09:00 - 10:59
springer,2011-01-01,11,26,30,56,985,11:00 - 12:59
springer,2011-01-01,12,29,55,84,985,11:00 - 12:59
springer,2011-01-01,13,47,47,94,985,13:00 - 14:59
springer,2011-01-01,14,35,71,106,985,13:00 - 14:59
springer,2011-01-01,15,40,70,110,985,15:00 - 16:59
springer,2011-01-01,16,41,52,93,985,15:00 - 16:59
springer,2011-01-01,17,15,52,67,985,17:00 - 18:59
springer,2011-01-01,18,9,26,35,985,17:00 - 18:59
springer,2011-01-01,19,6,31,37,985,19:00 - 20:59
springer,2011-01-01,20,11,25,36,985,19:00 - 20:59
springer,2011-01-01,21,3,31,34,985,21:00 - 22:59
springer,2011-01-01,22,11,17,28,985,21:00 - 22:59
springer,2011-01-01,23,15,24,39,985,23:00 - 24:59
springer,2011-01-02,0,4,13,17,801,
springer,2011-01-02,1,1,16,17,801,01:00 - 02:59
springer,2011-01-02,2,1,8,9,801,01:00 - 02:59
springer,2011-01-02,3,2,4,6,801,03:00 - 04:59
springer,2011-01-02,4,2,1,3,801,03:00 - 04:59
springer,2011-01-02,6,0,2,2,801,05:00 - 06:59
springer,2011-01-02,7,0,1,1,801,07:00 - 08:59
springer,2011-01-02,8,0,8,8,801,07:00 - 08:59
springer,2011-01-02,9,1,19,20,801,09:00 - 10:59
springer,2011-01-02,10,7,46,53,801,09:00 - 10:59
springer,2011-01-02,11,16,54,70,801,11:00 - 12:59
springer,2011-01-02,12,20,73,93,801,11:00 - 12:59
springer,2011-01-02,13,11,64,75,801,13:00 - 14:59
springer,2011-01-02,14,4,55,59,801,13:00 - 14:59
springer,2011-01-02,15,19,55,74,801,15:00 - 16:59
springer,2011-01-02,16,9,67,76,801,15:00 - 16:59
springer,2011-01-02,17,7,58,65,801,17:00 - 18:59
springer,2011-01-02,18,10,43,53,801,17:00 - 18:59
springer,2011-01-02,19,1,29,30,801,19:00 - 20:59
springer,2011-01-02,20,5,17,22,801,19:00 - 20:59
springer,2011-01-02,21,11,20,31,801,21:00 - 22:59
springer,2011-01-02,22,0,9,9,801,21:00 - 22:59
springer,2011-01-02,23,0,8,8,801,23:00 - 24:59
springer,2011-01-03,0,0,5,5,1349,
springer,2011-01-03,1,0,2,2,1349,01:00 - 02:59
springer,2011-01-03,4,0,1,1,1349,03:00 - 04:59
springer,2011-01-03,5,0,3,3,1349,05:00 - 06:59
springer,2011-01-03,6,0,30,30,1349,05:00 - 06:59
springer,2011-01-03,7,1,63,64,1349,07:00 - 08:59
springer,2011-01-03,8,1,153,154,1349,07:00 - 08:59
springer,2011-01-03,9,7,81,88,1349,09:00 - 10:59
springer,2011-01-03,10,11,33,44,1349,09:00 - 10:59
springer,2011-01-03,11,10,41,51,1349,11:00 - 12:59
springer,2011-01-03,12,13,48,61,1349,11:00 - 12:59
springer,2011-01-03,13,8,53,61,1349,13:00 - 14:59
springer,2011-01-03,14,11,66,77,1349,13:00 - 14:59
springer,2011-01-03,15,14,58,72,1349,15:00 - 16:59
springer,2011-01-03,16,9,67,76,1349,15:00 - 16:59
springer,2011-01-03,17,11,146,157,1349,17:00 - 18:59
springer,2011-01-03,18,9,148,157,1349,17:00 - 18:59
springer,2011-01-03,19,8,102,110,1349,19:00 - 20:59
springer,2011-01-03,20,3,49,52,1349,19:00 - 20:59
springer,2011-01-03,21,3,49,52,1349,21:00 - 22:59
springer,2011-01-03,22,0,20,20,1349,21:00 - 22:59
springer,2011-01-03,23,1,11,12,1349,23:00 - 24:59
springer,2011-01-04,0,0,5,5,1562,
springer,2011-01-04,1,0,2,2,1562,01:00 - 02:59
springer,2011-01-04,2,0,1,1,1562,01:00 - 02:59
springer,2011-01-04,4,0,2,2,1562,03:00 - 04:59
springer,2011-01-04,5,0,4,4,1562,05:00 - 06:59
springer,2011-01-04,6,0,36,36,1562,05:00 - 06:59
springer,2011-01-04,7,2,92,94,1562,07:00 - 08:59
springer,2011-01-04,8,2,177,179,1562,07:00 - 08:59
springer,2011-01-04,9,2,98,100,1562,09:00 - 10:59
springer,2011-01-04,10,5,37,42,1562,09:00 - 10:59
springer,2011-01-04,11,7,50,57,1562,11:00 - 12:59
springer,2011-01-04,12,12,66,78,1562,11:00 - 12:59
springer,2011-01-04,13,18,79,97,1562,13:00 - 14:59
springer,2011-01-04,14,9,54,63,1562,13:00 - 14:59
springer,2011-01-04,15,17,48,65,1562,15:00 - 16:59
springer,2011-01-04,16,15,68,83,1562,15:00 - 16:59
springer,2011-01-04,17,10,202,212,1562,17:00 - 18:59
springer,2011-01-04,18,3,179,182,1562,17:00 - 18:59
springer,2011-01-04,19,2,110,112,1562,19:00 - 20:59
springer,2011-01-04,20,1,53,54,1562,19:00 - 20:59
springer,2011-01-04,21,0,48,48,1562,21:00 - 22:59
springer,2011-01-04,22,1,34,35,1562,21:00 - 22:59
springer,2011-01-04,23,2,9,11,1562,23:00 - 24:59
springer,2011-01-05,0,0,6,6,1600,
springer,2011-01-05,1,0,6,6,1600,01:00 - 02:59
springer,2011-01-05,2,0,2,2,1600,01:00 - 02:59
springer,2011-01-05,4,0,2,2,1600,03:00 - 04:59
springer,2011-01-05,5,0,3,3,1600,05:00 - 06:59
springer,2011-01-05,6,0,33,33,1600,05:00 - 06:59
springer,2011-01-05,7,1,87,88,1600,07:00 - 08:59
springer,2011-01-05,8,3,192,195,1600,07:00 - 08:59
springer,2011-01-05,9,6,109,115,1600,09:00 - 10:59
springer,2011-01-05,10,4,53,57,1600,09:00 - 10:59
springer,2011-01-05,11,12,34,46,1600,11:00 - 12:59
springer,2011-01-05,12,5,74,79,1600,11:00 - 12:59
springer,2011-01-05,13,6,65,71,1600,13:00 - 14:59
springer,2011-01-05,14,10,52,62,1600,13:00 - 14:59
springer,2011-01-05,15,7,55,62,1600,15:00 - 16:59
springer,2011-01-05,16,4,85,89,1600,15:00 - 16:59
springer,2011-01-05,17,4,186,190,1600,17:00 - 18:59
springer,2011-01-05,18,3,166,169,1600,17:00 - 18:59
springer,2011-01-05,19,5,127,132,1600,19:00 - 20:59
springer,2011-01-05,20,7,82,89,1600,19:00 - 20:59
springer,2011-01-05,21,3,40,43,1600,21:00 - 22:59
springer,2011-01-05,22,1,41,42,1600,21:00 - 22:59
springer,2011-01-05,23,1,18,19,1600,23:00 - 24:59
springer,2011-01-06,0,0,11,11,1606,
springer,2011-01-06,1,0,4,4,1606,01:00 - 02:59
springer,2011-01-06,2,0,2,2,1606,01:00 - 02:59
springer,2011-01-06,4,0,1,1,1606,03:00 - 04:59
springer,2011-01-06,5,0,4,4,1606,05:00 - 06:59
springer,2011-01-06,6,0,36,36,1606,05:00 - 06:59
springer,2011-01-06,7,0,95,95,1606,07:00 - 08:59
springer,2011-01-06,8,3,216,219,1606,07:00 - 08:59
springer,2011-01-06,9,6,116,122,1606,09:00 - 10:59
springer,2011-01-06,10,3,42,45,1606,09:00 - 10:59
springer,2011-01-06,11,2,57,59,1606,11:00 - 12:59
springer,2011-01-06,12,6,78,84,1606,11:00 - 12:59
springer,2011-01-06,13,12,55,67,1606,13:00 - 14:59
springer,2011-01-06,14,11,59,70,1606,13:00 - 14:59
springer,2011-01-06,15,8,54,62,1606,15:00 - 16:59
springer,2011-01-06,16,12,74,86,1606,15:00 - 16:59
springer,2011-01-06,17,9,163,172,1606,17:00 - 18:59
springer,2011-01-06,18,5,158,163,1606,17:00 - 18:59
springer,2011-01-06,19,3,109,112,1606,19:00 - 20:59
springer,2011-01-06,20,3,66,69,1606,19:00 - 20:59
springer,2011-01-06,21,0,48,48,1606,21:00 - 22:59
springer,2011-01-06,22,1,51,52,1606,21:00 - 22:59
springer,2011-01-06,23,4,19,23,1606,23:00 - 24:59
springer,2011-01-07,0,4,13,17,1510,
springer,2011-01-07,1,2,5,7,1510,01:00 - 02:59
springer,2011-01-07,2,0,1,1,1510,01:00 - 02:59
springer,2011-01-07,4,0,1,1,1510,03:00 - 04:59
springer,2011-01-07,5,0,5,5,1510,05:00 - 06:59
springer,2011-01-07,6,8,26,34,1510,05:00 - 06:59
springer,2011-01-07,7,8,76,84,1510,07:00 - 08:59
springer,2011-01-07,8,20,190,210,1510,07:00 - 08:59
springer,2011-01-07,9,9,125,134,1510,09:00 - 10:59
springer,2011-01-07,10,16,47,63,1510,09:00 - 10:59
springer,2011-01-07,11,19,48,67,1510,11:00 - 12:59
springer,2011-01-07,12,9,50,59,1510,11:00 - 12:59
springer,2011-01-07,13,9,64,73,1510,13:00 - 14:59
springer,2011-01-07,14,7,43,50,1510,13:00 - 14:59
springer,2011-01-07,15,9,63,72,1510,15:00 - 16:59
springer,2011-01-07,16,5,82,87,1510,15:00 - 16:59
springer,2011-01-07,17,9,178,187,1510,17:00 - 18:59
springer,2011-01-07,18,7,116,123,1510,17:00 - 18:59
springer,2011-01-07,19,3,92,95,1510,19:00 - 20:59
springer,2011-01-07,20,1,50,51,1510,19:00 - 20:59
springer,2011-01-07,21,0,39,39,1510,21:00 - 22:59
springer,2011-01-07,22,2,34,36,1510,21:00 - 22:59
springer,2011-01-07,23,1,14,15,1510,23:00 - 24:59
springer,2011-01-08,0,1,24,25,959,
springer,2011-01-08,1,1,15,16,959,01:00 - 02:59
springer,2011-01-08,2,3,13,16,959,01:00 - 02:59
springer,2011-01-08,3,0,7,7,959,03:00 - 04:59
springer,2011-01-08,4,0,1,1,959,03:00 - 04:59
springer,2011-01-08,5,0,5,5,959,05:00 - 06:59
springer,2011-01-08,6,0,2,2,959,05:00 - 06:59
springer,2011-01-08,7,1,8,9,959,07:00 - 08:59
springer,2011-01-08,8,0,15,15,959,07:00 - 08:59
springer,2011-01-08,9,0,20,20,959,09:00 - 10:59
springer,2011-01-08,10,5,56,61,959,09:00 - 10:59
springer,2011-01-08,11,2,60,62,959,11:00 - 12:59
springer,2011-01-08,12,8,90,98,959,11:00 - 12:59
springer,2011-01-08,13,7,95,102,959,13:00 - 14:59
springer,2011-01-08,14,12,83,95,959,13:00 - 14:59
springer,2011-01-08,15,5,69,74,959,15:00 - 16:59
springer,2011-01-08,16,8,68,76,959,15:00 - 16:59
springer,2011-01-08,17,5,64,69,959,17:00 - 18:59
springer,2011-01-08,18,3,52,55,959,17:00 - 18:59
springer,2011-01-08,19,4,26,30,959,19:00 - 20:59
springer,2011-01-08,20,0,28,28,959,19:00 - 20:59
springer,2011-01-08,21,2,35,37,959,21:00 - 22:59
springer,2011-01-08,22,1,33,34,959,21:00 - 22:59
springer,2011-01-08,23,0,22,22,959,23:00 - 24:59
springer,2011-01-09,0,1,24,25,822,
springer,2011-01-09,1,0,12,12,822,01:00 - 02:59
springer,2011-01-09,2,0,11,11,822,01:00 - 02:59
springer,2011-01-09,3,0,4,4,822,03:00 - 04:59
springer,2011-01-09,4,0,1,1,822,03:00 - 04:59
springer,2011-01-09,5,0,1,1,822,05:00 - 06:59
springer,2011-01-09,6,0,1,1,822,05:00 - 06:59
springer,2011-01-09,7,1,5,6,822,07:00 - 08:59
springer,2011-01-09,8,0,10,10,822,07:00 - 08:59
springer,2011-01-09,9,0,19,19,822,09:00 - 10:59
springer,2011-01-09,10,0,49,49,822,09:00 - 10:59
springer,2011-01-09,11,2,47,49,822,11:00 - 12:59
springer,2011-01-09,12,4,79,83,822,11:00 - 12:59
springer,2011-01-09,13,6,69,75,822,13:00 - 14:59
springer,2011-01-09,14,8,64,72,822,13:00 - 14:59
springer,2011-01-09,15,5,77,82,822,15:00 - 16:59
springer,2011-01-09,16,13,79,92,822,15:00 - 16:59
springer,2011-01-09,17,3,59,62,822,17:00 - 18:59
springer,2011-01-09,18,4,44,48,822,17:00 - 18:59
springer,2011-01-09,19,1,40,41,822,19:00 - 20:59
springer,2011-01-09,20,0,38,38,822,19:00 - 20:59
springer,2011-01-09,21,1,19,20,822,21:00 - 22:59
springer,2011-01-09,22,5,10,15,822,21:00 - 22:59
springer,2011-01-09,23,0,6,6,822,23:00 - 24:59
springer,2011-01-10,0,2,3,5,1321,
springer,2011-01-10,1,1,0,1,1321,01:00 - 02:59
springer,2011-01-10,2,0,3,3,1321,01:00 - 02:59
springer,2011-01-10,3,0,1,1,1321,03:00 - 04:59
springer,2011-01-10,4,1,2,3,1321,03:00 - 04:59
springer,2011-01-10,5,0,3,3,1321,05:00 - 06:59
springer,2011-01-10,6,0,31,31,1321,05:00 - 06:59
springer,2011-01-10,7,2,75,77,1321,07:00 - 08:59
springer,2011-01-10,8,4,184,188,1321,07:00 - 08:59
springer,2011-01-10,9,2,92,94,1321,09:00 - 10:59
springer,2011-01-10,10,0,31,31,1321,09:00 - 10:59
springer,2011-01-10,11,2,28,30,1321,11:00 - 12:59
springer,2011-01-10,12,5,47,52,1321,11:00 - 12:59
springer,2011-01-10,13,4,50,54,1321,13:00 - 14:59
springer,2011-01-10,14,0,47,47,1321,13:00 - 14:59
springer,2011-01-10,15,2,43,45,1321,15:00 - 16:59
springer,2011-01-10,16,4,70,74,1321,15:00 - 16:59
springer,2011-01-10,17,4,174,178,1321,17:00 - 18:59
springer,2011-01-10,18,1,154,155,1321,17:00 - 18:59
springer,2011-01-10,19,3,92,95,1321,19:00 - 20:59
springer,2011-01-10,20,1,73,74,1321,19:00 - 20:59
springer,2011-01-10,21,1,37,38,1321,21:00 - 22:59
springer,2011-01-10,22,2,22,24,1321,21:00 - 22:59
springer,2011-01-10,23,0,18,18,1321,23:00 - 24:59
springer,2011-01-11,0,2,10,12,1263,
springer,2011-01-11,1,0,3,3,1263,01:00 - 02:59
springer,2011-01-11,2,0,3,3,1263,01:00 - 02:59
springer,2011-01-11,5,0,6,6,1263,05:00 - 06:59
springer,2011-01-11,6,0,27,27,1263,05:00 - 06:59
springer,2011-01-11,7,2,97,99,1263,07:00 - 08:59
springer,2011-01-11,8,3,214,217,1263,07:00 - 08:59
springer,2011-01-11,9,3,127,130,1263,09:00 - 10:59
springer,2011-01-11,10,3,51,54,1263,09:00 - 10:59
springer,2011-01-11,11,4,31,35,1263,11:00 - 12:59
springer,2011-01-11,12,2,55,57,1263,11:00 - 12:59
springer,2011-01-11,13,6,46,52,1263,13:00 - 14:59
springer,2011-01-11,14,3,60,63,1263,13:00 - 14:59
springer,2011-01-11,15,2,45,47,1263,15:00 - 16:59
springer,2011-01-11,16,4,72,76,1263,15:00 - 16:59
springer,2011-01-11,17,6,130,136,1263,17:00 - 18:59
springer,2011-01-11,18,1,94,95,1263,17:00 - 18:59
springer,2011-01-11,19,0,51,51,1263,19:00 - 20:59
springer,2011-01-11,20,0,32,32,1263,19:00 - 20:59
springer,2011-01-11,21,0,20,20,1263,21:00 - 22:59
springer,2011-01-11,22,1,28,29,1263,21:00 - 22:59
springer,2011-01-11,23,1,18,19,1263,23:00 - 24:59
springer,2011-01-12,0,0,7,7,1162,
springer,2011-01-12,1,0,6,6,1162,01:00 - 02:59
springer,2011-01-12,2,0,1,1,1162,01:00 - 02:59
springer,2011-01-12,5,0,5,5,1162,05:00 - 06:59
springer,2011-01-12,6,0,16,16,1162,05:00 - 06:59
springer,2011-01-12,7,0,54,54,1162,07:00 - 08:59
springer,2011-01-12,8,3,125,128,1162,07:00 - 08:59
springer,2011-01-12,9,3,78,81,1162,09:00 - 10:59
springer,2011-01-12,10,0,39,39,1162,09:00 - 10:59
springer,2011-01-12,11,3,32,35,1162,11:00 - 12:59
springer,2011-01-12,12,3,52,55,1162,11:00 - 12:59
springer,2011-01-12,13,0,49,49,1162,13:00 - 14:59
springer,2011-01-12,14,0,44,44,1162,13:00 - 14:59
springer,2011-01-12,15,1,48,49,1162,15:00 - 16:59
springer,2011-01-12,16,5,63,68,1162,15:00 - 16:59
springer,2011-01-12,17,0,139,139,1162,17:00 - 18:59
springer,2011-01-12,18,2,135,137,1162,17:00 - 18:59
springer,2011-01-12,19,1,82,83,1162,19:00 - 20:59
springer,2011-01-12,20,2,54,56,1162,19:00 - 20:59
springer,2011-01-12,21,0,57,57,1162,21:00 - 22:59
springer,2011-01-12,22,1,32,33,1162,21:00 - 22:59
springer,2011-01-12,23,1,19,20,1162,23:00 - 24:59
springer,2011-01-13,0,1,6,7,1406,
springer,2011-01-13,1,0,2,2,1406,01:00 - 02:59
springer,2011-01-13,2,0,2,2,1406,01:00 - 02:59
springer,2011-01-13,3,0,3,3,1406,03:00 - 04:59
springer,2011-01-13,4,0,4,4,1406,03:00 - 04:59
springer,2011-01-13,5,0,3,3,1406,05:00 - 06:59
springer,2011-01-13,6,0,28,28,1406,05:00 - 06:59
springer,2011-01-13,7,0,72,72,1406,07:00 - 08:59
springer,2011-01-13,8,5,197,202,1406,07:00 - 08:59
springer,2011-01-13,9,2,137,139,1406,09:00 - 10:59
springer,2011-01-13,10,2,36,38,1406,09:00 - 10:59
springer,2011-01-13,11,4,33,37,1406,11:00 - 12:59
springer,2011-01-13,12,3,49,52,1406,11:00 - 12:59
springer,2011-01-13,13,2,81,83,1406,13:00 - 14:59
springer,2011-01-13,14,3,39,42,1406,13:00 - 14:59
springer,2011-01-13,15,5,55,60,1406,15:00 - 16:59
springer,2011-01-13,16,2,76,78,1406,15:00 - 16:59
springer,2011-01-13,17,4,158,162,1406,17:00 - 18:59
springer,2011-01-13,18,3,141,144,1406,17:00 - 18:59
springer,2011-01-13,19,1,98,99,1406,19:00 - 20:59
springer,2011-01-13,20,0,64,64,1406,19:00 - 20:59
springer,2011-01-13,21,0,40,40,1406,21:00 - 22:59
springer,2011-01-13,22,0,30,30,1406,21:00 - 22:59
springer,2011-01-13,23,1,14,15,1406,23:00 - 24:59
springer,2011-01-14,0,0,14,14,1421,
springer,2011-01-14,1,0,5,5,1421,01:00 - 02:59
springer,2011-01-14,2,0,1,1,1421,01:00 - 02:59
springer,2011-01-14,3,0,1,1,1421,03:00 - 04:59
springer,2011-01-14,5,0,8,8,1421,05:00 - 06:59
springer,2011-01-14,6,0,17,17,1421,05:00 - 06:59
springer,2011-01-14,7,0,70,70,1421,07:00 - 08:59
springer,2011-01-14,8,2,156,158,1421,07:00 - 08:59
springer,2011-01-14,9,0,117,117,1421,09:00 - 10:59
springer,2011-01-14,10,4,40,44,1421,09:00 - 10:59
springer,2011-01-14,11,6,47,53,1421,11:00 - 12:59
springer,2011-01-14,12,2,59,61,1421,11:00 - 12:59
springer,2011-01-14,13,4,73,77,1421,13:00 - 14:59
springer,2011-01-14,14,5,59,64,1421,13:00 - 14:59
springer,2011-01-14,15,9,59,68,1421,15:00 - 16:59
springer,2011-01-14,16,3,87,90,1421,15:00 - 16:59
springer,2011-01-14,17,4,155,159,1421,17:00 - 18:59
springer,2011-01-14,18,5,134,139,1421,17:00 - 18:59
springer,2011-01-14,19,3,89,92,1421,19:00 - 20:59
springer,2011-01-14,20,0,68,68,1421,19:00 - 20:59
springer,2011-01-14,21,4,48,52,1421,21:00 - 22:59
springer,2011-01-14,22,2,34,36,1421,21:00 - 22:59
springer,2011-01-14,23,1,26,27,1421,23:00 - 24:59
springer,2011-01-15,0,3,25,28,1248,
springer,2011-01-15,1,2,18,20,1248,01:00 - 02:59
springer,2011-01-15,2,0,12,12,1248,01:00 - 02:59
springer,2011-01-15,3,1,7,8,1248,03:00 - 04:59
springer,2011-01-15,4,0,5,5,1248,03:00 - 04:59
springer,2011-01-15,5,0,1,1,1248,05:00 - 06:59
springer,2011-01-15,6,1,2,3,1248,05:00 - 06:59
springer,2011-01-15,7,1,9,10,1248,07:00 - 08:59
springer,2011-01-15,8,1,22,23,1248,07:00 - 08:59
springer,2011-01-15,9,2,31,33,1248,09:00 - 10:59
springer,2011-01-15,10,2,57,59,1248,09:00 - 10:59
springer,2011-01-15,11,18,54,72,1248,11:00 - 12:59
springer,2011-01-15,12,15,74,89,1248,11:00 - 12:59
springer,2011-01-15,13,21,80,101,1248,13:00 - 14:59
springer,2011-01-15,14,26,92,118,1248,13:00 - 14:59
springer,2011-01-15,15,21,108,129,1248,15:00 - 16:59
springer,2011-01-15,16,33,95,128,1248,15:00 - 16:59
springer,2011-01-15,17,29,54,83,1248,17:00 - 18:59
springer,2011-01-15,18,15,69,84,1248,17:00 - 18:59
springer,2011-01-15,19,14,60,74,1248,19:00 - 20:59
springer,2011-01-15,20,6,35,41,1248,19:00 - 20:59
springer,2011-01-15,21,6,51,57,1248,21:00 - 22:59
springer,2011-01-15,22,0,26,26,1248,21:00 - 22:59
springer,2011-01-15,23,5,39,44,1248,23:00 - 24:59
springer,2011-01-16,0,6,33,39,1204,
springer,2011-01-16,1,4,19,23,1204,01:00 - 02:59
springer,2011-01-16,2,3,13,16,1204,01:00 - 02:59
springer,2011-01-16,3,9,6,15,1204,03:00 - 04:59
springer,2011-01-16,4,0,1,1,1204,03:00 - 04:59
springer,2011-01-16,5,1,1,2,1204,05:00 - 06:59
springer,2011-01-16,6,0,1,1,1204,05:00 - 06:59
springer,2011-01-16,7,0,3,3,1204,07:00 - 08:59
springer,2011-01-16,8,0,18,18,1204,07:00 - 08:59
springer,2011-01-16,9,3,29,32,1204,09:00 - 10:59
springer,2011-01-16,10,8,71,79,1204,09:00 - 10:59
springer,2011-01-16,11,23,70,93,1204,11:00 - 12:59
springer,2011-01-16,12,29,75,104,1204,11:00 - 12:59
springer,2011-01-16,13,23,95,118,1204,13:00 - 14:59
springer,2011-01-16,14,22,69,91,1204,13:00 - 14:59
springer,2011-01-16,15,35,78,113,1204,15:00 - 16:59
springer,2011-01-16,16,22,77,99,1204,15:00 - 16:59
springer,2011-01-16,17,23,82,105,1204,17:00 - 18:59
springer,2011-01-16,18,11,56,67,1204,17:00 - 18:59
springer,2011-01-16,19,14,47,61,1204,19:00 - 20:59
springer,2011-01-16,20,7,50,57,1204,19:00 - 20:59
springer,2011-01-16,21,6,22,28,1204,21:00 - 22:59
springer,2011-01-16,22,2,19,21,1204,21:00 - 22:59
springer,2011-01-16,23,0,18,18,1204,23:00 - 24:59
springer,2011-01-17,0,1,16,17,1000,
springer,2011-01-17,1,1,15,16,1000,01:00 - 02:59
springer,2011-01-17,2,0,8,8,1000,01:00 - 02:59
springer,2011-01-17,3,0,2,2,1000,03:00 - 04:59
springer,2011-01-17,4,1,2,3,1000,03:00 - 04:59
springer,2011-01-17,5,0,1,1,1000,05:00 - 06:59
springer,2011-01-17,6,0,5,5,1000,05:00 - 06:59
springer,2011-01-17,7,4,9,13,1000,07:00 - 08:59
springer,2011-01-17,8,3,30,33,1000,07:00 - 08:59
springer,2011-01-17,9,8,39,47,1000,09:00 - 10:59
springer,2011-01-17,10,7,50,57,1000,09:00 - 10:59
springer,2011-01-17,11,9,55,64,1000,11:00 - 12:59
springer,2011-01-17,12,10,70,80,1000,11:00 - 12:59
springer,2011-01-17,13,13,80,93,1000,13:00 - 14:59
springer,2011-01-17,14,12,74,86,1000,13:00 - 14:59
springer,2011-01-17,15,21,72,93,1000,15:00 - 16:59
springer,2011-01-17,16,6,76,82,1000,15:00 - 16:59
springer,2011-01-17,17,4,67,71,1000,17:00 - 18:59
springer,2011-01-17,18,7,85,92,1000,17:00 - 18:59
springer,2011-01-17,19,2,58,60,1000,19:00 - 20:59
springer,2011-01-17,20,4,29,33,1000,19:00 - 20:59
springer,2011-01-17,21,3,24,27,1000,21:00 - 22:59
springer,2011-01-17,22,0,13,13,1000,21:00 - 22:59
springer,2011-01-17,23,1,3,4,1000,23:00 - 24:59
springer,2011-01-18,12,0,3,3,683,11:00 - 12:59
springer,2011-01-18,13,0,22,22,683,13:00 - 14:59
springer,2011-01-18,14,2,26,28,683,13:00 - 14:59
springer,2011-01-18,15,3,32,35,683,15:00 - 16:59
springer,2011-01-18,16,0,61,61,683,15:00 - 16:59
springer,2011-01-18,17,1,124,125,683,17:00 - 18:59
springer,2011-01-18,18,1,132,133,683,17:00 - 18:59
springer,2011-01-18,19,1,98,99,683,19:00 - 20:59
springer,2011-01-18,20,0,83,83,683,19:00 - 20:59
springer,2011-01-18,21,0,41,41,683,21:00 - 22:59
springer,2011-01-18,22,0,33,33,683,21:00 - 22:59
springer,2011-01-18,23,1,19,20,683,23:00 - 24:59
springer,2011-01-19,0,0,3,3,1650,
springer,2011-01-19,1,1,6,7,1650,01:00 - 02:59
springer,2011-01-19,2,0,3,3,1650,01:00 - 02:59
springer,2011-01-19,4,1,1,2,1650,03:00 - 04:59
springer,2011-01-19,5,0,7,7,1650,05:00 - 06:59
springer,2011-01-19,6,0,32,32,1650,05:00 - 06:59
springer,2011-01-19,7,1,89,90,1650,07:00 - 08:59
springer,2011-01-19,8,1,196,197,1650,07:00 - 08:59
springer,2011-01-19,9,2,107,109,1650,09:00 - 10:59
springer,2011-01-19,10,1,46,47,1650,09:00 - 10:59
springer,2011-01-19,11,5,47,52,1650,11:00 - 12:59
springer,2011-01-19,12,5,65,70,1650,11:00 - 12:59
springer,2011-01-19,13,11,67,78,1650,13:00 - 14:59
springer,2011-01-19,14,7,68,75,1650,13:00 - 14:59
springer,2011-01-19,15,4,78,82,1650,15:00 - 16:59
springer,2011-01-19,16,10,94,104,1650,15:00 - 16:59
springer,2011-01-19,17,7,190,197,1650,17:00 - 18:59
springer,2011-01-19,18,5,156,161,1650,17:00 - 18:59
springer,2011-01-19,19,4,108,112,1650,19:00 - 20:59
springer,2011-01-19,20,2,74,76,1650,19:00 - 20:59
springer,2011-01-19,21,4,55,59,1650,21:00 - 22:59
springer,2011-01-19,22,6,53,59,1650,21:00 - 22:59
springer,2011-01-19,23,1,27,28,1650,23:00 - 24:59
springer,2011-01-20,0,5,8,13,1927,
springer,2011-01-20,1,2,3,5,1927,01:00 - 02:59
springer,2011-01-20,2,0,2,2,1927,01:00 - 02:59
springer,2011-01-20,3,0,1,1,1927,03:00 - 04:59
springer,2011-01-20,4,0,1,1,1927,03:00 - 04:59
springer,2011-01-20,5,0,6,6,1927,05:00 - 06:59
springer,2011-01-20,6,0,35,35,1927,05:00 - 06:59
springer,2011-01-20,7,1,100,101,1927,07:00 - 08:59
springer,2011-01-20,8,2,247,249,1927,07:00 - 08:59
springer,2011-01-20,9,3,140,143,1927,09:00 - 10:59
springer,2011-01-20,10,1,56,57,1927,09:00 - 10:59
springer,2011-01-20,11,5,63,68,1927,11:00 - 12:59
springer,2011-01-20,12,7,77,84,1927,11:00 - 12:59
springer,2011-01-20,13,12,86,98,1927,13:00 - 14:59
springer,2011-01-20,14,6,75,81,1927,13:00 - 14:59
springer,2011-01-20,15,8,62,70,1927,15:00 - 16:59
springer,2011-01-20,16,8,83,91,1927,15:00 - 16:59
springer,2011-01-20,17,8,207,215,1927,17:00 - 18:59
springer,2011-01-20,18,1,184,185,1927,17:00 - 18:59
springer,2011-01-20,19,6,146,152,1927,19:00 - 20:59
springer,2011-01-20,20,2,124,126,1927,19:00 - 20:59
springer,2011-01-20,21,3,54,57,1927,21:00 - 22:59
springer,2011-01-20,22,0,56,56,1927,21:00 - 22:59
springer,2011-01-20,23,3,28,31,1927,23:00 - 24:59
springer,2011-01-21,0,1,20,21,1543,
springer,2011-01-21,1,0,6,6,1543,01:00 - 02:59
springer,2011-01-21,2,0,2,2,1543,01:00 - 02:59
springer,2011-01-21,3,0,1,1,1543,03:00 - 04:59
springer,2011-01-21,4,0,1,1,1543,03:00 - 04:59
springer,2011-01-21,5,1,4,5,1543,05:00 - 06:59
springer,2011-01-21,6,0,27,27,1543,05:00 - 06:59
springer,2011-01-21,7,2,66,68,1543,07:00 - 08:59
springer,2011-01-21,8,7,210,217,1543,07:00 - 08:59
springer,2011-01-21,9,7,159,166,1543,09:00 - 10:59
springer,2011-01-21,10,6,57,63,1543,09:00 - 10:59
springer,2011-01-21,11,6,53,59,1543,11:00 - 12:59
springer,2011-01-21,12,11,67,78,1543,11:00 - 12:59
springer,2011-01-21,13,8,65,73,1543,13:00 - 14:59
springer,2011-01-21,14,6,56,62,1543,13:00 - 14:59
springer,2011-01-21,15,4,61,65,1543,15:00 - 16:59
springer,2011-01-21,16,0,97,97,1543,15:00 - 16:59
springer,2011-01-21,17,10,151,161,1543,17:00 - 18:59
springer,2011-01-21,18,1,119,120,1543,17:00 - 18:59
springer,2011-01-21,19,3,93,96,1543,19:00 - 20:59
springer,2011-01-21,20,1,52,53,1543,19:00 - 20:59
springer,2011-01-21,21,0,41,41,1543,21:00 - 22:59
springer,2011-01-21,22,1,33,34,1543,21:00 - 22:59
springer,2011-01-21,23,0,27,27,1543,23:00 - 24:59
springer,2011-01-22,0,0,13,13,981,
springer,2011-01-22,1,3,9,12,981,01:00 - 02:59
springer,2011-01-22,2,0,11,11,981,01:00 - 02:59
springer,2011-01-22,3,1,6,7,981,03:00 - 04:59
springer,2011-01-22,4,0,3,3,981,03:00 - 04:59
springer,2011-01-22,6,0,2,2,981,05:00 - 06:59
springer,2011-01-22,7,0,8,8,981,07:00 - 08:59
springer,2011-01-22,8,1,26,27,981,07:00 - 08:59
springer,2011-01-22,9,3,37,40,981,09:00 - 10:59
springer,2011-01-22,10,3,50,53,981,09:00 - 10:59
springer,2011-01-22,11,4,59,63,981,11:00 - 12:59
springer,2011-01-22,12,10,60,70,981,11:00 - 12:59
springer,2011-01-22,13,12,72,84,981,13:00 - 14:59
springer,2011-01-22,14,11,64,75,981,13:00 - 14:59
springer,2011-01-22,15,10,93,103,981,15:00 - 16:59
springer,2011-01-22,16,11,72,83,981,15:00 - 16:59
springer,2011-01-22,17,8,59,67,981,17:00 - 18:59
springer,2011-01-22,18,0,54,54,981,17:00 - 18:59
springer,2011-01-22,19,6,53,59,981,19:00 - 20:59
springer,2011-01-22,20,1,44,45,981,19:00 - 20:59
springer,2011-01-22,21,0,39,39,981,21:00 - 22:59
springer,2011-01-22,22,7,23,30,981,21:00 - 22:59
springer,2011-01-22,23,2,31,33,981,23:00 - 24:59
springer,2011-01-23,0,2,20,22,986,
springer,2011-01-23,1,1,12,13,986,01:00 - 02:59
springer,2011-01-23,2,3,15,18,986,01:00 - 02:59
springer,2011-01-23,3,1,4,5,986,03:00 - 04:59
springer,2011-01-23,5,0,3,3,986,05:00 - 06:59
springer,2011-01-23,6,0,1,1,986,05:00 - 06:59
springer,2011-01-23,7,1,1,2,986,07:00 - 08:59
springer,2011-01-23,8,2,17,19,986,07:00 - 08:59
springer,2011-01-23,9,3,25,28,986,09:00 - 10:59
springer,2011-01-23,10,7,51,58,986,09:00 - 10:59
springer,2011-01-23,11,22,77,99,986,11:00 - 12:59
springer,2011-01-23,12,24,92,116,986,11:00 - 12:59
springer,2011-01-23,13,12,75,87,986,13:00 - 14:59
springer,2011-01-23,14,17,93,110,986,13:00 - 14:59
springer,2011-01-23,15,13,64,77,986,15:00 - 16:59
springer,2011-01-23,16,9,56,65,986,15:00 - 16:59
springer,2011-01-23,17,5,50,55,986,17:00 - 18:59
springer,2011-01-23,18,5,44,49,986,17:00 - 18:59
springer,2011-01-23,19,5,45,50,986,19:00 - 20:59
springer,2011-01-23,20,4,31,35,986,19:00 - 20:59
springer,2011-01-23,21,5,20,25,986,21:00 - 22:59
springer,2011-01-23,22,5,23,28,986,21:00 - 22:59
springer,2011-01-23,23,4,17,21,986,23:00 - 24:59
springer,2011-01-24,0,0,7,7,1416,
springer,2011-01-24,1,0,1,1,1416,01:00 - 02:59
springer,2011-01-24,3,0,1,1,1416,03:00 - 04:59
springer,2011-01-24,4,0,1,1,1416,03:00 - 04:59
springer,2011-01-24,5,0,5,5,1416,05:00 - 06:59
springer,2011-01-24,6,0,15,15,1416,05:00 - 06:59
springer,2011-01-24,7,5,79,84,1416,07:00 - 08:59
springer,2011-01-24,8,6,171,177,1416,07:00 - 08:59
springer,2011-01-24,9,4,98,102,1416,09:00 - 10:59
springer,2011-01-24,10,6,34,40,1416,09:00 - 10:59
springer,2011-01-24,11,3,43,46,1416,11:00 - 12:59
springer,2011-01-24,12,11,52,63,1416,11:00 - 12:59
springer,2011-01-24,13,6,54,60,1416,13:00 - 14:59
springer,2011-01-24,14,2,43,45,1416,13:00 - 14:59
springer,2011-01-24,15,7,50,57,1416,15:00 - 16:59
springer,2011-01-24,16,4,66,70,1416,15:00 - 16:59
springer,2011-01-24,17,6,178,184,1416,17:00 - 18:59
springer,2011-01-24,18,8,145,153,1416,17:00 - 18:59
springer,2011-01-24,19,5,101,106,1416,19:00 - 20:59
springer,2011-01-24,20,1,80,81,1416,19:00 - 20:59
springer,2011-01-24,21,6,53,59,1416,21:00 - 22:59
springer,2011-01-24,22,3,32,35,1416,21:00 - 22:59
springer,2011-01-24,23,3,21,24,1416,23:00 - 24:59
springer,2011-01-25,0,3,6,9,1985,
springer,2011-01-25,1,0,5,5,1985,01:00 - 02:59
springer,2011-01-25,2,0,2,2,1985,01:00 - 02:59
springer,2011-01-25,4,0,1,1,1985,03:00 - 04:59
springer,2011-01-25,5,0,9,9,1985,05:00 - 06:59
springer,2011-01-25,6,1,35,36,1985,05:00 - 06:59
springer,2011-01-25,7,5,103,108,1985,07:00 - 08:59
springer,2011-01-25,8,5,233,238,1985,07:00 - 08:59
springer,2011-01-25,9,10,134,144,1985,09:00 - 10:59
springer,2011-01-25,10,6,49,55,1985,09:00 - 10:59
springer,2011-01-25,11,6,55,61,1985,11:00 - 12:59
springer,2011-01-25,12,21,85,106,1985,11:00 - 12:59
springer,2011-01-25,13,21,72,93,1985,13:00 - 14:59
springer,2011-01-25,14,11,57,68,1985,13:00 - 14:59
springer,2011-01-25,15,21,63,84,1985,15:00 - 16:59
springer,2011-01-25,16,14,102,116,1985,15:00 - 16:59
springer,2011-01-25,17,14,208,222,1985,17:00 - 18:59
springer,2011-01-25,18,7,218,225,1985,17:00 - 18:59
springer,2011-01-25,19,13,133,146,1985,19:00 - 20:59
springer,2011-01-25,20,16,103,119,1985,19:00 - 20:59
springer,2011-01-25,21,5,40,45,1985,21:00 - 22:59
springer,2011-01-25,22,4,49,53,1985,21:00 - 22:59
springer,2011-01-25,23,3,37,40,1985,23:00 - 24:59
springer,2011-01-26,0,3,14,17,506,
springer,2011-01-26,1,0,5,5,506,01:00 - 02:59
springer,2011-01-26,2,3,7,10,506,01:00 - 02:59
springer,2011-01-26,5,0,1,1,506,05:00 - 06:59
springer,2011-01-26,6,0,8,8,506,05:00 - 06:59
springer,2011-01-26,7,1,29,30,506,07:00 - 08:59
springer,2011-01-26,8,3,69,72,506,07:00 - 08:59
springer,2011-01-26,9,3,55,58,506,09:00 - 10:59
springer,2011-01-26,10,2,26,28,506,09:00 - 10:59
springer,2011-01-26,11,6,35,41,506,11:00 - 12:59
springer,2011-01-26,12,7,41,48,506,11:00 - 12:59
springer,2011-01-26,13,4,43,47,506,13:00 - 14:59
springer,2011-01-26,14,0,36,36,506,13:00 - 14:59
springer,2011-01-26,15,1,42,43,506,15:00 - 16:59
springer,2011-01-26,16,1,35,36,506,15:00 - 16:59
springer,2011-01-26,17,0,26,26,506,17:00 - 18:59
springer,2011-01-27,16,1,23,24,431,15:00 - 16:59
springer,2011-01-27,17,2,82,84,431,17:00 - 18:59
springer,2011-01-27,18,3,101,104,431,17:00 - 18:59
springer,2011-01-27,19,3,76,79,431,19:00 - 20:59
springer,2011-01-27,20,4,55,59,431,19:00 - 20:59
springer,2011-01-27,21,2,36,38,431,21:00 - 22:59
springer,2011-01-27,22,0,27,27,431,21:00 - 22:59
springer,2011-01-27,23,0,16,16,431,23:00 - 24:59
springer,2011-01-28,0,0,9,9,1167,
springer,2011-01-28,1,1,2,3,1167,01:00 - 02:59
springer,2011-01-28,2,0,2,2,1167,01:00 - 02:59
springer,2011-01-28,3,1,0,1,1167,03:00 - 04:59
springer,2011-01-28,5,0,4,4,1167,05:00 - 06:59
springer,2011-01-28,6,0,16,16,1167,05:00 - 06:59
springer,2011-01-28,7,2,58,60,1167,07:00 - 08:59
springer,2011-01-28,8,2,155,157,1167,07:00 - 08:59
springer,2011-01-28,9,6,95,101,1167,09:00 - 10:59
springer,2011-01-28,10,0,49,49,1167,09:00 - 10:59
springer,2011-01-28,11,0,30,30,1167,11:00 - 12:59
springer,2011-01-28,12,1,28,29,1167,11:00 - 12:59
springer,2011-01-28,13,0,31,31,1167,13:00 - 14:59
springer,2011-01-28,14,2,36,38,1167,13:00 - 14:59
springer,2011-01-28,15,1,40,41,1167,15:00 - 16:59
springer,2011-01-28,16,10,70,80,1167,15:00 - 16:59
springer,2011-01-28,17,2,147,149,1167,17:00 - 18:59
springer,2011-01-28,18,2,107,109,1167,17:00 - 18:59
springer,2011-01-28,19,5,84,89,1167,19:00 - 20:59
springer,2011-01-28,20,1,61,62,1167,19:00 - 20:59
springer,2011-01-28,21,1,57,58,1167,21:00 - 22:59
springer,2011-01-28,22,0,26,26,1167,21:00 - 22:59
springer,2011-01-28,23,1,22,23,1167,23:00 - 24:59
springer,2011-01-29,0,2,26,28,1098,
springer,2011-01-29,1,0,20,20,1098,01:00 - 02:59
springer,2011-01-29,2,0,15,15,1098,01:00 - 02:59
springer,2011-01-29,3,3,5,8,1098,03:00 - 04:59
springer,2011-01-29,4,1,2,3,1098,03:00 - 04:59
springer,2011-01-29,6,0,2,2,1098,05:00 - 06:59
springer,2011-01-29,7,1,4,5,1098,07:00 - 08:59
springer,2011-01-29,8,3,31,34,1098,07:00 - 08:59
springer,2011-01-29,9,0,34,34,1098,09:00 - 10:59
springer,2011-01-29,10,4,51,55,1098,09:00 - 10:59
springer,2011-01-29,11,4,60,64,1098,11:00 - 12:59
springer,2011-01-29,12,12,66,78,1098,11:00 - 12:59
springer,2011-01-29,13,9,56,65,1098,13:00 - 14:59
springer,2011-01-29,14,10,89,99,1098,13:00 - 14:59
springer,2011-01-29,15,22,98,120,1098,15:00 - 16:59
springer,2011-01-29,16,19,88,107,1098,15:00 - 16:59
springer,2011-01-29,17,9,82,91,1098,17:00 - 18:59
springer,2011-01-29,18,9,59,68,1098,17:00 - 18:59
springer,2011-01-29,19,6,52,58,1098,19:00 - 20:59
springer,2011-01-29,20,1,42,43,1098,19:00 - 20:59
springer,2011-01-29,21,1,35,36,1098,21:00 - 22:59
springer,2011-01-29,22,4,28,32,1098,21:00 - 22:59
springer,2011-01-29,23,3,30,33,1098,23:00 - 24:59
springer,2011-01-30,0,0,33,33,1096,
springer,2011-01-30,1,7,22,29,1096,01:00 - 02:59
springer,2011-01-30,2,1,10,11,1096,01:00 - 02:59
springer,2011-01-30,3,1,7,8,1096,03:00 - 04:59
springer,2011-01-30,4,0,1,1,1096,03:00 - 04:59
springer,2011-01-30,5,0,3,3,1096,05:00 - 06:59
springer,2011-01-30,7,0,3,3,1096,07:00 - 08:59
springer,2011-01-30,8,1,11,12,1096,07:00 - 08:59
springer,2011-01-30,9,4,34,38,1096,09:00 - 10:59
springer,2011-01-30,10,7,57,64,1096,09:00 - 10:59
springer,2011-01-30,11,9,50,59,1096,11:00 - 12:59
springer,2011-01-30,12,10,87,97,1096,11:00 - 12:59
springer,2011-01-30,13,13,71,84,1096,13:00 - 14:59
springer,2011-01-30,14,18,104,122,1096,13:00 - 14:59
springer,2011-01-30,15,14,95,109,1096,15:00 - 16:59
springer,2011-01-30,16,19,104,123,1096,15:00 - 16:59
springer,2011-01-30,17,6,71,77,1096,17:00 - 18:59
springer,2011-01-30,18,8,57,65,1096,17:00 - 18:59
springer,2011-01-30,19,9,46,55,1096,19:00 - 20:59
springer,2011-01-30,20,3,30,33,1096,19:00 - 20:59
springer,2011-01-30,21,3,25,28,1096,21:00 - 22:59
springer,2011-01-30,22,2,19,21,1096,21:00 - 22:59
springer,2011-01-30,23,5,16,21,1096,23:00 - 24:59
springer,2011-01-31,0,1,6,7,1501,
springer,2011-01-31,1,2,5,7,1501,01:00 - 02:59
springer,2011-01-31,2,0,1,1,1501,01:00 - 02:59
springer,2011-01-31,3,0,2,2,1501,03:00 - 04:59
springer,2011-01-31,4,0,2,2,1501,03:00 - 04:59
springer,2011-01-31,5,0,8,8,1501,05:00 - 06:59
springer,2011-01-31,6,0,37,37,1501,05:00 - 06:59
springer,2011-01-31,7,1,71,72,1501,07:00 - 08:59
springer,2011-01-31,8,3,182,185,1501,07:00 - 08:59
springer,2011-01-31,9,0,112,112,1501,09:00 - 10:59
springer,2011-01-31,10,1,68,69,1501,09:00 - 10:59
springer,2011-01-31,11,2,46,48,1501,11:00 - 12:59
springer,2011-01-31,12,6,62,68,1501,11:00 - 12:59
springer,2011-01-31,13,2,52,54,1501,13:00 - 14:59
springer,2011-01-31,14,1,85,86,1501,13:00 - 14:59
springer,2011-01-31,15,3,41,44,1501,15:00 - 16:59
springer,2011-01-31,16,3,83,86,1501,15:00 - 16:59
springer,2011-01-31,17,6,155,161,1501,17:00 - 18:59
springer,2011-01-31,18,3,153,156,1501,17:00 - 18:59
springer,2011-01-31,19,3,108,111,1501,19:00 - 20:59
springer,2011-01-31,20,0,78,78,1501,19:00 - 20:59
springer,2011-01-31,21,3,53,56,1501,21:00 - 22:59
springer,2011-01-31,22,0,34,34,1501,21:00 - 22:59
springer,2011-01-31,23,2,15,17,1501,23:00 - 24:59
springer,2011-02-01,0,2,6,8,1360,
springer,2011-02-01,1,0,3,3,1360,01:00 - 02:59
springer,2011-02-01,2,0,2,2,1360,01:00 - 02:59
springer,2011-02-01,3,0,2,2,1360,03:00 - 04:59
springer,2011-02-01,5,0,3,3,1360,05:00 - 06:59
springer,2011-02-01,6,0,22,22,1360,05:00 - 06:59
springer,2011-02-01,7,0,52,52,1360,07:00 - 08:59
springer,2011-02-01,8,3,132,135,1360,07:00 - 08:59
springer,2011-02-01,9,2,114,116,1360,09:00 - 10:59
springer,2011-02-01,10,0,47,47,1360,09:00 - 10:59
springer,2011-02-01,11,2,49,51,1360,11:00 - 12:59
springer,2011-02-01,12,2,53,55,1360,11:00 - 12:59
springer,2011-02-01,13,3,49,52,1360,13:00 - 14:59
springer,2011-02-01,14,5,49,54,1360,13:00 - 14:59
springer,2011-02-01,15,7,45,52,1360,15:00 - 16:59
springer,2011-02-01,16,3,61,64,1360,15:00 - 16:59
springer,2011-02-01,17,4,172,176,1360,17:00 - 18:59
springer,2011-02-01,18,3,165,168,1360,17:00 - 18:59
springer,2011-02-01,19,3,105,108,1360,19:00 - 20:59
springer,2011-02-01,20,5,69,74,1360,19:00 - 20:59
springer,2011-02-01,21,0,64,64,1360,21:00 - 22:59
springer,2011-02-01,22,2,34,36,1360,21:00 - 22:59
springer,2011-02-01,23,1,15,16,1360,23:00 - 24:59
springer,2011-02-02,0,0,2,2,1526,
springer,2011-02-02,1,0,3,3,1526,01:00 - 02:59
springer,2011-02-02,2,4,0,4,1526,01:00 - 02:59
springer,2011-02-02,3,0,1,1,1526,03:00 - 04:59
springer,2011-02-02,4,0,1,1,1526,03:00 - 04:59
springer,2011-02-02,5,0,3,3,1526,05:00 - 06:59
springer,2011-02-02,6,1,17,18,1526,05:00 - 06:59
springer,2011-02-02,7,1,48,49,1526,07:00 - 08:59
springer,2011-02-02,8,1,154,155,1526,07:00 - 08:59
springer,2011-02-02,9,4,119,123,1526,09:00 - 10:59
springer,2011-02-02,10,2,59,61,1526,09:00 - 10:59
springer,2011-02-02,11,5,47,52,1526,11:00 - 12:59
springer,2011-02-02,12,3,61,64,1526,11:00 - 12:59
springer,2011-02-02,13,1,74,75,1526,13:00 - 14:59
springer,2011-02-02,14,2,61,63,1526,13:00 - 14:59
springer,2011-02-02,15,10,66,76,1526,15:00 - 16:59
springer,2011-02-02,16,8,95,103,1526,15:00 - 16:59
springer,2011-02-02,17,7,183,190,1526,17:00 - 18:59
springer,2011-02-02,18,7,175,182,1526,17:00 - 18:59
springer,2011-02-02,19,3,88,91,1526,19:00 - 20:59
springer,2011-02-02,20,4,71,75,1526,19:00 - 20:59
springer,2011-02-02,21,1,62,63,1526,21:00 - 22:59
springer,2011-02-02,22,5,35,40,1526,21:00 - 22:59
springer,2011-02-02,23,3,29,32,1526,23:00 - 24:59
springer,2011-02-03,0,1,11,12,1550,
springer,2011-02-03,1,0,5,5,1550,01:00 - 02:59
springer,2011-02-03,2,0,2,2,1550,01:00 - 02:59
springer,2011-02-03,3,0,1,1,1550,03:00 - 04:59
springer,2011-02-03,5,0,2,2,1550,05:00 - 06:59
springer,2011-02-03,6,0,39,39,1550,05:00 - 06:59
springer,2011-02-03,7,1,86,87,1550,07:00 - 08:59
springer,2011-02-03,8,4,184,188,1550,07:00 - 08:59
springer,2011-02-03,9,6,127,133,1550,09:00 - 10:59
springer,2011-02-03,10,2,50,52,1550,09:00 - 10:59
springer,2011-02-03,11,9,55,64,1550,11:00 - 12:59
springer,2011-02-03,12,2,67,69,1550,11:00 - 12:59
springer,2011-02-03,13,4,47,51,1550,13:00 - 14:59
springer,2011-02-03,14,4,43,47,1550,13:00 - 14:59
springer,2011-02-03,15,4,56,60,1550,15:00 - 16:59
springer,2011-02-03,16,5,73,78,1550,15:00 - 16:59
springer,2011-02-03,17,5,170,175,1550,17:00 - 18:59
springer,2011-02-03,18,2,145,147,1550,17:00 - 18:59
springer,2011-02-03,19,4,92,96,1550,19:00 - 20:59
springer,2011-02-03,20,1,108,109,1550,19:00 - 20:59
springer,2011-02-03,21,1,53,54,1550,21:00 - 22:59
springer,2011-02-03,22,2,39,41,1550,21:00 - 22:59
springer,2011-02-03,23,4,34,38,1550,23:00 - 24:59
springer,2011-02-04,0,3,10,13,1708,
springer,2011-02-04,1,0,7,7,1708,01:00 - 02:59
springer,2011-02-04,2,0,1,1,1708,01:00 - 02:59
springer,2011-02-04,3,0,1,1,1708,03:00 - 04:59
springer,2011-02-04,5,0,7,7,1708,05:00 - 06:59
springer,2011-02-04,6,2,26,28,1708,05:00 - 06:59
springer,2011-02-04,7,0,87,87,1708,07:00 - 08:59
springer,2011-02-04,8,3,217,220,1708,07:00 - 08:59
springer,2011-02-04,9,3,124,127,1708,09:00 - 10:59
springer,2011-02-04,10,5,46,51,1708,09:00 - 10:59
springer,2011-02-04,11,3,61,64,1708,11:00 - 12:59
springer,2011-02-04,12,8,78,86,1708,11:00 - 12:59
springer,2011-02-04,13,9,73,82,1708,13:00 - 14:59
springer,2011-02-04,14,15,76,91,1708,13:00 - 14:59
springer,2011-02-04,15,9,81,90,1708,15:00 - 16:59
springer,2011-02-04,16,8,91,99,1708,15:00 - 16:59
springer,2011-02-04,17,10,195,205,1708,17:00 - 18:59
springer,2011-02-04,18,3,152,155,1708,17:00 - 18:59
springer,2011-02-04,19,1,102,103,1708,19:00 - 20:59
springer,2011-02-04,20,2,69,71,1708,19:00 - 20:59
springer,2011-02-04,21,2,41,43,1708,21:00 - 22:59
springer,2011-02-04,22,1,45,46,1708,21:00 - 22:59
springer,2011-02-04,23,1,30,31,1708,23:00 - 24:59
springer,2011-02-05,0,3,36,39,1005,
springer,2011-02-05,1,1,17,18,1005,01:00 - 02:59
springer,2011-02-05,2,5,12,17,1005,01:00 - 02:59
springer,2011-02-05,3,1,10,11,1005,03:00 - 04:59
springer,2011-02-05,4,0,8,8,1005,03:00 - 04:59
springer,2011-02-05,5,0,9,9,1005,05:00 - 06:59
springer,2011-02-05,6,0,4,4,1005,05:00 - 06:59
springer,2011-02-05,7,0,4,4,1005,07:00 - 08:59
springer,2011-02-05,8,0,10,10,1005,07:00 - 08:59
springer,2011-02-05,9,3,17,20,1005,09:00 - 10:59
springer,2011-02-05,10,3,31,34,1005,09:00 - 10:59
springer,2011-02-05,11,1,46,47,1005,11:00 - 12:59
springer,2011-02-05,12,10,42,52,1005,11:00 - 12:59
springer,2011-02-05,13,10,62,72,1005,13:00 - 14:59
springer,2011-02-05,14,5,50,55,1005,13:00 - 14:59
springer,2011-02-05,15,11,49,60,1005,15:00 - 16:59
springer,2011-02-05,16,8,63,71,1005,15:00 - 16:59
springer,2011-02-05,17,14,64,78,1005,17:00 - 18:59
springer,2011-02-05,18,2,81,83,1005,17:00 - 18:59
springer,2011-02-05,19,6,78,84,1005,19:00 - 20:59
springer,2011-02-05,20,5,64,69,1005,19:00 - 20:59
springer,2011-02-05,21,3,53,56,1005,21:00 - 22:59
springer,2011-02-05,22,2,43,45,1005,21:00 - 22:59
springer,2011-02-05,23,7,52,59,1005,23:00 - 24:59
springer,2011-02-06,0,2,37,39,1623,
springer,2011-02-06,1,4,40,44,1623,01:00 - 02:59
springer,2011-02-06,2,0,20,20,1623,01:00 - 02:59
springer,2011-02-06,3,3,10,13,1623,03:00 - 04:59
springer,2011-02-06,4,0,2,2,1623,03:00 - 04:59
springer,2011-02-06,5,0,1,1,1623,05:00 - 06:59
springer,2011-02-06,6,0,1,1,1623,05:00 - 06:59
springer,2011-02-06,7,0,8,8,1623,07:00 - 08:59
springer,2011-02-06,8,2,21,23,1623,07:00 - 08:59
springer,2011-02-06,9,7,38,45,1623,09:00 - 10:59
springer,2011-02-06,10,15,74,89,1623,09:00 - 10:59
springer,2011-02-06,11,28,89,117,1623,11:00 - 12:59
springer,2011-02-06,12,48,126,174,1623,11:00 - 12:59
springer,2011-02-06,13,47,135,182,1623,13:00 - 14:59
springer,2011-02-06,14,47,114,161,1623,13:00 - 14:59
springer,2011-02-06,15,52,130,182,1623,15:00 - 16:59
springer,2011-02-06,16,42,115,157,1623,15:00 - 16:59
springer,2011-02-06,17,24,97,121,1623,17:00 - 18:59
springer,2011-02-06,18,13,65,78,1623,17:00 - 18:59
springer,2011-02-06,19,1,20,21,1623,19:00 - 20:59
springer,2011-02-06,20,5,21,26,1623,19:00 - 20:59
springer,2011-02-06,21,5,22,27,1623,21:00 - 22:59
springer,2011-02-06,22,5,57,62,1623,21:00 - 22:59
springer,2011-02-06,23,4,26,30,1623,23:00 - 24:59
springer,2011-02-07,0,1,14,15,1712,
springer,2011-02-07,1,1,4,5,1712,01:00 - 02:59
springer,2011-02-07,2,0,3,3,1712,01:00 - 02:59
springer,2011-02-07,3,0,1,1,1712,03:00 - 04:59
springer,2011-02-07,4,1,1,2,1712,03:00 - 04:59
springer,2011-02-07,5,1,9,10,1712,05:00 - 06:59
springer,2011-02-07,6,1,29,30,1712,05:00 - 06:59
springer,2011-02-07,7,6,89,95,1712,07:00 - 08:59
springer,2011-02-07,8,7,223,230,1712,07:00 - 08:59
springer,2011-02-07,9,3,115,118,1712,09:00 - 10:59
springer,2011-02-07,10,6,49,55,1712,09:00 - 10:59
springer,2011-02-07,11,11,36,47,1712,11:00 - 12:59
springer,2011-02-07,12,7,59,66,1712,11:00 - 12:59
springer,2011-02-07,13,10,54,64,1712,13:00 - 14:59
springer,2011-02-07,14,8,52,60,1712,13:00 - 14:59
springer,2011-02-07,15,4,46,50,1712,15:00 - 16:59
springer,2011-02-07,16,16,98,114,1712,15:00 - 16:59
springer,2011-02-07,17,9,207,216,1712,17:00 - 18:59
springer,2011-02-07,18,5,170,175,1712,17:00 - 18:59
springer,2011-02-07,19,5,123,128,1712,19:00 - 20:59
springer,2011-02-07,20,6,82,88,1712,19:00 - 20:59
springer,2011-02-07,21,3,75,78,1712,21:00 - 22:59
springer,2011-02-07,22,3,34,37,1712,21:00 - 22:59
springer,2011-02-07,23,6,19,25,1712,23:00 - 24:59
springer,2011-02-08,0,4,6,10,1530,
springer,2011-02-08,1,0,4,4,1530,01:00 - 02:59
springer,2011-02-08,2,1,1,2,1530,01:00 - 02:59
springer,2011-02-08,3,0,1,1,1530,03:00 - 04:59
springer,2011-02-08,4,0,3,3,1530,03:00 - 04:59
springer,2011-02-08,5,0,2,2,1530,05:00 - 06:59
springer,2011-02-08,6,0,39,39,1530,05:00 - 06:59
springer,2011-02-08,7,3,97,100,1530,07:00 - 08:59
springer,2011-02-08,8,7,236,243,1530,07:00 - 08:59
springer,2011-02-08,9,7,128,135,1530,09:00 - 10:59
springer,2011-02-08,10,4,44,48,1530,09:00 - 10:59
springer,2011-02-08,11,1,49,50,1530,11:00 - 12:59
springer,2011-02-08,12,2,63,65,1530,11:00 - 12:59
springer,2011-02-08,13,2,48,50,1530,13:00 - 14:59
springer,2011-02-08,14,3,61,64,1530,13:00 - 14:59
springer,2011-02-08,15,6,45,51,1530,15:00 - 16:59
springer,2011-02-08,16,4,79,83,1530,15:00 - 16:59
springer,2011-02-08,17,4,172,176,1530,17:00 - 18:59
springer,2011-02-08,18,1,151,152,1530,17:00 - 18:59
springer,2011-02-08,19,1,100,101,1530,19:00 - 20:59
springer,2011-02-08,20,3,53,56,1530,19:00 - 20:59
springer,2011-02-08,21,8,46,54,1530,21:00 - 22:59
springer,2011-02-08,22,0,29,29,1530,21:00 - 22:59
springer,2011-02-08,23,3,9,12,1530,23:00 - 24:59
springer,2011-02-09,0,0,17,17,1605,
springer,2011-02-09,1,0,7,7,1605,01:00 - 02:59
springer,2011-02-09,2,1,2,3,1605,01:00 - 02:59
springer,2011-02-09,3,0,2,2,1605,03:00 - 04:59
springer,2011-02-09,5,0,7,7,1605,05:00 - 06:59
springer,2011-02-09,6,0,43,43,1605,05:00 - 06:59
springer,2011-02-09,7,4,95,99,1605,07:00 - 08:59
springer,2011-02-09,8,1,198,199,1605,07:00 - 08:59
springer,2011-02-09,9,4,119,123,1605,09:00 - 10:59
springer,2011-02-09,10,8,51,59,1605,09:00 - 10:59
springer,2011-02-09,11,1,40,41,1605,11:00 - 12:59
springer,2011-02-09,12,4,57,61,1605,11:00 - 12:59
springer,2011-02-09,13,2,67,69,1605,13:00 - 14:59
springer,2011-02-09,14,2,56,58,1605,13:00 - 14:59
springer,2011-02-09,15,3,61,64,1605,15:00 - 16:59
springer,2011-02-09,16,7,72,79,1605,15:00 - 16:59
springer,2011-02-09,17,9,157,166,1605,17:00 - 18:59
springer,2011-02-09,18,2,168,170,1605,17:00 - 18:59
springer,2011-02-09,19,1,87,88,1605,19:00 - 20:59
springer,2011-02-09,20,0,84,84,1605,19:00 - 20:59
springer,2011-02-09,21,0,83,83,1605,21:00 - 22:59
springer,2011-02-09,22,4,42,46,1605,21:00 - 22:59
springer,2011-02-09,23,0,37,37,1605,23:00 - 24:59
springer,2011-02-10,0,0,16,16,1538,
springer,2011-02-10,1,0,7,7,1538,01:00 - 02:59
springer,2011-02-10,2,0,3,3,1538,01:00 - 02:59
springer,2011-02-10,4,0,1,1,1538,03:00 - 04:59
springer,2011-02-10,5,0,6,6,1538,05:00 - 06:59
springer,2011-02-10,6,0,26,26,1538,05:00 - 06:59
springer,2011-02-10,7,0,99,99,1538,07:00 - 08:59
springer,2011-02-10,8,5,173,178,1538,07:00 - 08:59
springer,2011-02-10,9,1,121,122,1538,09:00 - 10:59
springer,2011-02-10,10,1,34,35,1538,09:00 - 10:59
springer,2011-02-10,11,1,44,45,1538,11:00 - 12:59
springer,2011-02-10,12,4,65,69,1538,11:00 - 12:59
springer,2011-02-10,13,3,59,62,1538,13:00 - 14:59
springer,2011-02-10,14,6,42,48,1538,13:00 - 14:59
springer,2011-02-10,15,0,50,50,1538,15:00 - 16:59
springer,2011-02-10,16,4,76,80,1538,15:00 - 16:59
springer,2011-02-10,17,6,159,165,1538,17:00 - 18:59
springer,2011-02-10,18,3,157,160,1538,17:00 - 18:59
springer,2011-02-10,19,2,110,112,1538,19:00 - 20:59
springer,2011-02-10,20,4,93,97,1538,19:00 - 20:59
springer,2011-02-10,21,2,70,72,1538,21:00 - 22:59
springer,2011-02-10,22,4,47,51,1538,21:00 - 22:59
springer,2011-02-10,23,1,33,34,1538,23:00 - 24:59
springer,2011-02-11,0,2,12,14,1746,
springer,2011-02-11,1,1,6,7,1746,01:00 - 02:59
springer,2011-02-11,2,0,3,3,1746,01:00 - 02:59
springer,2011-02-11,5,0,4,4,1746,05:00 - 06:59
springer,2011-02-11,6,1,23,24,1746,05:00 - 06:59
springer,2011-02-11,7,1,73,74,1746,07:00 - 08:59
springer,2011-02-11,8,4,212,216,1746,07:00 - 08:59
springer,2011-02-11,9,8,132,140,1746,09:00 - 10:59
springer,2011-02-11,10,5,39,44,1746,09:00 - 10:59
springer,2011-02-11,11,12,52,64,1746,11:00 - 12:59
springer,2011-02-11,12,7,64,71,1746,11:00 - 12:59
springer,2011-02-11,13,21,89,110,1746,13:00 - 14:59
springer,2011-02-11,14,17,67,84,1746,13:00 - 14:59
springer,2011-02-11,15,12,62,74,1746,15:00 - 16:59
springer,2011-02-11,16,14,111,125,1746,15:00 - 16:59
springer,2011-02-11,17,18,193,211,1746,17:00 - 18:59
springer,2011-02-11,18,9,165,174,1746,17:00 - 18:59
springer,2011-02-11,19,7,94,101,1746,19:00 - 20:59
springer,2011-02-11,20,2,61,63,1746,19:00 - 20:59
springer,2011-02-11,21,1,46,47,1746,21:00 - 22:59
springer,2011-02-11,22,2,41,43,1746,21:00 - 22:59
springer,2011-02-11,23,5,48,53,1746,23:00 - 24:59
springer,2011-02-12,0,3,27,30,1472,
springer,2011-02-12,1,2,22,24,1472,01:00 - 02:59
springer,2011-02-12,2,2,13,15,1472,01:00 - 02:59
springer,2011-02-12,3,3,7,10,1472,03:00 - 04:59
springer,2011-02-12,4,0,4,4,1472,03:00 - 04:59
springer,2011-02-12,5,0,1,1,1472,05:00 - 06:59
springer,2011-02-12,6,1,1,2,1472,05:00 - 06:59
springer,2011-02-12,7,2,9,11,1472,07:00 - 08:59
springer,2011-02-12,8,2,28,30,1472,07:00 - 08:59
springer,2011-02-12,9,5,38,43,1472,09:00 - 10:59
springer,2011-02-12,10,13,71,84,1472,09:00 - 10:59
springer,2011-02-12,11,30,84,114,1472,11:00 - 12:59
springer,2011-02-12,12,27,93,120,1472,11:00 - 12:59
springer,2011-02-12,13,32,103,135,1472,13:00 - 14:59
springer,2011-02-12,14,30,90,120,1472,13:00 - 14:59
springer,2011-02-12,15,47,127,174,1472,15:00 - 16:59
springer,2011-02-12,16,42,103,145,1472,15:00 - 16:59
springer,2011-02-12,17,24,113,137,1472,17:00 - 18:59
springer,2011-02-12,18,4,60,64,1472,17:00 - 18:59
springer,2011-02-12,19,2,39,41,1472,19:00 - 20:59
springer,2011-02-12,20,1,39,40,1472,19:00 - 20:59
springer,2011-02-12,21,9,42,51,1472,21:00 - 22:59
springer,2011-02-12,22,6,39,45,1472,21:00 - 22:59
springer,2011-02-12,23,1,31,32,1472,23:00 - 24:59
springer,2011-02-13,0,5,34,39,1589,
springer,2011-02-13,1,1,23,24,1589,01:00 - 02:59
springer,2011-02-13,2,1,19,20,1589,01:00 - 02:59
springer,2011-02-13,3,4,8,12,1589,03:00 - 04:59
springer,2011-02-13,4,0,2,2,1589,03:00 - 04:59
springer,2011-02-13,6,2,3,5,1589,05:00 - 06:59
springer,2011-02-13,7,0,3,3,1589,07:00 - 08:59
springer,2011-02-13,8,1,11,12,1589,07:00 - 08:59
springer,2011-02-13,9,12,35,47,1589,09:00 - 10:59
springer,2011-02-13,10,19,86,105,1589,09:00 - 10:59
springer,2011-02-13,11,26,86,112,1589,11:00 - 12:59
springer,2011-02-13,12,58,94,152,1589,11:00 - 12:59
springer,2011-02-13,13,62,92,154,1589,13:00 - 14:59
springer,2011-02-13,14,51,110,161,1589,13:00 - 14:59
springer,2011-02-13,15,40,122,162,1589,15:00 - 16:59
springer,2011-02-13,16,28,106,134,1589,15:00 - 16:59
springer,2011-02-13,17,30,95,125,1589,17:00 - 18:59
springer,2011-02-13,18,17,78,95,1589,17:00 - 18:59
springer,2011-02-13,19,11,50,61,1589,19:00 - 20:59
springer,2011-02-13,20,15,32,47,1589,19:00 - 20:59
springer,2011-02-13,21,6,45,51,1589,21:00 - 22:59
springer,2011-02-13,22,5,31,36,1589,21:00 - 22:59
springer,2011-02-13,23,3,27,30,1589,23:00 - 24:59
springer,2011-02-14,0,3,8,11,1913,
springer,2011-02-14,1,1,6,7,1913,01:00 - 02:59
springer,2011-02-14,2,0,2,2,1913,01:00 - 02:59
springer,2011-02-14,3,1,1,2,1913,03:00 - 04:59
springer,2011-02-14,4,0,2,2,1913,03:00 - 04:59
springer,2011-02-14,5,0,3,3,1913,05:00 - 06:59
springer,2011-02-14,6,1,25,26,1913,05:00 - 06:59
springer,2011-02-14,7,2,96,98,1913,07:00 - 08:59
springer,2011-02-14,8,7,249,256,1913,07:00 - 08:59
springer,2011-02-14,9,8,122,130,1913,09:00 - 10:59
springer,2011-02-14,10,9,46,55,1913,09:00 - 10:59
springer,2011-02-14,11,10,43,53,1913,11:00 - 12:59
springer,2011-02-14,12,27,99,126,1913,11:00 - 12:59
springer,2011-02-14,13,27,93,120,1913,13:00 - 14:59
springer,2011-02-14,14,14,76,90,1913,13:00 - 14:59
springer,2011-02-14,15,19,71,90,1913,15:00 - 16:59
springer,2011-02-14,16,16,102,118,1913,15:00 - 16:59
springer,2011-02-14,17,25,218,243,1913,17:00 - 18:59
springer,2011-02-14,18,11,194,205,1913,17:00 - 18:59
springer,2011-02-14,19,12,86,98,1913,19:00 - 20:59
springer,2011-02-14,20,5,65,70,1913,19:00 - 20:59
springer,2011-02-14,21,8,35,43,1913,21:00 - 22:59
springer,2011-02-14,22,1,44,45,1913,21:00 - 22:59
springer,2011-02-14,23,1,19,20,1913,23:00 - 24:59
springer,2011-02-15,0,7,12,19,1815,
springer,2011-02-15,1,0,5,5,1815,01:00 - 02:59
springer,2011-02-15,2,1,2,3,1815,01:00 - 02:59
springer,2011-02-15,4,0,1,1,1815,03:00 - 04:59
springer,2011-02-15,5,0,4,4,1815,05:00 - 06:59
springer,2011-02-15,6,0,30,30,1815,05:00 - 06:59
springer,2011-02-15,7,2,103,105,1815,07:00 - 08:59
springer,2011-02-15,8,10,213,223,1815,07:00 - 08:59
springer,2011-02-15,9,2,108,110,1815,09:00 - 10:59
springer,2011-02-15,10,5,47,52,1815,09:00 - 10:59
springer,2011-02-15,11,11,46,57,1815,11:00 - 12:59
springer,2011-02-15,12,6,65,71,1815,11:00 - 12:59
springer,2011-02-15,13,14,68,82,1815,13:00 - 14:59
springer,2011-02-15,14,10,69,79,1815,13:00 - 14:59
springer,2011-02-15,15,11,74,85,1815,15:00 - 16:59
springer,2011-02-15,16,21,77,98,1815,15:00 - 16:59
springer,2011-02-15,17,15,191,206,1815,17:00 - 18:59
springer,2011-02-15,18,14,198,212,1815,17:00 - 18:59
springer,2011-02-15,19,3,142,145,1815,19:00 - 20:59
springer,2011-02-15,20,3,98,101,1815,19:00 - 20:59
springer,2011-02-15,21,5,61,66,1815,21:00 - 22:59
springer,2011-02-15,22,0,41,41,1815,21:00 - 22:59
springer,2011-02-15,23,0,20,20,1815,23:00 - 24:59
springer,2011-02-16,0,0,15,15,2115,
springer,2011-02-16,1,0,9,9,2115,01:00 - 02:59
springer,2011-02-16,3,0,1,1,2115,03:00 - 04:59
springer,2011-02-16,4,0,1,1,2115,03:00 - 04:59
springer,2011-02-16,5,0,5,5,2115,05:00 - 06:59
springer,2011-02-16,6,1,32,33,2115,05:00 - 06:59
springer,2011-02-16,7,5,103,108,2115,07:00 - 08:59
springer,2011-02-16,8,6,224,230,2115,07:00 - 08:59
springer,2011-02-16,9,2,122,124,2115,09:00 - 10:59
springer,2011-02-16,10,14,55,69,2115,09:00 - 10:59
springer,2011-02-16,11,7,59,66,2115,11:00 - 12:59
springer,2011-02-16,12,14,72,86,2115,11:00 - 12:59
springer,2011-02-16,13,13,80,93,2115,13:00 - 14:59
springer,2011-02-16,14,17,65,82,2115,13:00 - 14:59
springer,2011-02-16,15,35,82,117,2115,15:00 - 16:59
springer,2011-02-16,16,26,96,122,2115,15:00 - 16:59
springer,2011-02-16,17,11,244,255,2115,17:00 - 18:59
springer,2011-02-16,18,20,202,222,2115,17:00 - 18:59
springer,2011-02-16,19,18,143,161,2115,19:00 - 20:59
springer,2011-02-16,20,10,108,118,2115,19:00 - 20:59
springer,2011-02-16,21,5,87,92,2115,21:00 - 22:59
springer,2011-02-16,22,12,61,73,2115,21:00 - 22:59
springer,2011-02-16,23,2,31,33,2115,23:00 - 24:59
springer,2011-02-17,0,1,16,17,2475,
springer,2011-02-17,1,0,6,6,2475,01:00 - 02:59
springer,2011-02-17,2,2,4,6,2475,01:00 - 02:59
springer,2011-02-17,3,3,1,4,2475,03:00 - 04:59
springer,2011-02-17,4,3,1,4,2475,03:00 - 04:59
springer,2011-02-17,5,1,11,12,2475,05:00 - 06:59
springer,2011-02-17,6,3,44,47,2475,05:00 - 06:59
springer,2011-02-17,7,7,119,126,2475,07:00 - 08:59
springer,2011-02-17,8,18,267,285,2475,07:00 - 08:59
springer,2011-02-17,9,16,163,179,2475,09:00 - 10:59
springer,2011-02-17,10,18,70,88,2475,09:00 - 10:59
springer,2011-02-17,11,19,71,90,2475,11:00 - 12:59
springer,2011-02-17,12,15,86,101,2475,11:00 - 12:59
springer,2011-02-17,13,15,108,123,2475,13:00 - 14:59
springer,2011-02-17,14,26,55,81,2475,13:00 - 14:59
springer,2011-02-17,15,15,91,106,2475,15:00 - 16:59
springer,2011-02-17,16,29,117,146,2475,15:00 - 16:59
springer,2011-02-17,17,18,256,274,2475,17:00 - 18:59
springer,2011-02-17,18,11,211,222,2475,17:00 - 18:59
springer,2011-02-17,19,14,161,175,2475,19:00 - 20:59
springer,2011-02-17,20,8,131,139,2475,19:00 - 20:59
springer,2011-02-17,21,5,119,124,2475,21:00 - 22:59
springer,2011-02-17,22,8,68,76,2475,21:00 - 22:59
springer,2011-02-17,23,4,40,44,2475,23:00 - 24:59
springer,2011-02-18,0,12,20,32,2927,
springer,2011-02-18,1,1,7,8,2927,01:00 - 02:59
springer,2011-02-18,2,2,5,7,2927,01:00 - 02:59
springer,2011-02-18,3,2,6,8,2927,03:00 - 04:59
springer,2011-02-18,4,0,1,1,2927,03:00 - 04:59
springer,2011-02-18,5,1,6,7,2927,05:00 - 06:59
springer,2011-02-18,6,2,48,50,2927,05:00 - 06:59
springer,2011-02-18,7,8,108,116,2927,07:00 - 08:59
springer,2011-02-18,8,26,246,272,2927,07:00 - 08:59
springer,2011-02-18,9,15,154,169,2927,09:00 - 10:59
springer,2011-02-18,10,17,78,95,2927,09:00 - 10:59
springer,2011-02-18,11,31,82,113,2927,11:00 - 12:59
springer,2011-02-18,12,59,126,185,2927,11:00 - 12:59
springer,2011-02-18,13,45,131,176,2927,13:00 - 14:59
springer,2011-02-18,14,73,118,191,2927,13:00 - 14:59
springer,2011-02-18,15,55,117,172,2927,15:00 - 16:59
springer,2011-02-18,16,68,164,232,2927,15:00 - 16:59
springer,2011-02-18,17,52,275,327,2927,17:00 - 18:59
springer,2011-02-18,18,29,195,224,2927,17:00 - 18:59
springer,2011-02-18,19,16,146,162,2927,19:00 - 20:59
springer,2011-02-18,20,19,105,124,2927,19:00 - 20:59
springer,2011-02-18,21,11,61,72,2927,21:00 - 22:59
springer,2011-02-18,22,19,88,107,2927,21:00 - 22:59
springer,2011-02-18,23,16,61,77,2927,23:00 - 24:59
springer,2011-02-19,0,6,23,29,1635,
springer,2011-02-19,1,10,21,31,1635,01:00 - 02:59
springer,2011-02-19,2,3,14,17,1635,01:00 - 02:59
springer,2011-02-19,3,0,7,7,1635,03:00 - 04:59
springer,2011-02-19,4,0,3,3,1635,03:00 - 04:59
springer,2011-02-19,5,0,3,3,1635,05:00 - 06:59
springer,2011-02-19,6,3,3,6,1635,05:00 - 06:59
springer,2011-02-19,7,6,16,22,1635,07:00 - 08:59
springer,2011-02-19,8,9,36,45,1635,07:00 - 08:59
springer,2011-02-19,9,18,37,55,1635,09:00 - 10:59
springer,2011-02-19,10,34,72,106,1635,09:00 - 10:59
springer,2011-02-19,11,47,76,123,1635,11:00 - 12:59
springer,2011-02-19,12,38,81,119,1635,11:00 - 12:59
springer,2011-02-19,13,52,103,155,1635,13:00 - 14:59
springer,2011-02-19,14,102,94,196,1635,13:00 - 14:59
springer,2011-02-19,15,84,87,171,1635,15:00 - 16:59
springer,2011-02-19,16,39,81,120,1635,15:00 - 16:59
springer,2011-02-19,17,36,91,127,1635,17:00 - 18:59
springer,2011-02-19,18,21,67,88,1635,17:00 - 18:59
springer,2011-02-19,19,5,54,59,1635,19:00 - 20:59
springer,2011-02-19,20,9,38,47,1635,19:00 - 20:59
springer,2011-02-19,21,4,29,33,1635,21:00 - 22:59
springer,2011-02-19,22,2,42,44,1635,21:00 - 22:59
springer,2011-02-19,23,4,25,29,1635,23:00 - 24:59
springer,2011-02-20,0,3,14,17,1812,
springer,2011-02-20,1,5,11,16,1812,01:00 - 02:59
springer,2011-02-20,2,0,17,17,1812,01:00 - 02:59
springer,2011-02-20,3,9,9,18,1812,03:00 - 04:59
springer,2011-02-20,4,0,1,1,1812,03:00 - 04:59
springer,2011-02-20,6,1,1,2,1812,05:00 - 06:59
springer,2011-02-20,7,0,2,2,1812,07:00 - 08:59
springer,2011-02-20,8,2,22,24,1812,07:00 - 08:59
springer,2011-02-20,9,7,48,55,1812,09:00 - 10:59
springer,2011-02-20,10,34,70,104,1812,09:00 - 10:59
springer,2011-02-20,11,72,89,161,1812,11:00 - 12:59
springer,2011-02-20,12,62,120,182,1812,11:00 - 12:59
springer,2011-02-20,13,76,122,198,1812,13:00 - 14:59
springer,2011-02-20,14,108,104,212,1812,13:00 - 14:59
springer,2011-02-20,15,66,102,168,1812,15:00 - 16:59
springer,2011-02-20,16,59,88,147,1812,15:00 - 16:59
springer,2011-02-20,17,60,86,146,1812,17:00 - 18:59
springer,2011-02-20,18,30,71,101,1812,17:00 - 18:59
springer,2011-02-20,19,3,39,42,1812,19:00 - 20:59
springer,2011-02-20,20,12,30,42,1812,19:00 - 20:59
springer,2011-02-20,21,17,39,56,1812,21:00 - 22:59
springer,2011-02-20,22,4,43,47,1812,21:00 - 22:59
springer,2011-02-20,23,9,45,54,1812,23:00 - 24:59
springer,2011-02-21,0,7,30,37,1107,
springer,2011-02-21,1,2,11,13,1107,01:00 - 02:59
springer,2011-02-21,2,1,3,4,1107,01:00 - 02:59
springer,2011-02-21,3,2,3,5,1107,03:00 - 04:59
springer,2011-02-21,4,1,0,1,1107,03:00 - 04:59
springer,2011-02-21,5,1,2,3,1107,05:00 - 06:59
springer,2011-02-21,6,2,6,8,1107,05:00 - 06:59
springer,2011-02-21,7,3,16,19,1107,07:00 - 08:59
springer,2011-02-21,8,7,56,63,1107,07:00 - 08:59
springer,2011-02-21,9,11,46,57,1107,09:00 - 10:59
springer,2011-02-21,10,29,52,81,1107,09:00 - 10:59
springer,2011-02-21,11,20,70,90,1107,11:00 - 12:59
springer,2011-02-21,12,26,67,93,1107,11:00 - 12:59
springer,2011-02-21,13,28,75,103,1107,13:00 - 14:59
springer,2011-02-21,14,15,101,116,1107,13:00 - 14:59
springer,2011-02-21,15,11,76,87,1107,15:00 - 16:59
springer,2011-02-21,16,8,48,56,1107,15:00 - 16:59
springer,2011-02-21,17,18,62,80,1107,17:00 - 18:59
springer,2011-02-21,18,2,64,66,1107,17:00 - 18:59
springer,2011-02-21,19,0,49,49,1107,19:00 - 20:59
springer,2011-02-21,20,0,29,29,1107,19:00 - 20:59
springer,2011-02-21,21,1,33,34,1107,21:00 - 22:59
springer,2011-02-21,22,0,11,11,1107,21:00 - 22:59
springer,2011-02-21,23,0,2,2,1107,23:00 - 24:59
springer,2011-02-22,6,0,7,7,1450,05:00 - 06:59
springer,2011-02-22,7,0,40,40,1450,07:00 - 08:59
springer,2011-02-22,8,7,107,114,1450,07:00 - 08:59
springer,2011-02-22,9,5,101,106,1450,09:00 - 10:59
springer,2011-02-22,10,0,44,44,1450,09:00 - 10:59
springer,2011-02-22,11,7,43,50,1450,11:00 - 12:59
springer,2011-02-22,12,7,48,55,1450,11:00 - 12:59
springer,2011-02-22,13,3,52,55,1450,13:00 - 14:59
springer,2011-02-22,14,9,49,58,1450,13:00 - 14:59
springer,2011-02-22,15,2,67,69,1450,15:00 - 16:59
springer,2011-02-22,16,7,79,86,1450,15:00 - 16:59
springer,2011-02-22,17,8,188,196,1450,17:00 - 18:59
springer,2011-02-22,18,6,161,167,1450,17:00 - 18:59
springer,2011-02-22,19,4,114,118,1450,19:00 - 20:59
springer,2011-02-22,20,3,102,105,1450,19:00 - 20:59
springer,2011-02-22,21,2,80,82,1450,21:00 - 22:59
springer,2011-02-22,22,1,76,77,1450,21:00 - 22:59
springer,2011-02-22,23,3,18,21,1450,23:00 - 24:59
springer,2011-02-23,0,0,6,6,1917,
springer,2011-02-23,1,0,4,4,1917,01:00 - 02:59
springer,2011-02-23,2,0,1,1,1917,01:00 - 02:59
springer,2011-02-23,3,0,2,2,1917,03:00 - 04:59
springer,2011-02-23,5,0,8,8,1917,05:00 - 06:59
springer,2011-02-23,6,0,36,36,1917,05:00 - 06:59
springer,2011-02-23,7,2,94,96,1917,07:00 - 08:59
springer,2011-02-23,8,8,227,235,1917,07:00 - 08:59
springer,2011-02-23,9,9,130,139,1917,09:00 - 10:59
springer,2011-02-23,10,4,47,51,1917,09:00 - 10:59
springer,2011-02-23,11,16,53,69,1917,11:00 - 12:59
springer,2011-02-23,12,11,56,67,1917,11:00 - 12:59
springer,2011-02-23,13,9,78,87,1917,13:00 - 14:59
springer,2011-02-23,14,17,61,78,1917,13:00 - 14:59
springer,2011-02-23,15,18,54,72,1917,15:00 - 16:59
springer,2011-02-23,16,15,79,94,1917,15:00 - 16:59
springer,2011-02-23,17,15,207,222,1917,17:00 - 18:59
springer,2011-02-23,18,3,206,209,1917,17:00 - 18:59
springer,2011-02-23,19,6,135,141,1917,19:00 - 20:59
springer,2011-02-23,20,2,107,109,1917,19:00 - 20:59
springer,2011-02-23,21,2,89,91,1917,21:00 - 22:59
springer,2011-02-23,22,1,60,61,1917,21:00 - 22:59
springer,2011-02-23,23,1,38,39,1917,23:00 - 24:59
springer,2011-02-24,0,0,11,11,1807,
springer,2011-02-24,1,0,7,7,1807,01:00 - 02:59
springer,2011-02-24,2,0,4,4,1807,01:00 - 02:59
springer,2011-02-24,3,0,2,2,1807,03:00 - 04:59
springer,2011-02-24,5,1,3,4,1807,05:00 - 06:59
springer,2011-02-24,6,0,58,58,1807,05:00 - 06:59
springer,2011-02-24,7,0,104,104,1807,07:00 - 08:59
springer,2011-02-24,8,8,244,252,1807,07:00 - 08:59
springer,2011-02-24,9,4,133,137,1807,09:00 - 10:59
springer,2011-02-24,10,8,49,57,1807,09:00 - 10:59
springer,2011-02-24,11,8,71,79,1807,11:00 - 12:59
springer,2011-02-24,12,10,85,95,1807,11:00 - 12:59
springer,2011-02-24,13,16,72,88,1807,13:00 - 14:59
springer,2011-02-24,14,2,67,69,1807,13:00 - 14:59
springer,2011-02-24,15,5,58,63,1807,15:00 - 16:59
springer,2011-02-24,16,4,67,71,1807,15:00 - 16:59
springer,2011-02-24,17,9,168,177,1807,17:00 - 18:59
springer,2011-02-24,18,5,132,137,1807,17:00 - 18:59
springer,2011-02-24,19,3,112,115,1807,19:00 - 20:59
springer,2011-02-24,20,2,87,89,1807,19:00 - 20:59
springer,2011-02-24,21,7,76,83,1807,21:00 - 22:59
springer,2011-02-24,22,5,50,55,1807,21:00 - 22:59
springer,2011-02-24,23,3,47,50,1807,23:00 - 24:59
springer,2011-02-25,0,1,8,9,1461,
springer,2011-02-25,1,1,9,10,1461,01:00 - 02:59
springer,2011-02-25,2,0,3,3,1461,01:00 - 02:59
springer,2011-02-25,3,1,1,2,1461,03:00 - 04:59
springer,2011-02-25,5,1,5,6,1461,05:00 - 06:59
springer,2011-02-25,6,0,11,11,1461,05:00 - 06:59
springer,2011-02-25,7,1,34,35,1461,07:00 - 08:59
springer,2011-02-25,8,3,70,73,1461,07:00 - 08:59
springer,2011-02-25,9,3,111,114,1461,09:00 - 10:59
springer,2011-02-25,10,7,42,49,1461,09:00 - 10:59
springer,2011-02-25,11,9,50,59,1461,11:00 - 12:59
springer,2011-02-25,12,20,95,115,1461,11:00 - 12:59
springer,2011-02-25,13,6,77,83,1461,13:00 - 14:59
springer,2011-02-25,14,14,71,85,1461,13:00 - 14:59
springer,2011-02-25,15,5,50,55,1461,15:00 - 16:59
springer,2011-02-25,16,11,91,102,1461,15:00 - 16:59
springer,2011-02-25,17,8,181,189,1461,17:00 - 18:59
springer,2011-02-25,18,7,150,157,1461,17:00 - 18:59
springer,2011-02-25,19,4,86,90,1461,19:00 - 20:59
springer,2011-02-25,20,2,60,62,1461,19:00 - 20:59
springer,2011-02-25,21,7,56,63,1461,21:00 - 22:59
springer,2011-02-25,22,7,43,50,1461,21:00 - 22:59
springer,2011-02-25,23,2,37,39,1461,23:00 - 24:59
springer,2011-02-26,0,3,25,28,1969,
springer,2011-02-26,1,2,25,27,1969,01:00 - 02:59
springer,2011-02-26,2,3,9,12,1969,01:00 - 02:59
springer,2011-02-26,3,1,7,8,1969,03:00 - 04:59
springer,2011-02-26,4,1,1,2,1969,03:00 - 04:59
springer,2011-02-26,5,1,9,10,1969,05:00 - 06:59
springer,2011-02-26,6,1,6,7,1969,05:00 - 06:59
springer,2011-02-26,7,1,21,22,1969,07:00 - 08:59
springer,2011-02-26,8,2,55,57,1969,07:00 - 08:59
springer,2011-02-26,9,9,65,74,1969,09:00 - 10:59
springer,2011-02-26,10,14,71,85,1969,09:00 - 10:59
springer,2011-02-26,11,26,100,126,1969,11:00 - 12:59
springer,2011-02-26,12,45,115,160,1969,11:00 - 12:59
springer,2011-02-26,13,38,136,174,1969,13:00 - 14:59
springer,2011-02-26,14,57,154,211,1969,13:00 - 14:59
springer,2011-02-26,15,40,125,165,1969,15:00 - 16:59
springer,2011-02-26,16,41,130,171,1969,15:00 - 16:59
springer,2011-02-26,17,53,130,183,1969,17:00 - 18:59
springer,2011-02-26,18,26,111,137,1969,17:00 - 18:59
springer,2011-02-26,19,30,64,94,1969,19:00 - 20:59
springer,2011-02-26,20,8,60,68,1969,19:00 - 20:59
springer,2011-02-26,21,9,59,68,1969,21:00 - 22:59
springer,2011-02-26,22,8,38,46,1969,21:00 - 22:59
springer,2011-02-26,23,5,29,34,1969,23:00 - 24:59
springer,2011-02-27,0,8,26,34,2402,
springer,2011-02-27,1,7,30,37,2402,01:00 - 02:59
springer,2011-02-27,2,2,20,22,2402,01:00 - 02:59
springer,2011-02-27,3,3,8,11,2402,03:00 - 04:59
springer,2011-02-27,4,0,2,2,2402,03:00 - 04:59
springer,2011-02-27,6,2,1,3,2402,05:00 - 06:59
springer,2011-02-27,7,6,8,14,2402,07:00 - 08:59
springer,2011-02-27,8,9,26,35,2402,07:00 - 08:59
springer,2011-02-27,9,17,42,59,2402,09:00 - 10:59
springer,2011-02-27,10,24,79,103,2402,09:00 - 10:59
springer,2011-02-27,11,33,92,125,2402,11:00 - 12:59
springer,2011-02-27,12,61,132,193,2402,11:00 - 12:59
springer,2011-02-27,13,90,169,259,2402,13:00 - 14:59
springer,2011-02-27,14,105,177,282,2402,13:00 - 14:59
springer,2011-02-27,15,98,163,261,2402,15:00 - 16:59
springer,2011-02-27,16,98,170,268,2402,15:00 - 16:59
springer,2011-02-27,17,66,121,187,2402,17:00 - 18:59
springer,2011-02-27,18,24,103,127,2402,17:00 - 18:59
springer,2011-02-27,19,16,86,102,2402,19:00 - 20:59
springer,2011-02-27,20,9,72,81,2402,19:00 - 20:59
springer,2011-02-27,21,8,61,69,2402,21:00 - 22:59
springer,2011-02-27,22,2,67,69,2402,21:00 - 22:59
springer,2011-02-27,23,6,53,59,2402,23:00 - 24:59
springer,2011-02-28,0,5,25,30,1446,
springer,2011-02-28,1,1,7,8,1446,01:00 - 02:59
springer,2011-02-28,3,0,1,1,1446,03:00 - 04:59
springer,2011-02-28,5,1,4,5,1446,05:00 - 06:59
springer,2011-02-28,6,1,27,28,1446,05:00 - 06:59
springer,2011-02-28,7,2,90,92,1446,07:00 - 08:59
springer,2011-02-28,8,13,242,255,1446,07:00 - 08:59
springer,2011-02-28,9,15,127,142,1446,09:00 - 10:59
springer,2011-02-28,10,13,79,92,1446,09:00 - 10:59
springer,2011-02-28,11,13,74,87,1446,11:00 - 12:59
springer,2011-02-28,12,0,36,36,1446,11:00 - 12:59
springer,2011-02-28,13,1,31,32,1446,13:00 - 14:59
springer,2011-02-28,14,1,24,25,1446,13:00 - 14:59
springer,2011-02-28,15,0,35,35,1446,15:00 - 16:59
springer,2011-02-28,16,2,40,42,1446,15:00 - 16:59
springer,2011-02-28,17,2,77,79,1446,17:00 - 18:59
springer,2011-02-28,18,4,127,131,1446,17:00 - 18:59
springer,2011-02-28,19,1,79,80,1446,19:00 - 20:59
springer,2011-02-28,20,0,45,45,1446,19:00 - 20:59
springer,2011-02-28,21,2,78,80,1446,21:00 - 22:59
springer,2011-02-28,22,4,72,76,1446,21:00 - 22:59
springer,2011-02-28,23,0,45,45,1446,23:00 - 24:59
springer,2011-03-01,0,0,7,7,1851,
springer,2011-03-01,1,0,3,3,1851,01:00 - 02:59
springer,2011-03-01,2,0,4,4,1851,01:00 - 02:59
springer,2011-03-01,3,0,2,2,1851,03:00 - 04:59
springer,2011-03-01,4,0,1,1,1851,03:00 - 04:59
springer,2011-03-01,5,1,1,2,1851,05:00 - 06:59
springer,2011-03-01,6,0,46,46,1851,05:00 - 06:59
springer,2011-03-01,7,2,105,107,1851,07:00 - 08:59
springer,2011-03-01,8,10,204,214,1851,07:00 - 08:59
springer,2011-03-01,9,8,116,124,1851,09:00 - 10:59
springer,2011-03-01,10,13,55,68,1851,09:00 - 10:59
springer,2011-03-01,11,8,48,56,1851,11:00 - 12:59
springer,2011-03-01,12,6,80,86,1851,11:00 - 12:59
springer,2011-03-01,13,13,65,78,1851,13:00 - 14:59
springer,2011-03-01,14,18,61,79,1851,13:00 - 14:59
springer,2011-03-01,15,7,57,64,1851,15:00 - 16:59
springer,2011-03-01,16,10,92,102,1851,15:00 - 16:59
springer,2011-03-01,17,12,230,242,1851,17:00 - 18:59
springer,2011-03-01,18,10,214,224,1851,17:00 - 18:59
springer,2011-03-01,19,4,115,119,1851,19:00 - 20:59
springer,2011-03-01,20,2,86,88,1851,19:00 - 20:59
springer,2011-03-01,21,8,55,63,1851,21:00 - 22:59
springer,2011-03-01,22,3,44,47,1851,21:00 - 22:59
springer,2011-03-01,23,2,23,25,1851,23:00 - 24:59
springer,2011-03-02,0,3,5,8,2134,
springer,2011-03-02,1,0,4,4,2134,01:00 - 02:59
springer,2011-03-02,2,0,2,2,2134,01:00 - 02:59
springer,2011-03-02,3,3,1,4,2134,03:00 - 04:59
springer,2011-03-02,4,1,0,1,2134,03:00 - 04:59
springer,2011-03-02,5,0,5,5,2134,05:00 - 06:59
springer,2011-03-02,6,1,39,40,2134,05:00 - 06:59
springer,2011-03-02,7,2,108,110,2134,07:00 - 08:59
springer,2011-03-02,8,13,243,256,2134,07:00 - 08:59
springer,2011-03-02,9,7,141,148,2134,09:00 - 10:59
springer,2011-03-02,10,11,65,76,2134,09:00 - 10:59
springer,2011-03-02,11,8,65,73,2134,11:00 - 12:59
springer,2011-03-02,12,20,62,82,2134,11:00 - 12:59
springer,2011-03-02,13,35,90,125,2134,13:00 - 14:59
springer,2011-03-02,14,21,75,96,2134,13:00 - 14:59
springer,2011-03-02,15,19,91,110,2134,15:00 - 16:59
springer,2011-03-02,16,27,112,139,2134,15:00 - 16:59
springer,2011-03-02,17,30,238,268,2134,17:00 - 18:59
springer,2011-03-02,18,8,193,201,2134,17:00 - 18:59
springer,2011-03-02,19,6,144,150,2134,19:00 - 20:59
springer,2011-03-02,20,9,86,95,2134,19:00 - 20:59
springer,2011-03-02,21,3,68,71,2134,21:00 - 22:59
springer,2011-03-02,22,4,44,48,2134,21:00 - 22:59
springer,2011-03-02,23,0,22,22,2134,23:00 - 24:59
springer,2011-03-03,0,3,10,13,1685,
springer,2011-03-03,1,0,1,1,1685,01:00 - 02:59
springer,2011-03-03,2,1,2,3,1685,01:00 - 02:59
springer,2011-03-03,3,0,1,1,1685,03:00 - 04:59
springer,2011-03-03,4,0,1,1,1685,03:00 - 04:59
springer,2011-03-03,5,1,7,8,1685,05:00 - 06:59
springer,2011-03-03,6,1,34,35,1685,05:00 - 06:59
springer,2011-03-03,7,1,110,111,1685,07:00 - 08:59
springer,2011-03-03,8,4,216,220,1685,07:00 - 08:59
springer,2011-03-03,9,10,135,145,1685,09:00 - 10:59
springer,2011-03-03,10,7,49,56,1685,09:00 - 10:59
springer,2011-03-03,11,10,40,50,1685,11:00 - 12:59
springer,2011-03-03,12,7,65,72,1685,11:00 - 12:59
springer,2011-03-03,13,13,67,80,1685,13:00 - 14:59
springer,2011-03-03,14,18,60,78,1685,13:00 - 14:59
springer,2011-03-03,15,6,62,68,1685,15:00 - 16:59
springer,2011-03-03,16,6,65,71,1685,15:00 - 16:59
springer,2011-03-03,17,17,185,202,1685,17:00 - 18:59
springer,2011-03-03,18,6,161,167,1685,17:00 - 18:59
springer,2011-03-03,19,5,101,106,1685,19:00 - 20:59
springer,2011-03-03,20,1,69,70,1685,19:00 - 20:59
springer,2011-03-03,21,3,48,51,1685,21:00 - 22:59
springer,2011-03-03,22,3,50,53,1685,21:00 - 22:59
springer,2011-03-03,23,0,23,23,1685,23:00 - 24:59
springer,2011-03-04,0,0,12,12,1944,
springer,2011-03-04,1,0,4,4,1944,01:00 - 02:59
springer,2011-03-04,2,0,2,2,1944,01:00 - 02:59
springer,2011-03-04,3,0,1,1,1944,03:00 - 04:59
springer,2011-03-04,4,1,0,1,1944,03:00 - 04:59
springer,2011-03-04,5,0,7,7,1944,05:00 - 06:59
springer,2011-03-04,6,1,28,29,1944,05:00 - 06:59
springer,2011-03-04,7,0,83,83,1944,07:00 - 08:59
springer,2011-03-04,8,6,222,228,1944,07:00 - 08:59
springer,2011-03-04,9,12,138,150,1944,09:00 - 10:59
springer,2011-03-04,10,10,56,66,1944,09:00 - 10:59
springer,2011-03-04,11,16,73,89,1944,11:00 - 12:59
springer,2011-03-04,12,10,87,97,1944,11:00 - 12:59
springer,2011-03-04,13,13,74,87,1944,13:00 - 14:59
springer,2011-03-04,14,30,65,95,1944,13:00 - 14:59
springer,2011-03-04,15,31,75,106,1944,15:00 - 16:59
springer,2011-03-04,16,17,101,118,1944,15:00 - 16:59
springer,2011-03-04,17,22,206,228,1944,17:00 - 18:59
springer,2011-03-04,18,15,172,187,1944,17:00 - 18:59
springer,2011-03-04,19,5,102,107,1944,19:00 - 20:59
springer,2011-03-04,20,9,78,87,1944,19:00 - 20:59
springer,2011-03-04,21,6,64,70,1944,21:00 - 22:59
springer,2011-03-04,22,4,40,44,1944,21:00 - 22:59
springer,2011-03-04,23,6,40,46,1944,23:00 - 24:59
springer,2011-03-05,0,4,15,19,2077,
springer,2011-03-05,1,5,20,25,2077,01:00 - 02:59
springer,2011-03-05,2,5,15,20,2077,01:00 - 02:59
springer,2011-03-05,3,0,2,2,2077,03:00 - 04:59
springer,2011-03-05,4,0,1,1,2077,03:00 - 04:59
springer,2011-03-05,5,0,3,3,2077,05:00 - 06:59
springer,2011-03-05,6,1,3,4,2077,05:00 - 06:59
springer,2011-03-05,7,5,10,15,2077,07:00 - 08:59
springer,2011-03-05,8,11,34,45,2077,07:00 - 08:59
springer,2011-03-05,9,15,48,63,2077,09:00 - 10:59
springer,2011-03-05,10,34,69,103,2077,09:00 - 10:59
springer,2011-03-05,11,43,116,159,2077,11:00 - 12:59
springer,2011-03-05,12,46,121,167,2077,11:00 - 12:59
springer,2011-03-05,13,60,130,190,2077,13:00 - 14:59
springer,2011-03-05,14,80,118,198,2077,13:00 - 14:59
springer,2011-03-05,15,83,122,205,2077,15:00 - 16:59
springer,2011-03-05,16,74,130,204,2077,15:00 - 16:59
springer,2011-03-05,17,60,104,164,2077,17:00 - 18:59
springer,2011-03-05,18,37,115,152,2077,17:00 - 18:59
springer,2011-03-05,19,27,62,89,2077,19:00 - 20:59
springer,2011-03-05,20,12,58,70,2077,19:00 - 20:59
springer,2011-03-05,21,12,60,72,2077,21:00 - 22:59
springer,2011-03-05,22,16,47,63,2077,21:00 - 22:59
springer,2011-03-05,23,10,34,44,2077,23:00 - 24:59
springer,2011-03-06,0,11,41,52,605,
springer,2011-03-06,1,12,27,39,605,01:00 - 02:59
springer,2011-03-06,2,5,27,32,605,01:00 - 02:59
springer,2011-03-06,3,2,9,11,605,03:00 - 04:59
springer,2011-03-06,4,0,3,3,605,03:00 - 04:59
springer,2011-03-06,6,1,1,2,605,05:00 - 06:59
springer,2011-03-06,7,0,5,5,605,07:00 - 08:59
springer,2011-03-06,8,1,8,9,605,07:00 - 08:59
springer,2011-03-06,9,4,18,22,605,09:00 - 10:59
springer,2011-03-06,10,4,27,31,605,09:00 - 10:59
springer,2011-03-06,11,18,44,62,605,11:00 - 12:59
springer,2011-03-06,12,10,69,79,605,11:00 - 12:59
springer,2011-03-06,13,22,83,105,605,13:00 - 14:59
springer,2011-03-06,14,12,27,39,605,13:00 - 14:59
springer,2011-03-06,15,3,4,7,605,15:00 - 16:59
springer,2011-03-06,16,3,8,11,605,15:00 - 16:59
springer,2011-03-06,17,2,23,25,605,17:00 - 18:59
springer,2011-03-06,18,0,23,23,605,17:00 - 18:59
springer,2011-03-06,19,0,11,11,605,19:00 - 20:59
springer,2011-03-06,20,3,8,11,605,19:00 - 20:59
springer,2011-03-06,21,1,6,7,605,21:00 - 22:59
springer,2011-03-06,22,0,10,10,605,21:00 - 22:59
springer,2011-03-06,23,0,9,9,605,23:00 - 24:59
springer,2011-03-07,0,0,4,4,1872,
springer,2011-03-07,1,0,2,2,1872,01:00 - 02:59
springer,2011-03-07,3,0,1,1,1872,03:00 - 04:59
springer,2011-03-07,4,1,0,1,1872,03:00 - 04:59
springer,2011-03-07,5,0,1,1,1872,05:00 - 06:59
springer,2011-03-07,6,3,31,34,1872,05:00 - 06:59
springer,2011-03-07,7,3,88,91,1872,07:00 - 08:59
springer,2011-03-07,8,11,200,211,1872,07:00 - 08:59
springer,2011-03-07,9,5,129,134,1872,09:00 - 10:59
springer,2011-03-07,10,15,43,58,1872,09:00 - 10:59
springer,2011-03-07,11,19,41,60,1872,11:00 - 12:59
springer,2011-03-07,12,28,68,96,1872,11:00 - 12:59
springer,2011-03-07,13,16,54,70,1872,13:00 - 14:59
springer,2011-03-07,14,21,56,77,1872,13:00 - 14:59
springer,2011-03-07,15,32,64,96,1872,15:00 - 16:59
springer,2011-03-07,16,26,96,122,1872,15:00 - 16:59
springer,2011-03-07,17,27,206,233,1872,17:00 - 18:59
springer,2011-03-07,18,19,214,233,1872,17:00 - 18:59
springer,2011-03-07,19,11,134,145,1872,19:00 - 20:59
springer,2011-03-07,20,5,87,92,1872,19:00 - 20:59
springer,2011-03-07,21,1,53,54,1872,21:00 - 22:59
springer,2011-03-07,22,1,34,35,1872,21:00 - 22:59
springer,2011-03-07,23,0,22,22,1872,23:00 - 24:59
springer,2011-03-08,0,1,9,10,2133,
springer,2011-03-08,1,0,4,4,2133,01:00 - 02:59
springer,2011-03-08,2,1,0,1,2133,01:00 - 02:59
springer,2011-03-08,3,5,2,7,2133,03:00 - 04:59
springer,2011-03-08,4,0,2,2,2133,03:00 - 04:59
springer,2011-03-08,5,2,8,10,2133,05:00 - 06:59
springer,2011-03-08,6,3,42,45,2133,05:00 - 06:59
springer,2011-03-08,7,9,119,128,2133,07:00 - 08:59
springer,2011-03-08,8,10,247,257,2133,07:00 - 08:59
springer,2011-03-08,9,11,140,151,2133,09:00 - 10:59
springer,2011-03-08,10,25,46,71,2133,09:00 - 10:59
springer,2011-03-08,11,26,52,78,2133,11:00 - 12:59
springer,2011-03-08,12,29,70,99,2133,11:00 - 12:59
springer,2011-03-08,13,25,73,98,2133,13:00 - 14:59
springer,2011-03-08,14,16,56,72,2133,13:00 - 14:59
springer,2011-03-08,15,35,77,112,2133,15:00 - 16:59
springer,2011-03-08,16,26,82,108,2133,15:00 - 16:59
springer,2011-03-08,17,39,209,248,2133,17:00 - 18:59
springer,2011-03-08,18,21,214,235,2133,17:00 - 18:59
springer,2011-03-08,19,9,141,150,2133,19:00 - 20:59
springer,2011-03-08,20,2,74,76,2133,19:00 - 20:59
springer,2011-03-08,21,7,68,75,2133,21:00 - 22:59
springer,2011-03-08,22,11,44,55,2133,21:00 - 22:59
springer,2011-03-08,23,3,38,41,2133,23:00 - 24:59
springer,2011-03-09,0,0,9,9,1891,
springer,2011-03-09,1,0,4,4,1891,01:00 - 02:59
springer,2011-03-09,2,1,1,2,1891,01:00 - 02:59
springer,2011-03-09,3,1,2,3,1891,03:00 - 04:59
springer,2011-03-09,4,0,2,2,1891,03:00 - 04:59
springer,2011-03-09,5,1,7,8,1891,05:00 - 06:59
springer,2011-03-09,6,5,44,49,1891,05:00 - 06:59
springer,2011-03-09,7,18,123,141,1891,07:00 - 08:59
springer,2011-03-09,8,11,238,249,1891,07:00 - 08:59
springer,2011-03-09,9,5,136,141,1891,09:00 - 10:59
springer,2011-03-09,10,8,49,57,1891,09:00 - 10:59
springer,2011-03-09,11,15,44,59,1891,11:00 - 12:59
springer,2011-03-09,12,14,84,98,1891,11:00 - 12:59
springer,2011-03-09,13,17,82,99,1891,13:00 - 14:59
springer,2011-03-09,14,10,61,71,1891,13:00 - 14:59
springer,2011-03-09,15,15,64,79,1891,15:00 - 16:59
springer,2011-03-09,16,10,102,112,1891,15:00 - 16:59
springer,2011-03-09,17,18,176,194,1891,17:00 - 18:59
springer,2011-03-09,18,12,176,188,1891,17:00 - 18:59
springer,2011-03-09,19,11,123,134,1891,19:00 - 20:59
springer,2011-03-09,20,4,87,91,1891,19:00 - 20:59
springer,2011-03-09,21,10,52,62,1891,21:00 - 22:59
springer,2011-03-09,22,4,17,21,1891,21:00 - 22:59
springer,2011-03-09,23,1,17,18,1891,23:00 - 24:59
springer,2011-03-10,0,3,0,3,623,
springer,2011-03-10,1,0,2,2,623,01:00 - 02:59
springer,2011-03-10,2,0,1,1,623,01:00 - 02:59
springer,2011-03-10,5,1,2,3,623,05:00 - 06:59
springer,2011-03-10,6,0,12,12,623,05:00 - 06:59
springer,2011-03-10,7,1,36,37,623,07:00 - 08:59
springer,2011-03-10,8,1,43,44,623,07:00 - 08:59
springer,2011-03-10,9,1,23,24,623,09:00 - 10:59
springer,2011-03-10,10,0,17,17,623,09:00 - 10:59
springer,2011-03-10,11,6,5,11,623,11:00 - 12:59
springer,2011-03-10,12,4,30,34,623,11:00 - 12:59
springer,2011-03-10,13,1,11,12,623,13:00 - 14:59
springer,2011-03-10,14,0,12,12,623,13:00 - 14:59
springer,2011-03-10,15,3,11,14,623,15:00 - 16:59
springer,2011-03-10,16,1,20,21,623,15:00 - 16:59
springer,2011-03-10,17,2,109,111,623,17:00 - 18:59
springer,2011-03-10,18,2,80,82,623,17:00 - 18:59
springer,2011-03-10,19,5,51,56,623,19:00 - 20:59
springer,2011-03-10,20,9,29,38,623,19:00 - 20:59
springer,2011-03-10,21,1,27,28,623,21:00 - 22:59
springer,2011-03-10,22,4,30,34,623,21:00 - 22:59
springer,2011-03-10,23,1,26,27,623,23:00 - 24:59
springer,2011-03-11,0,0,6,6,1977,
springer,2011-03-11,1,0,8,8,1977,01:00 - 02:59
springer,2011-03-11,2,2,3,5,1977,01:00 - 02:59
springer,2011-03-11,3,0,2,2,1977,03:00 - 04:59
springer,2011-03-11,5,1,6,7,1977,05:00 - 06:59
springer,2011-03-11,6,1,31,32,1977,05:00 - 06:59
springer,2011-03-11,7,10,104,114,1977,07:00 - 08:59
springer,2011-03-11,8,15,244,259,1977,07:00 - 08:59
springer,2011-03-11,9,13,143,156,1977,09:00 - 10:59
springer,2011-03-11,10,18,60,78,1977,09:00 - 10:59
springer,2011-03-11,11,14,67,81,1977,11:00 - 12:59
springer,2011-03-11,12,15,96,111,1977,11:00 - 12:59
springer,2011-03-11,13,15,92,107,1977,13:00 - 14:59
springer,2011-03-11,14,25,64,89,1977,13:00 - 14:59
springer,2011-03-11,15,21,64,85,1977,15:00 - 16:59
springer,2011-03-11,16,18,95,113,1977,15:00 - 16:59
springer,2011-03-11,17,23,200,223,1977,17:00 - 18:59
springer,2011-03-11,18,19,134,153,1977,17:00 - 18:59
springer,2011-03-11,19,7,111,118,1977,19:00 - 20:59
springer,2011-03-11,20,6,70,76,1977,19:00 - 20:59
springer,2011-03-11,21,10,43,53,1977,21:00 - 22:59
springer,2011-03-11,22,11,53,64,1977,21:00 - 22:59
springer,2011-03-11,23,3,34,37,1977,23:00 - 24:59
springer,2011-03-12,0,4,30,34,2132,
springer,2011-03-12,1,3,15,18,2132,01:00 - 02:59
springer,2011-03-12,2,0,14,14,2132,01:00 - 02:59
springer,2011-03-12,3,1,6,7,2132,03:00 - 04:59
springer,2011-03-12,4,0,1,1,2132,03:00 - 04:59
springer,2011-03-12,5,0,2,2,2132,05:00 - 06:59
springer,2011-03-12,6,2,2,4,2132,05:00 - 06:59
springer,2011-03-12,7,4,19,23,2132,07:00 - 08:59
springer,2011-03-12,8,9,44,53,2132,07:00 - 08:59
springer,2011-03-12,9,25,76,101,2132,09:00 - 10:59
springer,2011-03-12,10,21,78,99,2132,09:00 - 10:59
springer,2011-03-12,11,36,83,119,2132,11:00 - 12:59
springer,2011-03-12,12,51,107,158,2132,11:00 - 12:59
springer,2011-03-12,13,62,95,157,2132,13:00 - 14:59
springer,2011-03-12,14,70,96,166,2132,13:00 - 14:59
springer,2011-03-12,15,81,101,182,2132,15:00 - 16:59
springer,2011-03-12,16,100,144,244,2132,15:00 - 16:59
springer,2011-03-12,17,99,114,213,2132,17:00 - 18:59
springer,2011-03-12,18,54,91,145,2132,17:00 - 18:59
springer,2011-03-12,19,26,86,112,2132,19:00 - 20:59
springer,2011-03-12,20,22,64,86,2132,19:00 - 20:59
springer,2011-03-12,21,36,46,82,2132,21:00 - 22:59
springer,2011-03-12,22,7,56,63,2132,21:00 - 22:59
springer,2011-03-12,23,11,38,49,2132,23:00 - 24:59
springer,2011-03-13,0,3,35,38,2417,
springer,2011-03-13,1,10,23,33,2417,01:00 - 02:59
springer,2011-03-13,3,6,17,23,2417,03:00 - 04:59
springer,2011-03-13,4,4,9,13,2417,03:00 - 04:59
springer,2011-03-13,5,0,3,3,2417,05:00 - 06:59
springer,2011-03-13,6,0,2,2,2417,05:00 - 06:59
springer,2011-03-13,7,2,8,10,2417,07:00 - 08:59
springer,2011-03-13,8,11,23,34,2417,07:00 - 08:59
springer,2011-03-13,9,8,36,44,2417,09:00 - 10:59
springer,2011-03-13,10,36,86,122,2417,09:00 - 10:59
springer,2011-03-13,11,88,93,181,2417,11:00 - 12:59
springer,2011-03-13,12,74,120,194,2417,11:00 - 12:59
springer,2011-03-13,13,97,124,221,2417,13:00 - 14:59
springer,2011-03-13,14,144,106,250,2417,13:00 - 14:59
springer,2011-03-13,15,149,155,304,2417,15:00 - 16:59
springer,2011-03-13,16,124,132,256,2417,15:00 - 16:59
springer,2011-03-13,17,98,143,241,2417,17:00 - 18:59
springer,2011-03-13,18,55,92,147,2417,17:00 - 18:59
springer,2011-03-13,19,28,73,101,2417,19:00 - 20:59
springer,2011-03-13,20,23,54,77,2417,19:00 - 20:59
springer,2011-03-13,21,9,49,58,2417,21:00 - 22:59
springer,2011-03-13,22,8,29,37,2417,21:00 - 22:59
springer,2011-03-13,23,5,23,28,2417,23:00 - 24:59
springer,2011-03-14,0,4,7,11,2046,
springer,2011-03-14,1,0,1,1,2046,01:00 - 02:59
springer,2011-03-14,2,0,1,1,2046,01:00 - 02:59
springer,2011-03-14,3,0,3,3,2046,03:00 - 04:59
springer,2011-03-14,5,0,8,8,2046,05:00 - 06:59
springer,2011-03-14,6,1,27,28,2046,05:00 - 06:59
springer,2011-03-14,7,4,84,88,2046,07:00 - 08:59
springer,2011-03-14,8,24,217,241,2046,07:00 - 08:59
springer,2011-03-14,9,13,127,140,2046,09:00 - 10:59
springer,2011-03-14,10,27,57,84,2046,09:00 - 10:59
springer,2011-03-14,11,26,45,71,2046,11:00 - 12:59
springer,2011-03-14,12,40,54,94,2046,11:00 - 12:59
springer,2011-03-14,13,24,51,75,2046,13:00 - 14:59
springer,2011-03-14,14,27,52,79,2046,13:00 - 14:59
springer,2011-03-14,15,24,77,101,2046,15:00 - 16:59
springer,2011-03-14,16,27,80,107,2046,15:00 - 16:59
springer,2011-03-14,17,42,229,271,2046,17:00 - 18:59
springer,2011-03-14,18,25,210,235,2046,17:00 - 18:59
springer,2011-03-14,19,17,133,150,2046,19:00 - 20:59
springer,2011-03-14,20,23,106,129,2046,19:00 - 20:59
springer,2011-03-14,21,5,58,63,2046,21:00 - 22:59
springer,2011-03-14,22,4,43,47,2046,21:00 - 22:59
springer,2011-03-14,23,2,17,19,2046,23:00 - 24:59
springer,2011-03-15,0,7,7,14,2056,
springer,2011-03-15,1,4,6,10,2056,01:00 - 02:59
springer,2011-03-15,2,1,2,3,2056,01:00 - 02:59
springer,2011-03-15,4,1,1,2,2056,03:00 - 04:59
springer,2011-03-15,5,0,11,11,2056,05:00 - 06:59
springer,2011-03-15,6,3,32,35,2056,05:00 - 06:59
springer,2011-03-15,7,10,109,119,2056,07:00 - 08:59
springer,2011-03-15,8,23,259,282,2056,07:00 - 08:59
springer,2011-03-15,9,10,147,157,2056,09:00 - 10:59
springer,2011-03-15,10,22,56,78,2056,09:00 - 10:59
springer,2011-03-15,11,27,51,78,2056,11:00 - 12:59
springer,2011-03-15,12,32,70,102,2056,11:00 - 12:59
springer,2011-03-15,13,23,74,97,2056,13:00 - 14:59
springer,2011-03-15,14,14,74,88,2056,13:00 - 14:59
springer,2011-03-15,15,24,66,90,2056,15:00 - 16:59
springer,2011-03-15,16,21,93,114,2056,15:00 - 16:59
springer,2011-03-15,17,22,195,217,2056,17:00 - 18:59
springer,2011-03-15,18,18,207,225,2056,17:00 - 18:59
springer,2011-03-15,19,14,138,152,2056,19:00 - 20:59
springer,2011-03-15,20,9,79,88,2056,19:00 - 20:59
springer,2011-03-15,21,2,53,55,2056,21:00 - 22:59
springer,2011-03-15,22,1,20,21,2056,21:00 - 22:59
springer,2011-03-15,23,1,17,18,2056,23:00 - 24:59
springer,2011-03-16,0,0,8,8,2192,
springer,2011-03-16,1,1,2,3,2192,01:00 - 02:59
springer,2011-03-16,3,1,2,3,2192,03:00 - 04:59
springer,2011-03-16,4,0,1,1,2192,03:00 - 04:59
springer,2011-03-16,5,0,3,3,2192,05:00 - 06:59
springer,2011-03-16,6,1,30,31,2192,05:00 - 06:59
springer,2011-03-16,7,10,101,111,2192,07:00 - 08:59
springer,2011-03-16,8,26,227,253,2192,07:00 - 08:59
springer,2011-03-16,9,10,144,154,2192,09:00 - 10:59
springer,2011-03-16,10,19,49,68,2192,09:00 - 10:59
springer,2011-03-16,11,13,62,75,2192,11:00 - 12:59
springer,2011-03-16,12,23,65,88,2192,11:00 - 12:59
springer,2011-03-16,13,18,81,99,2192,13:00 - 14:59
springer,2011-03-16,14,33,67,100,2192,13:00 - 14:59
springer,2011-03-16,15,22,79,101,2192,15:00 - 16:59
springer,2011-03-16,16,30,121,151,2192,15:00 - 16:59
springer,2011-03-16,17,37,216,253,2192,17:00 - 18:59
springer,2011-03-16,18,26,211,237,2192,17:00 - 18:59
springer,2011-03-16,19,18,150,168,2192,19:00 - 20:59
springer,2011-03-16,20,10,111,121,2192,19:00 - 20:59
springer,2011-03-16,21,3,75,78,2192,21:00 - 22:59
springer,2011-03-16,22,11,48,59,2192,21:00 - 22:59
springer,2011-03-16,23,9,18,27,2192,23:00 - 24:59
springer,2011-03-17,0,4,19,23,2744,
springer,2011-03-17,1,1,11,12,2744,01:00 - 02:59
springer,2011-03-17,2,3,5,8,2744,01:00 - 02:59
springer,2011-03-17,3,1,1,2,2744,03:00 - 04:59
springer,2011-03-17,4,0,3,3,2744,03:00 - 04:59
springer,2011-03-17,5,0,13,13,2744,05:00 - 06:59
springer,2011-03-17,6,4,47,51,2744,05:00 - 06:59
springer,2011-03-17,7,12,128,140,2744,07:00 - 08:59
springer,2011-03-17,8,17,282,299,2744,07:00 - 08:59
springer,2011-03-17,9,23,162,185,2744,09:00 - 10:59
springer,2011-03-17,10,9,69,78,2744,09:00 - 10:59
springer,2011-03-17,11,20,66,86,2744,11:00 - 12:59
springer,2011-03-17,12,24,81,105,2744,11:00 - 12:59
springer,2011-03-17,13,26,85,111,2744,13:00 - 14:59
springer,2011-03-17,14,32,87,119,2744,13:00 - 14:59
springer,2011-03-17,15,30,95,125,2744,15:00 - 16:59
springer,2011-03-17,16,34,108,142,2744,15:00 - 16:59
springer,2011-03-17,17,48,265,313,2744,17:00 - 18:59
springer,2011-03-17,18,50,260,310,2744,17:00 - 18:59
springer,2011-03-17,19,18,189,207,2744,19:00 - 20:59
springer,2011-03-17,20,25,112,137,2744,19:00 - 20:59
springer,2011-03-17,21,19,119,138,2744,21:00 - 22:59
springer,2011-03-17,22,17,70,87,2744,21:00 - 22:59
springer,2011-03-17,23,7,43,50,2744,23:00 - 24:59
springer,2011-03-18,0,5,24,29,3239,
springer,2011-03-18,1,4,12,16,3239,01:00 - 02:59
springer,2011-03-18,2,5,9,14,3239,01:00 - 02:59
springer,2011-03-18,3,1,4,5,3239,03:00 - 04:59
springer,2011-03-18,5,2,8,10,3239,05:00 - 06:59
springer,2011-03-18,6,1,35,36,3239,05:00 - 06:59
springer,2011-03-18,7,11,112,123,3239,07:00 - 08:59
springer,2011-03-18,8,24,256,280,3239,07:00 - 08:59
springer,2011-03-18,9,18,192,210,3239,09:00 - 10:59
springer,2011-03-18,10,43,74,117,3239,09:00 - 10:59
springer,2011-03-18,11,55,104,159,3239,11:00 - 12:59
springer,2011-03-18,12,72,123,195,3239,11:00 - 12:59
springer,2011-03-18,13,57,118,175,3239,13:00 - 14:59
springer,2011-03-18,14,71,103,174,3239,13:00 - 14:59
springer,2011-03-18,15,62,111,173,3239,15:00 - 16:59
springer,2011-03-18,16,67,137,204,3239,15:00 - 16:59
springer,2011-03-18,17,95,237,332,3239,17:00 - 18:59
springer,2011-03-18,18,84,247,331,3239,17:00 - 18:59
springer,2011-03-18,19,58,132,190,3239,19:00 - 20:59
springer,2011-03-18,20,46,103,149,3239,19:00 - 20:59
springer,2011-03-18,21,22,91,113,3239,21:00 - 22:59
springer,2011-03-18,22,55,63,118,3239,21:00 - 22:59
springer,2011-03-18,23,26,60,86,3239,23:00 - 24:59
springer,2011-03-19,0,26,50,76,3117,
springer,2011-03-19,1,16,35,51,3117,01:00 - 02:59
springer,2011-03-19,2,5,20,25,3117,01:00 - 02:59
springer,2011-03-19,3,1,7,8,3117,03:00 - 04:59
springer,2011-03-19,4,1,2,3,3117,03:00 - 04:59
springer,2011-03-19,5,0,2,2,3117,05:00 - 06:59
springer,2011-03-19,6,0,10,10,3117,05:00 - 06:59
springer,2011-03-19,7,4,9,13,3117,07:00 - 08:59
springer,2011-03-19,8,11,37,48,3117,07:00 - 08:59
springer,2011-03-19,9,35,41,76,3117,09:00 - 10:59
springer,2011-03-19,10,55,85,140,3117,09:00 - 10:59
springer,2011-03-19,11,90,106,196,3117,11:00 - 12:59
springer,2011-03-19,12,126,141,267,3117,11:00 - 12:59
springer,2011-03-19,13,174,127,301,3117,13:00 - 14:59
springer,2011-03-19,14,168,144,312,3117,13:00 - 14:59
springer,2011-03-19,15,170,143,313,3117,15:00 - 16:59
springer,2011-03-19,16,175,129,304,3117,15:00 - 16:59
springer,2011-03-19,17,138,140,278,3117,17:00 - 18:59
springer,2011-03-19,18,92,125,217,3117,17:00 - 18:59
springer,2011-03-19,19,38,116,154,3117,19:00 - 20:59
springer,2011-03-19,20,39,69,108,3117,19:00 - 20:59
springer,2011-03-19,21,20,73,93,3117,21:00 - 22:59
springer,2011-03-19,22,27,45,72,3117,21:00 - 22:59
springer,2011-03-19,23,13,37,50,3117,23:00 - 24:59
springer,2011-03-20,0,7,33,40,2471,
springer,2011-03-20,1,2,22,24,2471,01:00 - 02:59
springer,2011-03-20,2,6,24,30,2471,01:00 - 02:59
springer,2011-03-20,3,1,11,12,2471,03:00 - 04:59
springer,2011-03-20,4,2,1,3,2471,03:00 - 04:59
springer,2011-03-20,5,3,6,9,2471,05:00 - 06:59
springer,2011-03-20,6,1,3,4,2471,05:00 - 06:59
springer,2011-03-20,7,5,9,14,2471,07:00 - 08:59
springer,2011-03-20,8,7,30,37,2471,07:00 - 08:59
springer,2011-03-20,9,35,43,78,2471,09:00 - 10:59
springer,2011-03-20,10,55,81,136,2471,09:00 - 10:59
springer,2011-03-20,11,92,111,203,2471,11:00 - 12:59
springer,2011-03-20,12,120,108,228,2471,11:00 - 12:59
springer,2011-03-20,13,88,115,203,2471,13:00 - 14:59
springer,2011-03-20,14,145,134,279,2471,13:00 - 14:59
springer,2011-03-20,15,172,136,308,2471,15:00 - 16:59
springer,2011-03-20,16,92,132,224,2471,15:00 - 16:59
springer,2011-03-20,17,83,143,226,2471,17:00 - 18:59
springer,2011-03-20,18,58,98,156,2471,17:00 - 18:59
springer,2011-03-20,19,21,58,79,2471,19:00 - 20:59
springer,2011-03-20,20,21,46,67,2471,19:00 - 20:59
springer,2011-03-20,21,10,39,49,2471,21:00 - 22:59
springer,2011-03-20,22,8,30,38,2471,21:00 - 22:59
springer,2011-03-20,23,13,11,24,2471,23:00 - 24:59
summer,2011-03-21,0,2,11,13,2077,
summer,2011-03-21,1,1,6,7,2077,01:00 - 02:59
summer,2011-03-21,2,1,5,6,2077,01:00 - 02:59
summer,2011-03-21,3,0,1,1,2077,03:00 - 04:59
summer,2011-03-21,5,1,1,2,2077,05:00 - 06:59
summer,2011-03-21,6,2,30,32,2077,05:00 - 06:59
summer,2011-03-21,7,3,15,18,2077,07:00 - 08:59
summer,2011-03-21,8,3,95,98,2077,07:00 - 08:59
summer,2011-03-21,9,12,115,127,2077,09:00 - 10:59
summer,2011-03-21,10,17,45,62,2077,09:00 - 10:59
summer,2011-03-21,11,32,47,79,2077,11:00 - 12:59
summer,2011-03-21,12,25,56,81,2077,11:00 - 12:59
summer,2011-03-21,13,35,77,112,2077,13:00 - 14:59
summer,2011-03-21,14,36,65,101,2077,13:00 - 14:59
summer,2011-03-21,15,41,66,107,2077,15:00 - 16:59
summer,2011-03-21,16,29,112,141,2077,15:00 - 16:59
summer,2011-03-21,17,41,231,272,2077,17:00 - 18:59
summer,2011-03-21,18,44,232,276,2077,17:00 - 18:59
summer,2011-03-21,19,22,199,221,2077,19:00 - 20:59
summer,2011-03-21,20,16,106,122,2077,19:00 - 20:59
summer,2011-03-21,21,12,79,91,2077,21:00 - 22:59
summer,2011-03-21,22,18,60,78,2077,21:00 - 22:59
summer,2011-03-21,23,8,22,30,2077,23:00 - 24:59
summer,2011-03-22,0,4,7,11,2703,
summer,2011-03-22,1,6,13,19,2703,01:00 - 02:59
summer,2011-03-22,2,0,1,1,2703,01:00 - 02:59
summer,2011-03-22,3,3,2,5,2703,03:00 - 04:59
summer,2011-03-22,4,0,1,1,2703,03:00 - 04:59
summer,2011-03-22,5,1,11,12,2703,05:00 - 06:59
summer,2011-03-22,6,2,58,60,2703,05:00 - 06:59
summer,2011-03-22,7,4,132,136,2703,07:00 - 08:59
summer,2011-03-22,8,24,312,336,2703,07:00 - 08:59
summer,2011-03-22,9,19,159,178,2703,09:00 - 10:59
summer,2011-03-22,10,29,95,124,2703,09:00 - 10:59
summer,2011-03-22,11,22,64,86,2703,11:00 - 12:59
summer,2011-03-22,12,35,86,121,2703,11:00 - 12:59
summer,2011-03-22,13,21,85,106,2703,13:00 - 14:59
summer,2011-03-22,14,30,71,101,2703,13:00 - 14:59
summer,2011-03-22,15,55,79,134,2703,15:00 - 16:59
summer,2011-03-22,16,40,125,165,2703,15:00 - 16:59
summer,2011-03-22,17,42,265,307,2703,17:00 - 18:59
summer,2011-03-22,18,41,271,312,2703,17:00 - 18:59
summer,2011-03-22,19,22,142,164,2703,19:00 - 20:59
summer,2011-03-22,20,19,116,135,2703,19:00 - 20:59
summer,2011-03-22,21,24,63,87,2703,21:00 - 22:59
summer,2011-03-22,22,13,57,70,2703,21:00 - 22:59
summer,2011-03-22,23,4,28,32,2703,23:00 - 24:59
summer,2011-03-23,0,3,8,11,2121,
summer,2011-03-23,1,0,7,7,2121,01:00 - 02:59
summer,2011-03-23,2,1,1,2,2121,01:00 - 02:59
summer,2011-03-23,3,0,3,3,2121,03:00 - 04:59
summer,2011-03-23,5,0,10,10,2121,05:00 - 06:59
summer,2011-03-23,6,1,43,44,2121,05:00 - 06:59
summer,2011-03-23,7,7,111,118,2121,07:00 - 08:59
summer,2011-03-23,8,14,247,261,2121,07:00 - 08:59
summer,2011-03-23,9,8,174,182,2121,09:00 - 10:59
summer,2011-03-23,10,15,60,75,2121,09:00 - 10:59
summer,2011-03-23,11,18,53,71,2121,11:00 - 12:59
summer,2011-03-23,12,14,73,87,2121,11:00 - 12:59
summer,2011-03-23,13,14,94,108,2121,13:00 - 14:59
summer,2011-03-23,14,13,71,84,2121,13:00 - 14:59
summer,2011-03-23,15,11,74,85,2121,15:00 - 16:59
summer,2011-03-23,16,13,123,136,2121,15:00 - 16:59
summer,2011-03-23,17,28,245,273,2121,17:00 - 18:59
summer,2011-03-23,18,20,218,238,2121,17:00 - 18:59
summer,2011-03-23,19,12,147,159,2121,19:00 - 20:59
summer,2011-03-23,20,3,72,75,2121,19:00 - 20:59
summer,2011-03-23,21,0,22,22,2121,21:00 - 22:59
summer,2011-03-23,22,6,38,44,2121,21:00 - 22:59
summer,2011-03-23,23,2,24,26,2121,23:00 - 24:59
summer,2011-03-24,0,0,11,11,1865,
summer,2011-03-24,1,0,3,3,1865,01:00 - 02:59
summer,2011-03-24,2,0,6,6,1865,01:00 - 02:59
summer,2011-03-24,3,1,0,1,1865,03:00 - 04:59
summer,2011-03-24,4,0,1,1,1865,03:00 - 04:59
summer,2011-03-24,5,1,8,9,1865,05:00 - 06:59
summer,2011-03-24,6,0,41,41,1865,05:00 - 06:59
summer,2011-03-24,7,2,106,108,1865,07:00 - 08:59
summer,2011-03-24,8,4,120,124,1865,07:00 - 08:59
summer,2011-03-24,9,3,94,97,1865,09:00 - 10:59
summer,2011-03-24,10,10,55,65,1865,09:00 - 10:59
summer,2011-03-24,11,10,61,71,1865,11:00 - 12:59
summer,2011-03-24,12,12,82,94,1865,11:00 - 12:59
summer,2011-03-24,13,11,90,101,1865,13:00 - 14:59
summer,2011-03-24,14,17,66,83,1865,13:00 - 14:59
summer,2011-03-24,15,13,77,90,1865,15:00 - 16:59
summer,2011-03-24,16,6,78,84,1865,15:00 - 16:59
summer,2011-03-24,17,12,221,233,1865,17:00 - 18:59
summer,2011-03-24,18,17,197,214,1865,17:00 - 18:59
summer,2011-03-24,19,16,122,138,1865,19:00 - 20:59
summer,2011-03-24,20,8,110,118,1865,19:00 - 20:59
summer,2011-03-24,21,11,67,78,1865,21:00 - 22:59
summer,2011-03-24,22,3,59,62,1865,21:00 - 22:59
summer,2011-03-24,23,9,24,33,1865,23:00 - 24:59
summer,2011-03-25,0,1,17,18,2210,
summer,2011-03-25,1,0,5,5,2210,01:00 - 02:59
summer,2011-03-25,2,0,5,5,2210,01:00 - 02:59
summer,2011-03-25,3,0,2,2,2210,03:00 - 04:59
summer,2011-03-25,4,3,2,5,2210,03:00 - 04:59
summer,2011-03-25,5,0,9,9,2210,05:00 - 06:59
summer,2011-03-25,6,0,32,32,2210,05:00 - 06:59
summer,2011-03-25,7,4,100,104,2210,07:00 - 08:59
summer,2011-03-25,8,9,228,237,2210,07:00 - 08:59
summer,2011-03-25,9,16,150,166,2210,09:00 - 10:59
summer,2011-03-25,10,15,53,68,2210,09:00 - 10:59
summer,2011-03-25,11,17,58,75,2210,11:00 - 12:59
summer,2011-03-25,12,37,108,145,2210,11:00 - 12:59
summer,2011-03-25,13,34,104,138,2210,13:00 - 14:59
summer,2011-03-25,14,30,103,133,2210,13:00 - 14:59
summer,2011-03-25,15,43,79,122,2210,15:00 - 16:59
summer,2011-03-25,16,23,127,150,2210,15:00 - 16:59
summer,2011-03-25,17,23,202,225,2210,17:00 - 18:59
summer,2011-03-25,18,8,190,198,2210,17:00 - 18:59
summer,2011-03-25,19,9,126,135,2210,19:00 - 20:59
summer,2011-03-25,20,6,75,81,2210,19:00 - 20:59
summer,2011-03-25,21,11,64,75,2210,21:00 - 22:59
summer,2011-03-25,22,3,40,43,2210,21:00 - 22:59
summer,2011-03-25,23,8,31,39,2210,23:00 - 24:59
summer,2011-03-26,0,3,25,28,2496,
summer,2011-03-26,1,3,24,27,2496,01:00 - 02:59
summer,2011-03-26,2,4,21,25,2496,01:00 - 02:59
summer,2011-03-26,3,2,7,9,2496,03:00 - 04:59
summer,2011-03-26,4,2,4,6,2496,03:00 - 04:59
summer,2011-03-26,5,0,8,8,2496,05:00 - 06:59
summer,2011-03-26,6,2,8,10,2496,05:00 - 06:59
summer,2011-03-26,7,18,23,41,2496,07:00 - 08:59
summer,2011-03-26,8,24,42,66,2496,07:00 - 08:59
summer,2011-03-26,9,32,68,100,2496,09:00 - 10:59
summer,2011-03-26,10,32,93,125,2496,09:00 - 10:59
summer,2011-03-26,11,75,93,168,2496,11:00 - 12:59
summer,2011-03-26,12,98,129,227,2496,11:00 - 12:59
summer,2011-03-26,13,94,145,239,2496,13:00 - 14:59
summer,2011-03-26,14,93,123,216,2496,13:00 - 14:59
summer,2011-03-26,15,110,109,219,2496,15:00 - 16:59
summer,2011-03-26,16,118,130,248,2496,15:00 - 16:59
summer,2011-03-26,17,102,101,203,2496,17:00 - 18:59
summer,2011-03-26,18,64,89,153,2496,17:00 - 18:59
summer,2011-03-26,19,45,93,138,2496,19:00 - 20:59
summer,2011-03-26,20,18,67,85,2496,19:00 - 20:59
summer,2011-03-26,21,15,36,51,2496,21:00 - 22:59
summer,2011-03-26,22,17,46,63,2496,21:00 - 22:59
summer,2011-03-26,23,10,31,41,2496,23:00 - 24:59
summer,2011-03-27,0,5,26,31,1693,
summer,2011-03-27,1,3,17,20,1693,01:00 - 02:59
summer,2011-03-27,2,6,15,21,1693,01:00 - 02:59
summer,2011-03-27,3,0,14,14,1693,03:00 - 04:59
summer,2011-03-27,4,1,5,6,1693,03:00 - 04:59
summer,2011-03-27,6,0,2,2,1693,05:00 - 06:59
summer,2011-03-27,7,0,7,7,1693,07:00 - 08:59
summer,2011-03-27,8,6,8,14,1693,07:00 - 08:59
summer,2011-03-27,9,17,37,54,1693,09:00 - 10:59
summer,2011-03-27,10,27,59,86,1693,09:00 - 10:59
summer,2011-03-27,11,23,85,108,1693,11:00 - 12:59
summer,2011-03-27,12,43,120,163,1693,11:00 - 12:59
summer,2011-03-27,13,47,100,147,1693,13:00 - 14:59
summer,2011-03-27,14,61,103,164,1693,13:00 - 14:59
summer,2011-03-27,15,61,111,172,1693,15:00 - 16:59
summer,2011-03-27,16,45,98,143,1693,15:00 - 16:59
summer,2011-03-27,17,50,109,159,1693,17:00 - 18:59
summer,2011-03-27,18,32,105,137,1693,17:00 - 18:59
summer,2011-03-27,19,23,80,103,1693,19:00 - 20:59
summer,2011-03-27,20,7,50,57,1693,19:00 - 20:59
summer,2011-03-27,21,7,29,36,1693,21:00 - 22:59
summer,2011-03-27,22,5,25,30,1693,21:00 - 22:59
summer,2011-03-27,23,3,16,19,1693,23:00 - 24:59
summer,2011-03-28,0,1,11,12,2028,
summer,2011-03-28,1,2,4,6,2028,01:00 - 02:59
summer,2011-03-28,2,0,5,5,2028,01:00 - 02:59
summer,2011-03-28,3,0,2,2,2028,03:00 - 04:59
summer,2011-03-28,5,0,8,8,2028,05:00 - 06:59
summer,2011-03-28,6,0,40,40,2028,05:00 - 06:59
summer,2011-03-28,7,6,104,110,2028,07:00 - 08:59
summer,2011-03-28,8,15,239,254,2028,07:00 - 08:59
summer,2011-03-28,9,12,109,121,2028,09:00 - 10:59
summer,2011-03-28,10,22,47,69,2028,09:00 - 10:59
summer,2011-03-28,11,18,39,57,2028,11:00 - 12:59
summer,2011-03-28,12,8,71,79,2028,11:00 - 12:59
summer,2011-03-28,13,14,69,83,2028,13:00 - 14:59
summer,2011-03-28,14,15,65,80,2028,13:00 - 14:59
summer,2011-03-28,15,19,53,72,2028,15:00 - 16:59
summer,2011-03-28,16,15,117,132,2028,15:00 - 16:59
summer,2011-03-28,17,25,227,252,2028,17:00 - 18:59
summer,2011-03-28,18,21,220,241,2028,17:00 - 18:59
summer,2011-03-28,19,17,156,173,2028,19:00 - 20:59
summer,2011-03-28,20,5,107,112,2028,19:00 - 20:59
summer,2011-03-28,21,6,55,61,2028,21:00 - 22:59
summer,2011-03-28,22,0,40,40,2028,21:00 - 22:59
summer,2011-03-28,23,1,18,19,2028,23:00 - 24:59
summer,2011-03-29,0,1,15,16,2425,
summer,2011-03-29,1,0,4,4,2425,01:00 - 02:59
summer,2011-03-29,2,0,3,3,2425,01:00 - 02:59
summer,2011-03-29,3,2,1,3,2425,03:00 - 04:59
summer,2011-03-29,4,1,1,2,2425,03:00 - 04:59
summer,2011-03-29,5,0,8,8,2425,05:00 - 06:59
summer,2011-03-29,6,4,46,50,2425,05:00 - 06:59
summer,2011-03-29,7,5,128,133,2425,07:00 - 08:59
summer,2011-03-29,8,19,268,287,2425,07:00 - 08:59
summer,2011-03-29,9,16,156,172,2425,09:00 - 10:59
summer,2011-03-29,10,13,46,59,2425,09:00 - 10:59
summer,2011-03-29,11,18,63,81,2425,11:00 - 12:59
summer,2011-03-29,12,29,77,106,2425,11:00 - 12:59
summer,2011-03-29,13,24,80,104,2425,13:00 - 14:59
summer,2011-03-29,14,20,66,86,2425,13:00 - 14:59
summer,2011-03-29,15,22,65,87,2425,15:00 - 16:59
summer,2011-03-29,16,12,124,136,2425,15:00 - 16:59
summer,2011-03-29,17,34,265,299,2425,17:00 - 18:59
summer,2011-03-29,18,42,252,294,2425,17:00 - 18:59
summer,2011-03-29,19,20,170,190,2425,19:00 - 20:59
summer,2011-03-29,20,13,119,132,2425,19:00 - 20:59
summer,2011-03-29,21,8,75,83,2425,21:00 - 22:59
summer,2011-03-29,22,6,49,55,2425,21:00 - 22:59
summer,2011-03-29,23,8,27,35,2425,23:00 - 24:59
summer,2011-03-30,0,3,8,11,1536,
summer,2011-03-30,1,1,9,10,1536,01:00 - 02:59
summer,2011-03-30,2,0,4,4,1536,01:00 - 02:59
summer,2011-03-30,3,0,4,4,1536,03:00 - 04:59
summer,2011-03-30,4,1,0,1,1536,03:00 - 04:59
summer,2011-03-30,5,0,7,7,1536,05:00 - 06:59
summer,2011-03-30,6,4,44,48,1536,05:00 - 06:59
summer,2011-03-30,7,8,128,136,1536,07:00 - 08:59
summer,2011-03-30,8,16,247,263,1536,07:00 - 08:59
summer,2011-03-30,9,7,147,154,1536,09:00 - 10:59
summer,2011-03-30,10,13,51,64,1536,09:00 - 10:59
summer,2011-03-30,11,26,64,90,1536,11:00 - 12:59
summer,2011-03-30,12,15,65,80,1536,11:00 - 12:59
summer,2011-03-30,13,14,84,98,1536,13:00 - 14:59
summer,2011-03-30,14,16,64,80,1536,13:00 - 14:59
summer,2011-03-30,15,14,56,70,1536,15:00 - 16:59
summer,2011-03-30,16,0,36,36,1536,15:00 - 16:59
summer,2011-03-30,17,11,105,116,1536,17:00 - 18:59
summer,2011-03-30,18,6,79,85,1536,17:00 - 18:59
summer,2011-03-30,19,5,67,72,1536,19:00 - 20:59
summer,2011-03-30,20,4,40,44,1536,19:00 - 20:59
summer,2011-03-30,21,0,27,27,1536,21:00 - 22:59
summer,2011-03-30,22,3,21,24,1536,21:00 - 22:59
summer,2011-03-30,23,1,11,12,1536,23:00 - 24:59
summer,2011-03-31,0,0,3,3,1685,
summer,2011-03-31,1,1,4,5,1685,01:00 - 02:59
summer,2011-03-31,2,0,5,5,1685,01:00 - 02:59
summer,2011-03-31,3,0,1,1,1685,03:00 - 04:59
summer,2011-03-31,4,0,2,2,1685,03:00 - 04:59
summer,2011-03-31,5,0,8,8,1685,05:00 - 06:59
summer,2011-03-31,6,2,34,36,1685,05:00 - 06:59
summer,2011-03-31,7,5,87,92,1685,07:00 - 08:59
summer,2011-03-31,8,7,185,192,1685,07:00 - 08:59
summer,2011-03-31,9,6,126,132,1685,09:00 - 10:59
summer,2011-03-31,10,15,54,69,1685,09:00 - 10:59
summer,2011-03-31,11,6,52,58,1685,11:00 - 12:59
summer,2011-03-31,12,17,73,90,1685,11:00 - 12:59
summer,2011-03-31,13,13,55,68,1685,13:00 - 14:59
summer,2011-03-31,14,27,49,76,1685,13:00 - 14:59
summer,2011-03-31,15,4,61,65,1685,15:00 - 16:59
summer,2011-03-31,16,13,72,85,1685,15:00 - 16:59
summer,2011-03-31,17,15,153,168,1685,17:00 - 18:59
summer,2011-03-31,18,12,165,177,1685,17:00 - 18:59
summer,2011-03-31,19,12,118,130,1685,19:00 - 20:59
summer,2011-03-31,20,6,79,85,1685,19:00 - 20:59
summer,2011-03-31,21,7,53,60,1685,21:00 - 22:59
summer,2011-03-31,22,7,44,51,1685,21:00 - 22:59
summer,2011-03-31,23,4,23,27,1685,23:00 - 24:59
summer,2011-04-01,0,0,6,6,2227,
summer,2011-04-01,1,0,4,4,2227,01:00 - 02:59
summer,2011-04-01,2,0,7,7,2227,01:00 - 02:59
summer,2011-04-01,3,0,4,4,2227,03:00 - 04:59
summer,2011-04-01,4,0,3,3,2227,03:00 - 04:59
summer,2011-04-01,5,1,11,12,2227,05:00 - 06:59
summer,2011-04-01,6,2,26,28,2227,05:00 - 06:59
summer,2011-04-01,7,4,91,95,2227,07:00 - 08:59
summer,2011-04-01,8,8,198,206,2227,07:00 - 08:59
summer,2011-04-01,9,11,162,173,2227,09:00 - 10:59
summer,2011-04-01,10,12,63,75,2227,09:00 - 10:59
summer,2011-04-01,11,17,72,89,2227,11:00 - 12:59
summer,2011-04-01,12,15,80,95,2227,11:00 - 12:59
summer,2011-04-01,13,18,92,110,2227,13:00 - 14:59
summer,2011-04-01,14,26,61,87,2227,13:00 - 14:59
summer,2011-04-01,15,30,81,111,2227,15:00 - 16:59
summer,2011-04-01,16,42,125,167,2227,15:00 - 16:59
summer,2011-04-01,17,36,245,281,2227,17:00 - 18:59
summer,2011-04-01,18,36,205,241,2227,17:00 - 18:59
summer,2011-04-01,19,16,120,136,2227,19:00 - 20:59
summer,2011-04-01,20,2,75,77,2227,19:00 - 20:59
summer,2011-04-01,21,9,84,93,2227,21:00 - 22:59
summer,2011-04-01,22,10,64,74,2227,21:00 - 22:59
summer,2011-04-01,23,12,41,53,2227,23:00 - 24:59
summer,2011-04-02,0,3,29,32,2252,
summer,2011-04-02,1,4,28,32,2252,01:00 - 02:59
summer,2011-04-02,2,1,20,21,2252,01:00 - 02:59
summer,2011-04-02,3,1,8,9,2252,03:00 - 04:59
summer,2011-04-02,4,0,5,5,2252,03:00 - 04:59
summer,2011-04-02,5,1,4,5,2252,05:00 - 06:59
summer,2011-04-02,6,5,7,12,2252,05:00 - 06:59
summer,2011-04-02,7,2,16,18,2252,07:00 - 08:59
summer,2011-04-02,8,10,45,55,2252,07:00 - 08:59
summer,2011-04-02,9,22,65,87,2252,09:00 - 10:59
summer,2011-04-02,10,41,113,154,2252,09:00 - 10:59
summer,2011-04-02,11,72,126,198,2252,11:00 - 12:59
summer,2011-04-02,12,84,100,184,2252,11:00 - 12:59
summer,2011-04-02,13,56,81,137,2252,13:00 - 14:59
summer,2011-04-02,14,97,93,190,2252,13:00 - 14:59
summer,2011-04-02,15,72,64,136,2252,15:00 - 16:59
summer,2011-04-02,16,111,85,196,2252,15:00 - 16:59
summer,2011-04-02,17,89,95,184,2252,17:00 - 18:59
summer,2011-04-02,18,69,110,179,2252,17:00 - 18:59
summer,2011-04-02,19,71,77,148,2252,19:00 - 20:59
summer,2011-04-02,20,29,56,85,2252,19:00 - 20:59
summer,2011-04-02,21,24,53,77,2252,21:00 - 22:59
summer,2011-04-02,22,14,41,55,2252,21:00 - 22:59
summer,2011-04-02,23,20,33,53,2252,23:00 - 24:59
summer,2011-04-03,0,8,31,39,3249,
summer,2011-04-03,1,8,26,34,3249,01:00 - 02:59
summer,2011-04-03,2,5,19,24,3249,01:00 - 02:59
summer,2011-04-03,3,3,8,11,3249,03:00 - 04:59
summer,2011-04-03,4,3,0,3,3249,03:00 - 04:59
summer,2011-04-03,5,1,4,5,3249,05:00 - 06:59
summer,2011-04-03,6,10,23,33,3249,05:00 - 06:59
summer,2011-04-03,7,13,20,33,3249,07:00 - 08:59
summer,2011-04-03,8,18,44,62,3249,07:00 - 08:59
summer,2011-04-03,9,68,74,142,3249,09:00 - 10:59
summer,2011-04-03,10,111,104,215,3249,09:00 - 10:59
summer,2011-04-03,11,139,104,243,3249,11:00 - 12:59
summer,2011-04-03,12,166,147,313,3249,11:00 - 12:59
summer,2011-04-03,13,219,148,367,3249,13:00 - 14:59
summer,2011-04-03,14,240,109,349,3249,13:00 - 14:59
summer,2011-04-03,15,174,118,292,3249,15:00 - 16:59
summer,2011-04-03,16,147,156,303,3249,15:00 - 16:59
summer,2011-04-03,17,148,126,274,3249,17:00 - 18:59
summer,2011-04-03,18,71,101,172,3249,17:00 - 18:59
summer,2011-04-03,19,51,93,144,3249,19:00 - 20:59
summer,2011-04-03,20,24,55,79,3249,19:00 - 20:59
summer,2011-04-03,21,8,37,45,3249,21:00 - 22:59
summer,2011-04-03,22,7,29,36,3249,21:00 - 22:59
summer,2011-04-03,23,9,22,31,3249,23:00 - 24:59
summer,2011-04-04,0,1,5,6,3115,
summer,2011-04-04,1,7,4,11,3115,01:00 - 02:59
summer,2011-04-04,2,1,1,2,3115,01:00 - 02:59
summer,2011-04-04,3,1,0,1,3115,03:00 - 04:59
summer,2011-04-04,4,1,1,2,3115,03:00 - 04:59
summer,2011-04-04,5,0,7,7,3115,05:00 - 06:59
summer,2011-04-04,6,3,43,46,3115,05:00 - 06:59
summer,2011-04-04,7,7,150,157,3115,07:00 - 08:59
summer,2011-04-04,8,31,308,339,3115,07:00 - 08:59
summer,2011-04-04,9,24,134,158,3115,09:00 - 10:59
summer,2011-04-04,10,35,55,90,3115,09:00 - 10:59
summer,2011-04-04,11,58,66,124,3115,11:00 - 12:59
summer,2011-04-04,12,59,98,157,3115,11:00 - 12:59
summer,2011-04-04,13,47,92,139,3115,13:00 - 14:59
summer,2011-04-04,14,47,76,123,3115,13:00 - 14:59
summer,2011-04-04,15,47,96,143,3115,15:00 - 16:59
summer,2011-04-04,16,59,130,189,3115,15:00 - 16:59
summer,2011-04-04,17,83,283,366,3115,17:00 - 18:59
summer,2011-04-04,18,78,308,386,3115,17:00 - 18:59
summer,2011-04-04,19,51,227,278,3115,19:00 - 20:59
summer,2011-04-04,20,40,133,173,3115,19:00 - 20:59
summer,2011-04-04,21,19,76,95,3115,21:00 - 22:59
summer,2011-04-04,22,17,58,75,3115,21:00 - 22:59
summer,2011-04-04,23,18,30,48,3115,23:00 - 24:59
summer,2011-04-05,0,10,12,22,1795,
summer,2011-04-05,1,10,5,15,1795,01:00 - 02:59
summer,2011-04-05,2,0,5,5,1795,01:00 - 02:59
summer,2011-04-05,3,1,3,4,1795,03:00 - 04:59
summer,2011-04-05,4,0,2,2,1795,03:00 - 04:59
summer,2011-04-05,5,0,5,5,1795,05:00 - 06:59
summer,2011-04-05,6,2,36,38,1795,05:00 - 06:59
summer,2011-04-05,7,10,124,134,1795,07:00 - 08:59
summer,2011-04-05,8,9,148,157,1795,07:00 - 08:59
summer,2011-04-05,9,2,44,46,1795,09:00 - 10:59
summer,2011-04-05,10,3,25,28,1795,09:00 - 10:59
summer,2011-04-05,11,1,18,19,1795,11:00 - 12:59
summer,2011-04-05,12,6,32,38,1795,11:00 - 12:59
summer,2011-04-05,13,5,51,56,1795,13:00 - 14:59
summer,2011-04-05,14,9,67,76,1795,13:00 - 14:59
summer,2011-04-05,15,6,62,68,1795,15:00 - 16:59
summer,2011-04-05,16,17,113,130,1795,15:00 - 16:59
summer,2011-04-05,17,27,246,273,1795,17:00 - 18:59
summer,2011-04-05,18,19,248,267,1795,17:00 - 18:59
summer,2011-04-05,19,12,148,160,1795,19:00 - 20:59
summer,2011-04-05,20,4,87,91,1795,19:00 - 20:59
summer,2011-04-05,21,8,81,89,1795,21:00 - 22:59
summer,2011-04-05,22,3,43,46,1795,21:00 - 22:59
summer,2011-04-05,23,3,23,26,1795,23:00 - 24:59
summer,2011-04-06,0,0,15,15,2808,
summer,2011-04-06,1,0,2,2,2808,01:00 - 02:59
summer,2011-04-06,2,0,5,5,2808,01:00 - 02:59
summer,2011-04-06,3,0,4,4,2808,03:00 - 04:59
summer,2011-04-06,4,0,1,1,2808,03:00 - 04:59
summer,2011-04-06,5,1,12,13,2808,05:00 - 06:59
summer,2011-04-06,6,4,52,56,2808,05:00 - 06:59
summer,2011-04-06,7,3,130,133,2808,07:00 - 08:59
summer,2011-04-06,8,17,308,325,2808,07:00 - 08:59
summer,2011-04-06,9,8,157,165,2808,09:00 - 10:59
summer,2011-04-06,10,21,48,69,2808,09:00 - 10:59
summer,2011-04-06,11,23,70,93,2808,11:00 - 12:59
summer,2011-04-06,12,22,112,134,2808,11:00 - 12:59
summer,2011-04-06,13,29,83,112,2808,13:00 - 14:59
summer,2011-04-06,14,35,80,115,2808,13:00 - 14:59
summer,2011-04-06,15,34,83,117,2808,15:00 - 16:59
summer,2011-04-06,16,27,142,169,2808,15:00 - 16:59
summer,2011-04-06,17,53,303,356,2808,17:00 - 18:59
summer,2011-04-06,18,43,282,325,2808,17:00 - 18:59
summer,2011-04-06,19,36,196,232,2808,19:00 - 20:59
summer,2011-04-06,20,15,126,141,2808,19:00 - 20:59
summer,2011-04-06,21,18,84,102,2808,21:00 - 22:59
summer,2011-04-06,22,13,71,84,2808,21:00 - 22:59
summer,2011-04-06,23,11,29,40,2808,23:00 - 24:59
summer,2011-04-07,0,5,15,20,3141,
summer,2011-04-07,1,2,11,13,3141,01:00 - 02:59
summer,2011-04-07,2,0,7,7,3141,01:00 - 02:59
summer,2011-04-07,3,0,3,3,3141,03:00 - 04:59
summer,2011-04-07,4,0,1,1,3141,03:00 - 04:59
summer,2011-04-07,5,0,6,6,3141,05:00 - 06:59
summer,2011-04-07,6,5,59,64,3141,05:00 - 06:59
summer,2011-04-07,7,8,152,160,3141,07:00 - 08:59
summer,2011-04-07,8,23,291,314,3141,07:00 - 08:59
summer,2011-04-07,9,15,155,170,3141,09:00 - 10:59
summer,2011-04-07,10,29,66,95,3141,09:00 - 10:59
summer,2011-04-07,11,36,86,122,3141,11:00 - 12:59
summer,2011-04-07,12,39,114,153,3141,11:00 - 12:59
summer,2011-04-07,13,36,99,135,3141,13:00 - 14:59
summer,2011-04-07,14,46,111,157,3141,13:00 - 14:59
summer,2011-04-07,15,27,133,160,3141,15:00 - 16:59
summer,2011-04-07,16,52,161,213,3141,15:00 - 16:59
summer,2011-04-07,17,63,280,343,3141,17:00 - 18:59
summer,2011-04-07,18,68,265,333,3141,17:00 - 18:59
summer,2011-04-07,19,34,192,226,3141,19:00 - 20:59
summer,2011-04-07,20,37,166,203,3141,19:00 - 20:59
summer,2011-04-07,21,19,89,108,3141,21:00 - 22:59
summer,2011-04-07,22,18,63,81,3141,21:00 - 22:59
summer,2011-04-07,23,9,45,54,3141,23:00 - 24:59
summer,2011-04-08,0,4,21,25,1471,
summer,2011-04-08,1,3,6,9,1471,01:00 - 02:59
summer,2011-04-08,2,3,10,13,1471,01:00 - 02:59
summer,2011-04-08,3,0,1,1,1471,03:00 - 04:59
summer,2011-04-08,4,0,1,1,1471,03:00 - 04:59
summer,2011-04-08,5,1,8,9,1471,05:00 - 06:59
summer,2011-04-08,6,2,33,35,1471,05:00 - 06:59
summer,2011-04-08,7,4,109,113,1471,07:00 - 08:59
summer,2011-04-08,8,13,208,221,1471,07:00 - 08:59
summer,2011-04-08,9,17,168,185,1471,09:00 - 10:59
summer,2011-04-08,10,10,63,73,1471,09:00 - 10:59
summer,2011-04-08,11,19,79,98,1471,11:00 - 12:59
summer,2011-04-08,12,29,51,80,1471,11:00 - 12:59
summer,2011-04-08,13,7,35,42,1471,13:00 - 14:59
summer,2011-04-08,14,2,13,15,1471,13:00 - 14:59
summer,2011-04-08,15,1,24,25,1471,15:00 - 16:59
summer,2011-04-08,16,2,58,60,1471,15:00 - 16:59
summer,2011-04-08,17,10,138,148,1471,17:00 - 18:59
summer,2011-04-08,18,8,54,62,1471,17:00 - 18:59
summer,2011-04-08,19,1,52,53,1471,19:00 - 20:59
summer,2011-04-08,20,12,51,63,1471,19:00 - 20:59
summer,2011-04-08,21,11,43,54,1471,21:00 - 22:59
summer,2011-04-08,22,9,42,51,1471,21:00 - 22:59
summer,2011-04-08,23,4,31,35,1471,23:00 - 24:59
summer,2011-04-09,0,5,26,31,2455,
summer,2011-04-09,1,3,17,20,2455,01:00 - 02:59
summer,2011-04-09,2,2,15,17,2455,01:00 - 02:59
summer,2011-04-09,3,3,11,14,2455,03:00 - 04:59
summer,2011-04-09,4,0,3,3,2455,03:00 - 04:59
summer,2011-04-09,5,0,5,5,2455,05:00 - 06:59
summer,2011-04-09,6,0,13,13,2455,05:00 - 06:59
summer,2011-04-09,7,8,13,21,2455,07:00 - 08:59
summer,2011-04-09,8,7,47,54,2455,07:00 - 08:59
summer,2011-04-09,9,27,71,98,2455,09:00 - 10:59
summer,2011-04-09,10,43,90,133,2455,09:00 - 10:59
summer,2011-04-09,11,51,91,142,2455,11:00 - 12:59
summer,2011-04-09,12,79,123,202,2455,11:00 - 12:59
summer,2011-04-09,13,114,108,222,2455,13:00 - 14:59
summer,2011-04-09,14,94,118,212,2455,13:00 - 14:59
summer,2011-04-09,15,85,116,201,2455,15:00 - 16:59
summer,2011-04-09,16,73,118,191,2455,15:00 - 16:59
summer,2011-04-09,17,128,129,257,2455,17:00 - 18:59
summer,2011-04-09,18,48,129,177,2455,17:00 - 18:59
summer,2011-04-09,19,47,83,130,2455,19:00 - 20:59
summer,2011-04-09,20,19,74,93,2455,19:00 - 20:59
summer,2011-04-09,21,10,65,75,2455,21:00 - 22:59
summer,2011-04-09,22,21,66,87,2455,21:00 - 22:59
summer,2011-04-09,23,12,45,57,2455,23:00 - 24:59
summer,2011-04-10,0,5,48,53,2895,
summer,2011-04-10,1,6,31,37,2895,01:00 - 02:59
summer,2011-04-10,2,12,24,36,2895,01:00 - 02:59
summer,2011-04-10,3,5,11,16,2895,03:00 - 04:59
summer,2011-04-10,4,3,2,5,2895,03:00 - 04:59
summer,2011-04-10,5,0,4,4,2895,05:00 - 06:59
summer,2011-04-10,6,0,4,4,2895,05:00 - 06:59
summer,2011-04-10,7,3,7,10,2895,07:00 - 08:59
summer,2011-04-10,8,17,38,55,2895,07:00 - 08:59
summer,2011-04-10,9,31,50,81,2895,09:00 - 10:59
summer,2011-04-10,10,69,81,150,2895,09:00 - 10:59
summer,2011-04-10,11,93,109,202,2895,11:00 - 12:59
summer,2011-04-10,12,94,136,230,2895,11:00 - 12:59
summer,2011-04-10,13,121,142,263,2895,13:00 - 14:59
summer,2011-04-10,14,148,133,281,2895,13:00 - 14:59
summer,2011-04-10,15,156,141,297,2895,15:00 - 16:59
summer,2011-04-10,16,135,153,288,2895,15:00 - 16:59
summer,2011-04-10,17,84,152,236,2895,17:00 - 18:59
summer,2011-04-10,18,103,137,240,2895,17:00 - 18:59
summer,2011-04-10,19,47,84,131,2895,19:00 - 20:59
summer,2011-04-10,20,21,71,92,2895,19:00 - 20:59
summer,2011-04-10,21,18,77,95,2895,21:00 - 22:59
summer,2011-04-10,22,12,45,57,2895,21:00 - 22:59
summer,2011-04-10,23,5,27,32,2895,23:00 - 24:59
summer,2011-04-11,0,7,16,23,3348,
summer,2011-04-11,1,1,3,4,3348,01:00 - 02:59
summer,2011-04-11,2,7,2,9,3348,01:00 - 02:59
summer,2011-04-11,4,0,1,1,3348,03:00 - 04:59
summer,2011-04-11,5,1,12,13,3348,05:00 - 06:59
summer,2011-04-11,6,2,59,61,3348,05:00 - 06:59
summer,2011-04-11,7,12,164,176,3348,07:00 - 08:59
summer,2011-04-11,8,28,286,314,3348,07:00 - 08:59
summer,2011-04-11,9,33,132,165,3348,09:00 - 10:59
summer,2011-04-11,10,41,55,96,3348,09:00 - 10:59
summer,2011-04-11,11,45,59,104,3348,11:00 - 12:59
summer,2011-04-11,12,37,97,134,3348,11:00 - 12:59
summer,2011-04-11,13,62,77,139,3348,13:00 - 14:59
summer,2011-04-11,14,60,85,145,3348,13:00 - 14:59
summer,2011-04-11,15,56,85,141,3348,15:00 - 16:59
summer,2011-04-11,16,73,162,235,3348,15:00 - 16:59
summer,2011-04-11,17,100,352,452,3348,17:00 - 18:59
summer,2011-04-11,18,93,290,383,3348,17:00 - 18:59
summer,2011-04-11,19,73,211,284,3348,19:00 - 20:59
summer,2011-04-11,20,44,122,166,3348,19:00 - 20:59
summer,2011-04-11,21,39,119,158,3348,21:00 - 22:59
summer,2011-04-11,22,25,66,91,3348,21:00 - 22:59
summer,2011-04-11,23,16,38,54,3348,23:00 - 24:59
summer,2011-04-12,0,11,13,24,2034,
summer,2011-04-12,1,6,7,13,2034,01:00 - 02:59
summer,2011-04-12,2,7,7,14,2034,01:00 - 02:59
summer,2011-04-12,3,0,1,1,2034,03:00 - 04:59
summer,2011-04-12,4,4,2,6,2034,03:00 - 04:59
summer,2011-04-12,5,1,15,16,2034,05:00 - 06:59
summer,2011-04-12,6,3,55,58,2034,05:00 - 06:59
summer,2011-04-12,7,12,177,189,2034,07:00 - 08:59
summer,2011-04-12,8,15,211,226,2034,07:00 - 08:59
summer,2011-04-12,9,4,50,54,2034,09:00 - 10:59
summer,2011-04-12,10,6,34,40,2034,09:00 - 10:59
summer,2011-04-12,11,11,38,49,2034,11:00 - 12:59
summer,2011-04-12,12,9,83,92,2034,11:00 - 12:59
summer,2011-04-12,13,22,84,106,2034,13:00 - 14:59
summer,2011-04-12,14,16,28,44,2034,13:00 - 14:59
summer,2011-04-12,15,24,54,78,2034,15:00 - 16:59
summer,2011-04-12,16,19,80,99,2034,15:00 - 16:59
summer,2011-04-12,17,29,262,291,2034,17:00 - 18:59
summer,2011-04-12,18,21,203,224,2034,17:00 - 18:59
summer,2011-04-12,19,3,127,130,2034,19:00 - 20:59
summer,2011-04-12,20,9,94,103,2034,19:00 - 20:59
summer,2011-04-12,21,10,74,84,2034,21:00 - 22:59
summer,2011-04-12,22,7,47,54,2034,21:00 - 22:59
summer,2011-04-12,23,8,31,39,2034,23:00 - 24:59
summer,2011-04-13,0,3,12,15,2162,
summer,2011-04-13,1,0,1,1,2162,01:00 - 02:59
summer,2011-04-13,2,0,2,2,2162,01:00 - 02:59
summer,2011-04-13,3,0,2,2,2162,03:00 - 04:59
summer,2011-04-13,4,1,2,3,2162,03:00 - 04:59
summer,2011-04-13,5,1,4,5,2162,05:00 - 06:59
summer,2011-04-13,6,1,33,34,2162,05:00 - 06:59
summer,2011-04-13,7,3,67,70,2162,07:00 - 08:59
summer,2011-04-13,8,6,158,164,2162,07:00 - 08:59
summer,2011-04-13,9,2,63,65,2162,09:00 - 10:59
summer,2011-04-13,10,4,42,46,2162,09:00 - 10:59
summer,2011-04-13,11,4,57,61,2162,11:00 - 12:59
summer,2011-04-13,12,12,83,95,2162,11:00 - 12:59
summer,2011-04-13,13,6,55,61,2162,13:00 - 14:59
summer,2011-04-13,14,24,82,106,2162,13:00 - 14:59
summer,2011-04-13,15,12,69,81,2162,15:00 - 16:59
summer,2011-04-13,16,23,119,142,2162,15:00 - 16:59
summer,2011-04-13,17,25,284,309,2162,17:00 - 18:59
summer,2011-04-13,18,28,293,321,2162,17:00 - 18:59
summer,2011-04-13,19,15,160,175,2162,19:00 - 20:59
summer,2011-04-13,20,7,119,126,2162,19:00 - 20:59
summer,2011-04-13,21,17,100,117,2162,21:00 - 22:59
summer,2011-04-13,22,10,89,99,2162,21:00 - 22:59
summer,2011-04-13,23,5,57,62,2162,23:00 - 24:59
summer,2011-04-14,0,3,18,21,3267,
summer,2011-04-14,1,1,9,10,3267,01:00 - 02:59
summer,2011-04-14,2,0,3,3,3267,01:00 - 02:59
summer,2011-04-14,3,0,2,2,3267,03:00 - 04:59
summer,2011-04-14,4,1,8,9,3267,03:00 - 04:59
summer,2011-04-14,5,2,12,14,3267,05:00 - 06:59
summer,2011-04-14,6,4,66,70,3267,05:00 - 06:59
summer,2011-04-14,7,11,182,193,3267,07:00 - 08:59
summer,2011-04-14,8,21,316,337,3267,07:00 - 08:59
summer,2011-04-14,9,18,152,170,3267,09:00 - 10:59
summer,2011-04-14,10,21,68,89,3267,09:00 - 10:59
summer,2011-04-14,11,28,87,115,3267,11:00 - 12:59
summer,2011-04-14,12,35,110,145,3267,11:00 - 12:59
summer,2011-04-14,13,38,121,159,3267,13:00 - 14:59
summer,2011-04-14,14,36,101,137,3267,13:00 - 14:59
summer,2011-04-14,15,57,85,142,3267,15:00 - 16:59
summer,2011-04-14,16,49,153,202,3267,15:00 - 16:59
summer,2011-04-14,17,50,338,388,3267,17:00 - 18:59
summer,2011-04-14,18,47,290,337,3267,17:00 - 18:59
summer,2011-04-14,19,37,222,259,3267,19:00 - 20:59
summer,2011-04-14,20,22,147,169,3267,19:00 - 20:59
summer,2011-04-14,21,19,126,145,3267,21:00 - 22:59
summer,2011-04-14,22,22,82,104,3267,21:00 - 22:59
summer,2011-04-14,23,7,40,47,3267,23:00 - 24:59
summer,2011-04-15,0,6,21,27,3126,
summer,2011-04-15,1,6,9,15,3126,01:00 - 02:59
summer,2011-04-15,2,8,10,18,3126,01:00 - 02:59
summer,2011-04-15,3,0,3,3,3126,03:00 - 04:59
summer,2011-04-15,4,0,3,3,3126,03:00 - 04:59
summer,2011-04-15,5,2,11,13,3126,05:00 - 06:59
summer,2011-04-15,6,5,42,47,3126,05:00 - 06:59
summer,2011-04-15,7,10,139,149,3126,07:00 - 08:59
summer,2011-04-15,8,21,279,300,3126,07:00 - 08:59
summer,2011-04-15,9,16,162,178,3126,09:00 - 10:59
summer,2011-04-15,10,31,91,122,3126,09:00 - 10:59
summer,2011-04-15,11,41,95,136,3126,11:00 - 12:59
summer,2011-04-15,12,45,155,200,3126,11:00 - 12:59
summer,2011-04-15,13,47,133,180,3126,13:00 - 14:59
summer,2011-04-15,14,57,106,163,3126,13:00 - 14:59
summer,2011-04-15,15,50,112,162,3126,15:00 - 16:59
summer,2011-04-15,16,70,173,243,3126,15:00 - 16:59
summer,2011-04-15,17,64,267,331,3126,17:00 - 18:59
summer,2011-04-15,18,47,216,263,3126,17:00 - 18:59
summer,2011-04-15,19,41,168,209,3126,19:00 - 20:59
summer,2011-04-15,20,26,92,118,3126,19:00 - 20:59
summer,2011-04-15,21,25,77,102,3126,21:00 - 22:59
summer,2011-04-15,22,16,64,80,3126,21:00 - 22:59
summer,2011-04-15,23,8,56,64,3126,23:00 - 24:59
summer,2011-04-16,0,7,36,43,795,
summer,2011-04-16,1,5,28,33,795,01:00 - 02:59
summer,2011-04-16,2,5,19,24,795,01:00 - 02:59
summer,2011-04-16,3,5,9,14,795,03:00 - 04:59
summer,2011-04-16,4,1,4,5,795,03:00 - 04:59
summer,2011-04-16,5,1,3,4,795,05:00 - 06:59
summer,2011-04-16,6,1,9,10,795,05:00 - 06:59
summer,2011-04-16,7,3,18,21,795,07:00 - 08:59
summer,2011-04-16,8,7,38,45,795,07:00 - 08:59
summer,2011-04-16,9,2,27,29,795,09:00 - 10:59
summer,2011-04-16,10,1,21,22,795,09:00 - 10:59
summer,2011-04-16,11,4,27,31,795,11:00 - 12:59
summer,2011-04-16,12,6,26,32,795,11:00 - 12:59
summer,2011-04-16,13,9,49,58,795,13:00 - 14:59
summer,2011-04-16,14,14,49,63,795,13:00 - 14:59
summer,2011-04-16,15,16,62,78,795,15:00 - 16:59
summer,2011-04-16,16,6,27,33,795,15:00 - 16:59
summer,2011-04-16,17,1,14,15,795,17:00 - 18:59
summer,2011-04-16,18,6,32,38,795,17:00 - 18:59
summer,2011-04-16,19,9,62,71,795,19:00 - 20:59
summer,2011-04-16,20,4,49,53,795,19:00 - 20:59
summer,2011-04-16,21,1,13,14,795,21:00 - 22:59
summer,2011-04-16,22,2,22,24,795,21:00 - 22:59
summer,2011-04-16,23,5,30,35,795,23:00 - 24:59
summer,2011-04-17,0,4,29,33,3744,
summer,2011-04-17,1,6,25,31,3744,01:00 - 02:59
summer,2011-04-17,2,4,25,29,3744,01:00 - 02:59
summer,2011-04-17,3,12,13,25,3744,03:00 - 04:59
summer,2011-04-17,4,2,5,7,3744,03:00 - 04:59
summer,2011-04-17,5,2,1,3,3744,05:00 - 06:59
summer,2011-04-17,6,3,5,8,3744,05:00 - 06:59
summer,2011-04-17,7,2,14,16,3744,07:00 - 08:59
summer,2011-04-17,8,7,36,43,3744,07:00 - 08:59
summer,2011-04-17,9,31,71,102,3744,09:00 - 10:59
summer,2011-04-17,10,91,120,211,3744,09:00 - 10:59
summer,2011-04-17,11,119,185,304,3744,11:00 - 12:59
summer,2011-04-17,12,167,187,354,3744,11:00 - 12:59
summer,2011-04-17,13,181,162,343,3744,13:00 - 14:59
summer,2011-04-17,14,170,191,361,3744,13:00 - 14:59
summer,2011-04-17,15,179,209,388,3744,15:00 - 16:59
summer,2011-04-17,16,161,182,343,3744,15:00 - 16:59
summer,2011-04-17,17,143,163,306,3744,17:00 - 18:59
summer,2011-04-17,18,102,175,277,3744,17:00 - 18:59
summer,2011-04-17,19,75,135,210,3744,19:00 - 20:59
summer,2011-04-17,20,44,97,141,3744,19:00 - 20:59
summer,2011-04-17,21,13,70,83,3744,21:00 - 22:59
summer,2011-04-17,22,21,49,70,3744,21:00 - 22:59
summer,2011-04-17,23,19,37,56,3744,23:00 - 24:59
summer,2011-04-18,0,15,24,39,3429,
summer,2011-04-18,1,11,8,19,3429,01:00 - 02:59
summer,2011-04-18,2,14,2,16,3429,01:00 - 02:59
summer,2011-04-18,3,6,1,7,3429,03:00 - 04:59
summer,2011-04-18,4,2,4,6,3429,03:00 - 04:59
summer,2011-04-18,5,0,16,16,3429,05:00 - 06:59
summer,2011-04-18,6,3,51,54,3429,05:00 - 06:59
summer,2011-04-18,7,12,156,168,3429,07:00 - 08:59
summer,2011-04-18,8,20,277,297,3429,07:00 - 08:59
summer,2011-04-18,9,37,132,169,3429,09:00 - 10:59
summer,2011-04-18,10,41,68,109,3429,09:00 - 10:59
summer,2011-04-18,11,36,87,123,3429,11:00 - 12:59
summer,2011-04-18,12,60,124,184,3429,11:00 - 12:59
summer,2011-04-18,13,41,128,169,3429,13:00 - 14:59
summer,2011-04-18,14,49,95,144,3429,13:00 - 14:59
summer,2011-04-18,15,64,112,176,3429,15:00 - 16:59
summer,2011-04-18,16,40,165,205,3429,15:00 - 16:59
summer,2011-04-18,17,66,362,428,3429,17:00 - 18:59
summer,2011-04-18,18,41,321,362,3429,17:00 - 18:59
summer,2011-04-18,19,42,244,286,3429,19:00 - 20:59
summer,2011-04-18,20,29,136,165,3429,19:00 - 20:59
summer,2011-04-18,21,20,131,151,3429,21:00 - 22:59
summer,2011-04-18,22,9,81,90,3429,21:00 - 22:59
summer,2011-04-18,23,11,35,46,3429,23:00 - 24:59
summer,2011-04-19,0,2,23,25,3204,
summer,2011-04-19,1,5,2,7,3204,01:00 - 02:59
summer,2011-04-19,2,8,5,13,3204,01:00 - 02:59
summer,2011-04-19,3,0,3,3,3204,03:00 - 04:59
summer,2011-04-19,4,1,4,5,3204,03:00 - 04:59
summer,2011-04-19,5,1,17,18,3204,05:00 - 06:59
summer,2011-04-19,6,2,63,65,3204,05:00 - 06:59
summer,2011-04-19,7,22,166,188,3204,07:00 - 08:59
summer,2011-04-19,8,20,331,351,3204,07:00 - 08:59
summer,2011-04-19,9,23,139,162,3204,09:00 - 10:59
summer,2011-04-19,10,15,60,75,3204,09:00 - 10:59
summer,2011-04-19,11,19,53,72,3204,11:00 - 12:59
summer,2011-04-19,12,19,84,103,3204,11:00 - 12:59
summer,2011-04-19,13,26,103,129,3204,13:00 - 14:59
summer,2011-04-19,14,19,88,107,3204,13:00 - 14:59
summer,2011-04-19,15,44,83,127,3204,15:00 - 16:59
summer,2011-04-19,16,30,162,192,3204,15:00 - 16:59
summer,2011-04-19,17,39,372,411,3204,17:00 - 18:59
summer,2011-04-19,18,44,377,421,3204,17:00 - 18:59
summer,2011-04-19,19,28,248,276,3204,19:00 - 20:59
summer,2011-04-19,20,20,148,168,3204,19:00 - 20:59
summer,2011-04-19,21,8,114,122,3204,21:00 - 22:59
summer,2011-04-19,22,3,109,112,3204,21:00 - 22:59
summer,2011-04-19,23,11,41,52,3204,23:00 - 24:59
summer,2011-04-20,0,4,29,33,3944,
summer,2011-04-20,1,2,5,7,3944,01:00 - 02:59
summer,2011-04-20,2,0,2,2,3944,01:00 - 02:59
summer,2011-04-20,3,0,2,2,3944,03:00 - 04:59
summer,2011-04-20,4,5,4,9,3944,03:00 - 04:59
summer,2011-04-20,5,1,14,15,3944,05:00 - 06:59
summer,2011-04-20,6,2,62,64,3944,05:00 - 06:59
summer,2011-04-20,7,26,211,237,3944,07:00 - 08:59
summer,2011-04-20,8,22,374,396,3944,07:00 - 08:59
summer,2011-04-20,9,27,170,197,3944,09:00 - 10:59
summer,2011-04-20,10,45,86,131,3944,09:00 - 10:59
summer,2011-04-20,11,31,87,118,3944,11:00 - 12:59
summer,2011-04-20,12,28,117,145,3944,11:00 - 12:59
summer,2011-04-20,13,42,135,177,3944,13:00 - 14:59
summer,2011-04-20,14,33,115,148,3944,13:00 - 14:59
summer,2011-04-20,15,32,113,145,3944,15:00 - 16:59
summer,2011-04-20,16,54,201,255,3944,15:00 - 16:59
summer,2011-04-20,17,34,398,432,3944,17:00 - 18:59
summer,2011-04-20,18,56,385,441,3944,17:00 - 18:59
summer,2011-04-20,19,74,309,383,3944,19:00 - 20:59
summer,2011-04-20,20,31,194,225,3944,19:00 - 20:59
summer,2011-04-20,21,38,134,172,3944,21:00 - 22:59
summer,2011-04-20,22,12,105,117,3944,21:00 - 22:59
summer,2011-04-20,23,14,79,93,3944,23:00 - 24:59
summer,2011-04-21,0,11,33,44,4189,
summer,2011-04-21,1,6,20,26,4189,01:00 - 02:59
summer,2011-04-21,2,3,10,13,4189,01:00 - 02:59
summer,2011-04-21,3,4,3,7,4189,03:00 - 04:59
summer,2011-04-21,4,2,4,6,4189,03:00 - 04:59
summer,2011-04-21,5,0,14,14,4189,05:00 - 06:59
summer,2011-04-21,6,2,73,75,4189,05:00 - 06:59
summer,2011-04-21,7,15,183,198,4189,07:00 - 08:59
summer,2011-04-21,8,19,346,365,4189,07:00 - 08:59
summer,2011-04-21,9,18,178,196,4189,09:00 - 10:59
summer,2011-04-21,10,25,73,98,4189,09:00 - 10:59
summer,2011-04-21,11,34,99,133,4189,11:00 - 12:59
summer,2011-04-21,12,49,150,199,4189,11:00 - 12:59
summer,2011-04-21,13,55,122,177,4189,13:00 - 14:59
summer,2011-04-21,14,68,160,228,4189,13:00 - 14:59
summer,2011-04-21,15,69,166,235,4189,15:00 - 16:59
summer,2011-04-21,16,66,228,294,4189,15:00 - 16:59
summer,2011-04-21,17,79,402,481,4189,17:00 - 18:59
summer,2011-04-21,18,71,381,452,4189,17:00 - 18:59
summer,2011-04-21,19,52,272,324,4189,19:00 - 20:59
summer,2011-04-21,20,28,176,204,4189,19:00 - 20:59
summer,2011-04-21,21,25,159,184,4189,21:00 - 22:59
summer,2011-04-21,22,31,106,137,4189,21:00 - 22:59
summer,2011-04-21,23,13,86,99,4189,23:00 - 24:59
summer,2011-04-22,0,3,30,33,1683,
summer,2011-04-22,1,2,22,24,1683,01:00 - 02:59
summer,2011-04-22,2,2,7,9,1683,01:00 - 02:59
summer,2011-04-22,3,0,2,2,1683,03:00 - 04:59
summer,2011-04-22,4,1,2,3,1683,03:00 - 04:59
summer,2011-04-22,5,0,16,16,1683,05:00 - 06:59
summer,2011-04-22,6,2,47,49,1683,05:00 - 06:59
summer,2011-04-22,7,5,175,180,1683,07:00 - 08:59
summer,2011-04-22,8,15,331,346,1683,07:00 - 08:59
summer,2011-04-22,9,17,178,195,1683,09:00 - 10:59
summer,2011-04-22,10,32,104,136,1683,09:00 - 10:59
summer,2011-04-22,11,23,83,106,1683,11:00 - 12:59
summer,2011-04-22,12,19,61,80,1683,11:00 - 12:59
summer,2011-04-22,13,3,37,40,1683,13:00 - 14:59
summer,2011-04-22,14,3,33,36,1683,13:00 - 14:59
summer,2011-04-22,15,13,62,75,1683,15:00 - 16:59
summer,2011-04-22,16,4,58,62,1683,15:00 - 16:59
summer,2011-04-22,17,6,63,69,1683,17:00 - 18:59
summer,2011-04-22,18,4,47,51,1683,17:00 - 18:59
summer,2011-04-22,19,7,48,55,1683,19:00 - 20:59
summer,2011-04-22,20,8,39,47,1683,19:00 - 20:59
summer,2011-04-22,21,5,23,28,1683,21:00 - 22:59
summer,2011-04-22,22,3,21,24,1683,21:00 - 22:59
summer,2011-04-22,23,0,17,17,1683,23:00 - 24:59
summer,2011-04-23,0,0,18,18,4036,
summer,2011-04-23,1,5,11,16,4036,01:00 - 02:59
summer,2011-04-23,2,3,14,17,4036,01:00 - 02:59
summer,2011-04-23,3,0,4,4,4036,03:00 - 04:59
summer,2011-04-23,4,2,3,5,4036,03:00 - 04:59
summer,2011-04-23,5,1,6,7,4036,05:00 - 06:59
summer,2011-04-23,6,0,11,11,4036,05:00 - 06:59
summer,2011-04-23,7,2,17,19,4036,07:00 - 08:59
summer,2011-04-23,8,15,32,47,4036,07:00 - 08:59
summer,2011-04-23,9,13,55,68,4036,09:00 - 10:59
summer,2011-04-23,10,36,93,129,4036,09:00 - 10:59
summer,2011-04-23,11,68,164,232,4036,11:00 - 12:59
summer,2011-04-23,12,94,197,291,4036,11:00 - 12:59
summer,2011-04-23,13,126,186,312,4036,13:00 - 14:59
summer,2011-04-23,14,182,209,391,4036,13:00 - 14:59
summer,2011-04-23,15,171,226,397,4036,15:00 - 16:59
summer,2011-04-23,16,180,246,426,4036,15:00 - 16:59
summer,2011-04-23,17,168,215,383,4036,17:00 - 18:59
summer,2011-04-23,18,149,227,376,4036,17:00 - 18:59
summer,2011-04-23,19,84,199,283,4036,19:00 - 20:59
summer,2011-04-23,20,45,138,183,4036,19:00 - 20:59
summer,2011-04-23,21,32,103,135,4036,21:00 - 22:59
summer,2011-04-23,22,55,114,169,4036,21:00 - 22:59
summer,2011-04-23,23,31,86,117,4036,23:00 - 24:59
summer,2011-04-24,0,30,66,96,4191,
summer,2011-04-24,1,14,40,54,4191,01:00 - 02:59
summer,2011-04-24,2,27,45,72,4191,01:00 - 02:59
summer,2011-04-24,3,4,20,24,4191,03:00 - 04:59
summer,2011-04-24,4,0,5,5,4191,03:00 - 04:59
summer,2011-04-24,5,5,7,12,4191,05:00 - 06:59
summer,2011-04-24,6,10,3,13,4191,05:00 - 06:59
summer,2011-04-24,7,16,11,27,4191,07:00 - 08:59
summer,2011-04-24,8,38,42,80,4191,07:00 - 08:59
summer,2011-04-24,9,73,104,177,4191,09:00 - 10:59
summer,2011-04-24,10,118,171,289,4191,09:00 - 10:59
summer,2011-04-24,11,124,193,317,4191,11:00 - 12:59
summer,2011-04-24,12,168,220,388,4191,11:00 - 12:59
summer,2011-04-24,13,205,236,441,4191,13:00 - 14:59
summer,2011-04-24,14,197,223,420,4191,13:00 - 14:59
summer,2011-04-24,15,167,202,369,4191,15:00 - 16:59
summer,2011-04-24,16,162,197,359,4191,15:00 - 16:59
summer,2011-04-24,17,142,189,331,4191,17:00 - 18:59
summer,2011-04-24,18,96,174,270,4191,17:00 - 18:59
summer,2011-04-24,19,62,132,194,4191,19:00 - 20:59
summer,2011-04-24,20,34,71,105,4191,19:00 - 20:59
summer,2011-04-24,21,8,53,61,4191,21:00 - 22:59
summer,2011-04-24,22,5,40,45,4191,21:00 - 22:59
summer,2011-04-24,23,5,37,42,4191,23:00 - 24:59
summer,2011-04-25,0,2,10,12,4073,
summer,2011-04-25,1,2,8,10,4073,01:00 - 02:59
summer,2011-04-25,2,1,9,10,4073,01:00 - 02:59
summer,2011-04-25,3,2,8,10,4073,03:00 - 04:59
summer,2011-04-25,4,1,4,5,4073,03:00 - 04:59
summer,2011-04-25,5,3,14,17,4073,05:00 - 06:59
summer,2011-04-25,6,7,59,66,4073,05:00 - 06:59
summer,2011-04-25,7,13,183,196,4073,07:00 - 08:59
summer,2011-04-25,8,27,326,353,4073,07:00 - 08:59
summer,2011-04-25,9,27,147,174,4073,09:00 - 10:59
summer,2011-04-25,10,61,64,125,4073,09:00 - 10:59
summer,2011-04-25,11,53,94,147,4073,11:00 - 12:59
summer,2011-04-25,12,48,140,188,4073,11:00 - 12:59
summer,2011-04-25,13,57,146,203,4073,13:00 - 14:59
summer,2011-04-25,14,47,99,146,4073,13:00 - 14:59
summer,2011-04-25,15,50,125,175,4073,15:00 - 16:59
summer,2011-04-25,16,41,198,239,4073,15:00 - 16:59
summer,2011-04-25,17,80,441,521,4073,17:00 - 18:59
summer,2011-04-25,18,74,425,499,4073,17:00 - 18:59
summer,2011-04-25,19,62,320,382,4073,19:00 - 20:59
summer,2011-04-25,20,42,195,237,4073,19:00 - 20:59
summer,2011-04-25,21,41,149,190,4073,21:00 - 22:59
summer,2011-04-25,22,23,83,106,4073,21:00 - 22:59
summer,2011-04-25,23,9,53,62,4073,23:00 - 24:59
summer,2011-04-26,0,10,17,27,4400,
summer,2011-04-26,1,16,5,21,4400,01:00 - 02:59
summer,2011-04-26,2,17,9,26,4400,01:00 - 02:59
summer,2011-04-26,3,17,4,21,4400,03:00 - 04:59
summer,2011-04-26,4,2,4,6,4400,03:00 - 04:59
summer,2011-04-26,5,0,16,16,4400,05:00 - 06:59
summer,2011-04-26,6,0,80,80,4400,05:00 - 06:59
summer,2011-04-26,7,16,254,270,4400,07:00 - 08:59
summer,2011-04-26,8,32,417,449,4400,07:00 - 08:59
summer,2011-04-26,9,35,164,199,4400,09:00 - 10:59
summer,2011-04-26,10,22,98,120,4400,09:00 - 10:59
summer,2011-04-26,11,40,132,172,4400,11:00 - 12:59
summer,2011-04-26,12,40,146,186,4400,11:00 - 12:59
summer,2011-04-26,13,37,139,176,4400,13:00 - 14:59
summer,2011-04-26,14,40,115,155,4400,13:00 - 14:59
summer,2011-04-26,15,34,119,153,4400,15:00 - 16:59
summer,2011-04-26,16,40,251,291,4400,15:00 - 16:59
summer,2011-04-26,17,66,455,521,4400,17:00 - 18:59
summer,2011-04-26,18,65,463,528,4400,17:00 - 18:59
summer,2011-04-26,19,42,286,328,4400,19:00 - 20:59
summer,2011-04-26,20,35,199,234,4400,19:00 - 20:59
summer,2011-04-26,21,33,162,195,4400,21:00 - 22:59
summer,2011-04-26,22,32,116,148,4400,21:00 - 22:59
summer,2011-04-26,23,7,71,78,4400,23:00 - 24:59
summer,2011-04-27,0,3,24,27,3872,
summer,2011-04-27,1,2,15,17,3872,01:00 - 02:59
summer,2011-04-27,2,0,5,5,3872,01:00 - 02:59
summer,2011-04-27,3,3,4,7,3872,03:00 - 04:59
summer,2011-04-27,4,0,6,6,3872,03:00 - 04:59
summer,2011-04-27,5,1,16,17,3872,05:00 - 06:59
summer,2011-04-27,6,5,79,84,3872,05:00 - 06:59
summer,2011-04-27,7,17,229,246,3872,07:00 - 08:59
summer,2011-04-27,8,31,413,444,3872,07:00 - 08:59
summer,2011-04-27,9,20,161,181,3872,09:00 - 10:59
summer,2011-04-27,10,26,66,92,3872,09:00 - 10:59
summer,2011-04-27,11,53,103,156,3872,11:00 - 12:59
summer,2011-04-27,12,38,135,173,3872,11:00 - 12:59
summer,2011-04-27,13,31,119,150,3872,13:00 - 14:59
summer,2011-04-27,14,29,119,148,3872,13:00 - 14:59
summer,2011-04-27,15,18,120,138,3872,15:00 - 16:59
summer,2011-04-27,16,29,189,218,3872,15:00 - 16:59
summer,2011-04-27,17,63,458,521,3872,17:00 - 18:59
summer,2011-04-27,18,46,366,412,3872,17:00 - 18:59
summer,2011-04-27,19,40,220,260,3872,19:00 - 20:59
summer,2011-04-27,20,30,188,218,3872,19:00 - 20:59
summer,2011-04-27,21,19,126,145,3872,21:00 - 22:59
summer,2011-04-27,22,18,111,129,3872,21:00 - 22:59
summer,2011-04-27,23,25,53,78,3872,23:00 - 24:59
summer,2011-04-28,0,13,41,54,4058,
summer,2011-04-28,1,8,12,20,4058,01:00 - 02:59
summer,2011-04-28,2,14,7,21,4058,01:00 - 02:59
summer,2011-04-28,3,2,1,3,4058,03:00 - 04:59
summer,2011-04-28,4,4,5,9,4058,03:00 - 04:59
summer,2011-04-28,5,0,13,13,4058,05:00 - 06:59
summer,2011-04-28,6,7,79,86,4058,05:00 - 06:59
summer,2011-04-28,7,14,201,215,4058,07:00 - 08:59
summer,2011-04-28,8,31,367,398,4058,07:00 - 08:59
summer,2011-04-28,9,18,165,183,4058,09:00 - 10:59
summer,2011-04-28,10,9,45,54,4058,09:00 - 10:59
summer,2011-04-28,11,10,74,84,4058,11:00 - 12:59
summer,2011-04-28,12,23,84,107,4058,11:00 - 12:59
summer,2011-04-28,13,18,103,121,4058,13:00 - 14:59
summer,2011-04-28,14,21,121,142,4058,13:00 - 14:59
summer,2011-04-28,15,46,117,163,4058,15:00 - 16:59
summer,2011-04-28,16,42,228,270,4058,15:00 - 16:59
summer,2011-04-28,17,49,406,455,4058,17:00 - 18:59
summer,2011-04-28,18,44,486,530,4058,17:00 - 18:59
summer,2011-04-28,19,57,347,404,4058,19:00 - 20:59
summer,2011-04-28,20,49,220,269,4058,19:00 - 20:59
summer,2011-04-28,21,27,167,194,4058,21:00 - 22:59
summer,2011-04-28,22,34,119,153,4058,21:00 - 22:59
summer,2011-04-28,23,29,81,110,4058,23:00 - 24:59
summer,2011-04-29,0,11,37,48,4595,
summer,2011-04-29,1,10,21,31,4595,01:00 - 02:59
summer,2011-04-29,2,2,8,10,4595,01:00 - 02:59
summer,2011-04-29,3,1,4,5,4595,03:00 - 04:59
summer,2011-04-29,4,0,6,6,4595,03:00 - 04:59
summer,2011-04-29,5,0,25,25,4595,05:00 - 06:59
summer,2011-04-29,6,4,67,71,4595,05:00 - 06:59
summer,2011-04-29,7,18,222,240,4595,07:00 - 08:59
summer,2011-04-29,8,35,386,421,4595,07:00 - 08:59
summer,2011-04-29,9,45,185,230,4595,09:00 - 10:59
summer,2011-04-29,10,57,99,156,4595,09:00 - 10:59
summer,2011-04-29,11,49,108,157,4595,11:00 - 12:59
summer,2011-04-29,12,63,160,223,4595,11:00 - 12:59
summer,2011-04-29,13,74,234,308,4595,13:00 - 14:59
summer,2011-04-29,14,58,190,248,4595,13:00 - 14:59
summer,2011-04-29,15,77,175,252,4595,15:00 - 16:59
summer,2011-04-29,16,59,240,299,4595,15:00 - 16:59
summer,2011-04-29,17,75,433,508,4595,17:00 - 18:59
summer,2011-04-29,18,55,384,439,4595,17:00 - 18:59
summer,2011-04-29,19,40,230,270,4595,19:00 - 20:59
summer,2011-04-29,20,34,160,194,4595,19:00 - 20:59
summer,2011-04-29,21,50,145,195,4595,21:00 - 22:59
summer,2011-04-29,22,36,110,146,4595,21:00 - 22:59
summer,2011-04-29,23,25,88,113,4595,23:00 - 24:59
summer,2011-04-30,0,33,73,106,5312,
summer,2011-04-30,1,15,59,74,5312,01:00 - 02:59
summer,2011-04-30,2,12,53,65,5312,01:00 - 02:59
summer,2011-04-30,3,4,13,17,5312,03:00 - 04:59
summer,2011-04-30,4,2,5,7,5312,03:00 - 04:59
summer,2011-04-30,5,3,4,7,5312,05:00 - 06:59
summer,2011-04-30,6,10,11,21,5312,05:00 - 06:59
summer,2011-04-30,7,21,27,48,5312,07:00 - 08:59
summer,2011-04-30,8,21,70,91,5312,07:00 - 08:59
summer,2011-04-30,9,35,121,156,5312,09:00 - 10:59
summer,2011-04-30,10,94,185,279,5312,09:00 - 10:59
summer,2011-04-30,11,120,201,321,5312,11:00 - 12:59
summer,2011-04-30,12,178,238,416,5312,11:00 - 12:59
summer,2011-04-30,13,185,270,455,5312,13:00 - 14:59
summer,2011-04-30,14,184,268,452,5312,13:00 - 14:59
summer,2011-04-30,15,217,282,499,5312,15:00 - 16:59
summer,2011-04-30,16,191,273,464,5312,15:00 - 16:59
summer,2011-04-30,17,162,245,407,5312,17:00 - 18:59
summer,2011-04-30,18,134,237,371,5312,17:00 - 18:59
summer,2011-04-30,19,150,237,387,5312,19:00 - 20:59
summer,2011-04-30,20,65,159,224,5312,19:00 - 20:59
summer,2011-04-30,21,58,119,177,5312,21:00 - 22:59
summer,2011-04-30,22,37,106,143,5312,21:00 - 22:59
summer,2011-04-30,23,34,91,125,5312,23:00 - 24:59
summer,2011-05-01,0,19,77,96,3351,
summer,2011-05-01,1,9,50,59,3351,01:00 - 02:59
summer,2011-05-01,2,7,43,50,3351,01:00 - 02:59
summer,2011-05-01,3,8,15,23,3351,03:00 - 04:59
summer,2011-05-01,4,6,11,17,3351,03:00 - 04:59
summer,2011-05-01,5,0,10,10,3351,05:00 - 06:59
summer,2011-05-01,6,4,9,13,3351,05:00 - 06:59
summer,2011-05-01,7,7,26,33,3351,07:00 - 08:59
summer,2011-05-01,8,16,43,59,3351,07:00 - 08:59
summer,2011-05-01,9,45,96,141,3351,09:00 - 10:59
summer,2011-05-01,10,109,155,264,3351,09:00 - 10:59
summer,2011-05-01,11,109,141,250,3351,11:00 - 12:59
summer,2011-05-01,12,109,172,281,3351,11:00 - 12:59
summer,2011-05-01,13,123,209,332,3351,13:00 - 14:59
summer,2011-05-01,14,85,153,238,3351,13:00 - 14:59
summer,2011-05-01,15,113,153,266,3351,15:00 - 16:59
summer,2011-05-01,16,75,139,214,3351,15:00 - 16:59
summer,2011-05-01,17,60,136,196,3351,17:00 - 18:59
summer,2011-05-01,18,33,126,159,3351,17:00 - 18:59
summer,2011-05-01,19,47,131,178,3351,19:00 - 20:59
summer,2011-05-01,20,35,86,121,3351,19:00 - 20:59
summer,2011-05-01,21,23,82,105,3351,21:00 - 22:59
summer,2011-05-01,22,32,68,100,3351,21:00 - 22:59
summer,2011-05-01,23,64,82,146,3351,23:00 - 24:59
summer,2011-05-02,0,68,109,177,4401,
summer,2011-05-02,1,41,73,114,4401,01:00 - 02:59
summer,2011-05-02,2,16,19,35,4401,01:00 - 02:59
summer,2011-05-02,3,9,7,16,4401,03:00 - 04:59
summer,2011-05-02,4,9,8,17,4401,03:00 - 04:59
summer,2011-05-02,5,4,16,20,4401,05:00 - 06:59
summer,2011-05-02,6,3,59,62,4401,05:00 - 06:59
summer,2011-05-02,7,16,193,209,4401,07:00 - 08:59
summer,2011-05-02,8,21,350,371,4401,07:00 - 08:59
summer,2011-05-02,9,41,131,172,4401,09:00 - 10:59
summer,2011-05-02,10,31,77,108,4401,09:00 - 10:59
summer,2011-05-02,11,34,96,130,4401,11:00 - 12:59
summer,2011-05-02,12,40,147,187,4401,11:00 - 12:59
summer,2011-05-02,13,51,119,170,4401,13:00 - 14:59
summer,2011-05-02,14,48,133,181,4401,13:00 - 14:59
summer,2011-05-02,15,45,110,155,4401,15:00 - 16:59
summer,2011-05-02,16,49,220,269,4401,15:00 - 16:59
summer,2011-05-02,17,65,472,537,4401,17:00 - 18:59
summer,2011-05-02,18,68,450,518,4401,17:00 - 18:59
summer,2011-05-02,19,46,268,314,4401,19:00 - 20:59
summer,2011-05-02,20,44,174,218,4401,19:00 - 20:59
summer,2011-05-02,21,54,178,232,4401,21:00 - 22:59
summer,2011-05-02,22,28,97,125,4401,21:00 - 22:59
summer,2011-05-02,23,16,48,64,4401,23:00 - 24:59
summer,2011-05-03,0,0,16,16,4451,
summer,2011-05-03,1,0,14,14,4451,01:00 - 02:59
summer,2011-05-03,2,0,5,5,4451,01:00 - 02:59
summer,2011-05-03,3,0,2,2,4451,03:00 - 04:59
summer,2011-05-03,4,3,1,4,4451,03:00 - 04:59
summer,2011-05-03,5,0,14,14,4451,05:00 - 06:59
summer,2011-05-03,6,7,102,109,4451,05:00 - 06:59
summer,2011-05-03,7,17,248,265,4451,07:00 - 08:59
summer,2011-05-03,8,24,435,459,4451,07:00 - 08:59
summer,2011-05-03,9,29,157,186,4451,09:00 - 10:59
summer,2011-05-03,10,36,91,127,4451,09:00 - 10:59
summer,2011-05-03,11,20,120,140,4451,11:00 - 12:59
summer,2011-05-03,12,48,169,217,4451,11:00 - 12:59
summer,2011-05-03,13,50,144,194,4451,13:00 - 14:59
summer,2011-05-03,14,36,122,158,4451,13:00 - 14:59
summer,2011-05-03,15,37,117,154,4451,15:00 - 16:59
summer,2011-05-03,16,46,225,271,4451,15:00 - 16:59
summer,2011-05-03,17,53,464,517,4451,17:00 - 18:59
summer,2011-05-03,18,59,485,544,4451,17:00 - 18:59
summer,2011-05-03,19,42,323,365,4451,19:00 - 20:59
summer,2011-05-03,20,28,262,290,4451,19:00 - 20:59
summer,2011-05-03,21,42,183,225,4451,21:00 - 22:59
summer,2011-05-03,22,14,99,113,4451,21:00 - 22:59
summer,2011-05-03,23,12,50,62,4451,23:00 - 24:59
summer,2011-05-04,0,5,22,27,2633,
summer,2011-05-04,1,1,6,7,2633,01:00 - 02:59
summer,2011-05-04,2,0,4,4,2633,01:00 - 02:59
summer,2011-05-04,3,0,1,1,2633,03:00 - 04:59
summer,2011-05-04,4,1,2,3,2633,03:00 - 04:59
summer,2011-05-04,5,1,8,9,2633,05:00 - 06:59
summer,2011-05-04,6,0,21,21,2633,05:00 - 06:59
summer,2011-05-04,7,6,46,52,2633,07:00 - 08:59
summer,2011-05-04,8,5,74,79,2633,07:00 - 08:59
summer,2011-05-04,9,5,35,40,2633,09:00 - 10:59
summer,2011-05-04,10,5,26,31,2633,09:00 - 10:59
summer,2011-05-04,11,3,69,72,2633,11:00 - 12:59
summer,2011-05-04,12,19,105,124,2633,11:00 - 12:59
summer,2011-05-04,13,15,128,143,2633,13:00 - 14:59
summer,2011-05-04,14,13,94,107,2633,13:00 - 14:59
summer,2011-05-04,15,22,107,129,2633,15:00 - 16:59
summer,2011-05-04,16,22,173,195,2633,15:00 - 16:59
summer,2011-05-04,17,22,388,410,2633,17:00 - 18:59
summer,2011-05-04,18,29,367,396,2633,17:00 - 18:59
summer,2011-05-04,19,30,266,296,2633,19:00 - 20:59
summer,2011-05-04,20,17,174,191,2633,19:00 - 20:59
summer,2011-05-04,21,17,133,150,2633,21:00 - 22:59
summer,2011-05-04,22,9,80,89,2633,21:00 - 22:59
summer,2011-05-04,23,8,49,57,2633,23:00 - 24:59
summer,2011-05-05,0,4,23,27,4433,
summer,2011-05-05,1,4,6,10,4433,01:00 - 02:59
summer,2011-05-05,2,1,4,5,4433,01:00 - 02:59
summer,2011-05-05,3,0,4,4,4433,03:00 - 04:59
summer,2011-05-05,4,4,3,7,4433,03:00 - 04:59
summer,2011-05-05,5,1,29,30,4433,05:00 - 06:59
summer,2011-05-05,6,3,86,89,4433,05:00 - 06:59
summer,2011-05-05,7,16,255,271,4433,07:00 - 08:59
summer,2011-05-05,8,25,415,440,4433,07:00 - 08:59
summer,2011-05-05,9,20,164,184,4433,09:00 - 10:59
summer,2011-05-05,10,30,98,128,4433,09:00 - 10:59
summer,2011-05-05,11,43,105,148,4433,11:00 - 12:59
summer,2011-05-05,12,27,169,196,4433,11:00 - 12:59
summer,2011-05-05,13,50,142,192,4433,13:00 - 14:59
summer,2011-05-05,14,19,135,154,4433,13:00 - 14:59
summer,2011-05-05,15,27,120,147,4433,15:00 - 16:59
summer,2011-05-05,16,36,233,269,4433,15:00 - 16:59
summer,2011-05-05,17,66,467,533,4433,17:00 - 18:59
summer,2011-05-05,18,64,456,520,4433,17:00 - 18:59
summer,2011-05-05,19,56,305,361,4433,19:00 - 20:59
summer,2011-05-05,20,33,225,258,4433,19:00 - 20:59
summer,2011-05-05,21,39,141,180,4433,21:00 - 22:59
summer,2011-05-05,22,30,135,165,4433,21:00 - 22:59
summer,2011-05-05,23,16,99,115,4433,23:00 - 24:59
summer,2011-05-06,0,13,43,56,4608,
summer,2011-05-06,1,8,24,32,4608,01:00 - 02:59
summer,2011-05-06,2,1,15,16,4608,01:00 - 02:59
summer,2011-05-06,3,3,6,9,4608,03:00 - 04:59
summer,2011-05-06,4,0,1,1,4608,03:00 - 04:59
summer,2011-05-06,5,0,16,16,4608,05:00 - 06:59
summer,2011-05-06,6,8,74,82,4608,05:00 - 06:59
summer,2011-05-06,7,20,202,222,4608,07:00 - 08:59
summer,2011-05-06,8,35,415,450,4608,07:00 - 08:59
summer,2011-05-06,9,27,161,188,4608,09:00 - 10:59
summer,2011-05-06,10,30,97,127,4608,09:00 - 10:59
summer,2011-05-06,11,42,123,165,4608,11:00 - 12:59
summer,2011-05-06,12,48,198,246,4608,11:00 - 12:59
summer,2011-05-06,13,71,182,253,4608,13:00 - 14:59
summer,2011-05-06,14,86,127,213,4608,13:00 - 14:59
summer,2011-05-06,15,89,171,260,4608,15:00 - 16:59
summer,2011-05-06,16,82,262,344,4608,15:00 - 16:59
summer,2011-05-06,17,83,470,553,4608,17:00 - 18:59
summer,2011-05-06,18,85,385,470,4608,17:00 - 18:59
summer,2011-05-06,19,39,253,292,4608,19:00 - 20:59
summer,2011-05-06,20,29,161,190,4608,19:00 - 20:59
summer,2011-05-06,21,22,130,152,4608,21:00 - 22:59
summer,2011-05-06,22,46,105,151,4608,21:00 - 22:59
summer,2011-05-06,23,27,93,120,4608,23:00 - 24:59
summer,2011-05-07,0,10,76,86,4714,
summer,2011-05-07,1,8,50,58,4714,01:00 - 02:59
summer,2011-05-07,2,5,47,52,4714,01:00 - 02:59
summer,2011-05-07,3,9,9,18,4714,03:00 - 04:59
summer,2011-05-07,4,1,4,5,4714,03:00 - 04:59
summer,2011-05-07,5,4,3,7,4714,05:00 - 06:59
summer,2011-05-07,6,1,12,13,4714,05:00 - 06:59
summer,2011-05-07,7,8,32,40,4714,07:00 - 08:59
summer,2011-05-07,8,19,96,115,4714,07:00 - 08:59
summer,2011-05-07,9,54,164,218,4714,09:00 - 10:59
summer,2011-05-07,10,90,208,298,4714,09:00 - 10:59
summer,2011-05-07,11,132,215,347,4714,11:00 - 12:59
summer,2011-05-07,12,129,244,373,4714,11:00 - 12:59
summer,2011-05-07,13,196,240,436,4714,13:00 - 14:59
summer,2011-05-07,14,143,235,378,4714,13:00 - 14:59
summer,2011-05-07,15,148,230,378,4714,15:00 - 16:59
summer,2011-05-07,16,119,223,342,4714,15:00 - 16:59
summer,2011-05-07,17,138,216,354,4714,17:00 - 18:59
summer,2011-05-07,18,114,175,289,4714,17:00 - 18:59
summer,2011-05-07,19,88,179,267,4714,19:00 - 20:59
summer,2011-05-07,20,82,137,219,4714,19:00 - 20:59
summer,2011-05-07,21,58,124,182,4714,21:00 - 22:59
summer,2011-05-07,22,26,94,120,4714,21:00 - 22:59
summer,2011-05-07,23,30,89,119,4714,23:00 - 24:59
summer,2011-05-08,0,22,78,100,4333,
summer,2011-05-08,1,8,56,64,4333,01:00 - 02:59
summer,2011-05-08,2,17,42,59,4333,01:00 - 02:59
summer,2011-05-08,3,10,21,31,4333,03:00 - 04:59
summer,2011-05-08,4,2,8,10,4333,03:00 - 04:59
summer,2011-05-08,5,0,5,5,4333,05:00 - 06:59
summer,2011-05-08,6,2,4,6,4333,05:00 - 06:59
summer,2011-05-08,7,8,15,23,4333,07:00 - 08:59
summer,2011-05-08,8,28,58,86,4333,07:00 - 08:59
summer,2011-05-08,9,48,112,160,4333,09:00 - 10:59
summer,2011-05-08,10,91,153,244,4333,09:00 - 10:59
summer,2011-05-08,11,142,198,340,4333,11:00 - 12:59
summer,2011-05-08,12,139,243,382,4333,11:00 - 12:59
summer,2011-05-08,13,166,224,390,4333,13:00 - 14:59
summer,2011-05-08,14,126,240,366,4333,13:00 - 14:59
summer,2011-05-08,15,128,230,358,4333,15:00 - 16:59
summer,2011-05-08,16,122,263,385,4333,15:00 - 16:59
summer,2011-05-08,17,106,245,351,4333,17:00 - 18:59
summer,2011-05-08,18,63,205,268,4333,17:00 - 18:59
summer,2011-05-08,19,61,178,239,4333,19:00 - 20:59
summer,2011-05-08,20,42,132,174,4333,19:00 - 20:59
summer,2011-05-08,21,32,95,127,4333,21:00 - 22:59
summer,2011-05-08,22,29,86,115,4333,21:00 - 22:59
summer,2011-05-08,23,9,41,50,4333,23:00 - 24:59
summer,2011-05-09,0,31,22,53,4362,
summer,2011-05-09,1,25,8,33,4362,01:00 - 02:59
summer,2011-05-09,2,6,2,8,4362,01:00 - 02:59
summer,2011-05-09,3,0,7,7,4362,03:00 - 04:59
summer,2011-05-09,4,0,4,4,4362,03:00 - 04:59
summer,2011-05-09,5,0,23,23,4362,05:00 - 06:59
summer,2011-05-09,6,2,87,89,4362,05:00 - 06:59
summer,2011-05-09,7,16,221,237,4362,07:00 - 08:59
summer,2011-05-09,8,23,351,374,4362,07:00 - 08:59
summer,2011-05-09,9,36,142,178,4362,09:00 - 10:59
summer,2011-05-09,10,24,95,119,4362,09:00 - 10:59
summer,2011-05-09,11,26,99,125,4362,11:00 - 12:59
summer,2011-05-09,12,35,160,195,4362,11:00 - 12:59
summer,2011-05-09,13,36,138,174,4362,13:00 - 14:59
summer,2011-05-09,14,44,118,162,4362,13:00 - 14:59
summer,2011-05-09,15,51,148,199,4362,15:00 - 16:59
summer,2011-05-09,16,49,255,304,4362,15:00 - 16:59
summer,2011-05-09,17,59,539,598,4362,17:00 - 18:59
summer,2011-05-09,18,66,458,524,4362,17:00 - 18:59
summer,2011-05-09,19,45,339,384,4362,19:00 - 20:59
summer,2011-05-09,20,25,214,239,4362,19:00 - 20:59
summer,2011-05-09,21,28,128,156,4362,21:00 - 22:59
summer,2011-05-09,22,21,95,116,4362,21:00 - 22:59
summer,2011-05-09,23,16,45,61,4362,23:00 - 24:59
summer,2011-05-10,0,6,12,18,4803,
summer,2011-05-10,1,3,12,15,4803,01:00 - 02:59
summer,2011-05-10,2,1,4,5,4803,01:00 - 02:59
summer,2011-05-10,3,1,3,4,4803,03:00 - 04:59
summer,2011-05-10,4,0,2,2,4803,03:00 - 04:59
summer,2011-05-10,5,1,28,29,4803,05:00 - 06:59
summer,2011-05-10,6,9,103,112,4803,05:00 - 06:59
summer,2011-05-10,7,13,301,314,4803,07:00 - 08:59
summer,2011-05-10,8,28,397,425,4803,07:00 - 08:59
summer,2011-05-10,9,29,176,205,4803,09:00 - 10:59
summer,2011-05-10,10,27,100,127,4803,09:00 - 10:59
summer,2011-05-10,11,17,108,125,4803,11:00 - 12:59
summer,2011-05-10,12,47,170,217,4803,11:00 - 12:59
summer,2011-05-10,13,50,152,202,4803,13:00 - 14:59
summer,2011-05-10,14,42,134,176,4803,13:00 - 14:59
summer,2011-05-10,15,28,152,180,4803,15:00 - 16:59
summer,2011-05-10,16,56,271,327,4803,15:00 - 16:59
summer,2011-05-10,17,79,532,611,4803,17:00 - 18:59
summer,2011-05-10,18,70,480,550,4803,17:00 - 18:59
summer,2011-05-10,19,69,365,434,4803,19:00 - 20:59
summer,2011-05-10,20,50,241,291,4803,19:00 - 20:59
summer,2011-05-10,21,30,173,203,4803,21:00 - 22:59
summer,2011-05-10,22,29,121,150,4803,21:00 - 22:59
summer,2011-05-10,23,9,72,81,4803,23:00 - 24:59
summer,2011-05-11,0,8,30,38,4182,
summer,2011-05-11,1,4,16,20,4182,01:00 - 02:59
summer,2011-05-11,2,6,4,10,4182,01:00 - 02:59
summer,2011-05-11,3,0,3,3,4182,03:00 - 04:59
summer,2011-05-11,4,0,2,2,4182,03:00 - 04:59
summer,2011-05-11,5,0,20,20,4182,05:00 - 06:59
summer,2011-05-11,6,6,93,99,4182,05:00 - 06:59
summer,2011-05-11,7,25,293,318,4182,07:00 - 08:59
summer,2011-05-11,8,21,421,442,4182,07:00 - 08:59
summer,2011-05-11,9,21,182,203,4182,09:00 - 10:59
summer,2011-05-11,10,30,124,154,4182,09:00 - 10:59
summer,2011-05-11,11,18,123,141,4182,11:00 - 12:59
summer,2011-05-11,12,41,185,226,4182,11:00 - 12:59
summer,2011-05-11,13,36,157,193,4182,13:00 - 14:59
summer,2011-05-11,14,36,141,177,4182,13:00 - 14:59
summer,2011-05-11,15,48,131,179,4182,15:00 - 16:59
summer,2011-05-11,16,49,240,289,4182,15:00 - 16:59
summer,2011-05-11,17,17,242,259,4182,17:00 - 18:59
summer,2011-05-11,18,40,234,274,4182,17:00 - 18:59
summer,2011-05-11,19,60,341,401,4182,19:00 - 20:59
summer,2011-05-11,20,28,245,273,4182,19:00 - 20:59
summer,2011-05-11,21,32,202,234,4182,21:00 - 22:59
summer,2011-05-11,22,12,134,146,4182,21:00 - 22:59
summer,2011-05-11,23,12,69,81,4182,23:00 - 24:59
summer,2011-05-12,0,5,39,44,4864,
summer,2011-05-12,1,1,16,17,4864,01:00 - 02:59
summer,2011-05-12,2,1,14,15,4864,01:00 - 02:59
summer,2011-05-12,3,0,5,5,4864,03:00 - 04:59
summer,2011-05-12,4,1,5,6,4864,03:00 - 04:59
summer,2011-05-12,5,2,27,29,4864,05:00 - 06:59
summer,2011-05-12,6,9,103,112,4864,05:00 - 06:59
summer,2011-05-12,7,14,283,297,4864,07:00 - 08:59
summer,2011-05-12,8,27,394,421,4864,07:00 - 08:59
summer,2011-05-12,9,21,191,212,4864,09:00 - 10:59
summer,2011-05-12,10,28,119,147,4864,09:00 - 10:59
summer,2011-05-12,11,43,136,179,4864,11:00 - 12:59
summer,2011-05-12,12,43,164,207,4864,11:00 - 12:59
summer,2011-05-12,13,48,170,218,4864,13:00 - 14:59
summer,2011-05-12,14,43,148,191,4864,13:00 - 14:59
summer,2011-05-12,15,54,163,217,4864,15:00 - 16:59
summer,2011-05-12,16,50,238,288,4864,15:00 - 16:59
summer,2011-05-12,17,54,540,594,4864,17:00 - 18:59
summer,2011-05-12,18,64,463,527,4864,17:00 - 18:59
summer,2011-05-12,19,59,305,364,4864,19:00 - 20:59
summer,2011-05-12,20,56,220,276,4864,19:00 - 20:59
summer,2011-05-12,21,31,192,223,4864,21:00 - 22:59
summer,2011-05-12,22,25,147,172,4864,21:00 - 22:59
summer,2011-05-12,23,16,87,103,4864,23:00 - 24:59
summer,2011-05-13,0,6,46,52,4105,
summer,2011-05-13,1,5,15,20,4105,01:00 - 02:59
summer,2011-05-13,2,3,8,11,4105,01:00 - 02:59
summer,2011-05-13,3,2,2,4,4105,03:00 - 04:59
summer,2011-05-13,4,2,3,5,4105,03:00 - 04:59
summer,2011-05-13,5,1,24,25,4105,05:00 - 06:59
summer,2011-05-13,6,6,76,82,4105,05:00 - 06:59
summer,2011-05-13,7,16,141,157,4105,07:00 - 08:59
summer,2011-05-13,8,26,361,387,4105,07:00 - 08:59
summer,2011-05-13,9,18,215,233,4105,09:00 - 10:59
summer,2011-05-13,10,31,99,130,4105,09:00 - 10:59
summer,2011-05-13,11,56,90,146,4105,11:00 - 12:59
summer,2011-05-13,12,53,170,223,4105,11:00 - 12:59
summer,2011-05-13,13,69,157,226,4105,13:00 - 14:59
summer,2011-05-13,14,70,120,190,4105,13:00 - 14:59
summer,2011-05-13,15,56,142,198,4105,15:00 - 16:59
summer,2011-05-13,16,44,256,300,4105,15:00 - 16:59
summer,2011-05-13,17,62,429,491,4105,17:00 - 18:59
summer,2011-05-13,18,39,359,398,4105,17:00 - 18:59
summer,2011-05-13,19,25,245,270,4105,19:00 - 20:59
summer,2011-05-13,20,22,130,152,4105,19:00 - 20:59
summer,2011-05-13,21,24,130,154,4105,21:00 - 22:59
summer,2011-05-13,22,25,107,132,4105,21:00 - 22:59
summer,2011-05-13,23,31,88,119,4105,23:00 - 24:59
summer,2011-05-14,0,24,78,102,3409,
summer,2011-05-14,1,18,64,82,3409,01:00 - 02:59
summer,2011-05-14,2,15,37,52,3409,01:00 - 02:59
summer,2011-05-14,3,5,30,35,3409,03:00 - 04:59
summer,2011-05-14,4,1,4,5,3409,03:00 - 04:59
summer,2011-05-14,5,7,7,14,3409,05:00 - 06:59
summer,2011-05-14,6,2,9,11,3409,05:00 - 06:59
summer,2011-05-14,7,4,28,32,3409,07:00 - 08:59
summer,2011-05-14,8,16,72,88,3409,07:00 - 08:59
summer,2011-05-14,9,14,86,100,3409,09:00 - 10:59
summer,2011-05-14,10,34,133,167,3409,09:00 - 10:59
summer,2011-05-14,11,72,207,279,3409,11:00 - 12:59
summer,2011-05-14,12,75,204,279,3409,11:00 - 12:59
summer,2011-05-14,13,68,180,248,3409,13:00 - 14:59
summer,2011-05-14,14,57,159,216,3409,13:00 - 14:59
summer,2011-05-14,15,73,221,294,3409,15:00 - 16:59
summer,2011-05-14,16,107,188,295,3409,15:00 - 16:59
summer,2011-05-14,17,78,194,272,3409,17:00 - 18:59
summer,2011-05-14,18,88,216,304,3409,17:00 - 18:59
summer,2011-05-14,19,69,179,248,3409,19:00 - 20:59
summer,2011-05-14,20,42,115,157,3409,19:00 - 20:59
summer,2011-05-14,21,15,44,59,3409,21:00 - 22:59
summer,2011-05-14,22,7,19,26,3409,21:00 - 22:59
summer,2011-05-14,23,11,33,44,3409,23:00 - 24:59
summer,2011-05-15,0,5,34,39,4553,
summer,2011-05-15,1,4,43,47,4553,01:00 - 02:59
summer,2011-05-15,2,13,37,50,4553,01:00 - 02:59
summer,2011-05-15,3,11,21,32,4553,03:00 - 04:59
summer,2011-05-15,4,5,8,13,4553,03:00 - 04:59
summer,2011-05-15,5,3,11,14,4553,05:00 - 06:59
summer,2011-05-15,6,3,14,17,4553,05:00 - 06:59
summer,2011-05-15,7,4,38,42,4553,07:00 - 08:59
summer,2011-05-15,8,24,46,70,4553,07:00 - 08:59
summer,2011-05-15,9,36,98,134,4553,09:00 - 10:59
summer,2011-05-15,10,73,153,226,4553,09:00 - 10:59
summer,2011-05-15,11,120,202,322,4553,11:00 - 12:59
summer,2011-05-15,12,120,247,367,4553,11:00 - 12:59
summer,2011-05-15,13,195,261,456,4553,13:00 - 14:59
summer,2011-05-15,14,183,254,437,4553,13:00 - 14:59
summer,2011-05-15,15,206,253,459,4553,15:00 - 16:59
summer,2011-05-15,16,158,282,440,4553,15:00 - 16:59
summer,2011-05-15,17,137,255,392,4553,17:00 - 18:59
summer,2011-05-15,18,60,177,237,4553,17:00 - 18:59
summer,2011-05-15,19,78,153,231,4553,19:00 - 20:59
summer,2011-05-15,20,53,138,191,4553,19:00 - 20:59
summer,2011-05-15,21,44,107,151,4553,21:00 - 22:59
summer,2011-05-15,22,29,88,117,4553,21:00 - 22:59
summer,2011-05-15,23,18,51,69,4553,23:00 - 24:59
summer,2011-05-16,0,17,21,38,3958,
summer,2011-05-16,1,6,8,14,3958,01:00 - 02:59
summer,2011-05-16,2,4,9,13,3958,01:00 - 02:59
summer,2011-05-16,3,1,3,4,3958,03:00 - 04:59
summer,2011-05-16,4,1,5,6,3958,03:00 - 04:59
summer,2011-05-16,5,1,20,21,3958,05:00 - 06:59
summer,2011-05-16,6,11,93,104,3958,05:00 - 06:59
summer,2011-05-16,7,27,245,272,3958,07:00 - 08:59
summer,2011-05-16,8,28,366,394,3958,07:00 - 08:59
summer,2011-05-16,9,38,156,194,3958,09:00 - 10:59
summer,2011-05-16,10,37,75,112,3958,09:00 - 10:59
summer,2011-05-16,11,56,129,185,3958,11:00 - 12:59
summer,2011-05-16,12,72,137,209,3958,11:00 - 12:59
summer,2011-05-16,13,61,153,214,3958,13:00 - 14:59
summer,2011-05-16,14,76,117,193,3958,13:00 - 14:59
summer,2011-05-16,15,55,110,165,3958,15:00 - 16:59
summer,2011-05-16,16,45,181,226,3958,15:00 - 16:59
summer,2011-05-16,17,47,227,274,3958,17:00 - 18:59
summer,2011-05-16,18,55,398,453,3958,17:00 - 18:59
summer,2011-05-16,19,36,272,308,3958,19:00 - 20:59
summer,2011-05-16,20,31,167,198,3958,19:00 - 20:59
summer,2011-05-16,21,28,149,177,3958,21:00 - 22:59
summer,2011-05-16,22,22,105,127,3958,21:00 - 22:59
summer,2011-05-16,23,18,39,57,3958,23:00 - 24:59
summer,2011-05-17,0,13,18,31,4123,
summer,2011-05-17,1,7,6,13,4123,01:00 - 02:59
summer,2011-05-17,2,4,4,8,4123,01:00 - 02:59
summer,2011-05-17,3,1,3,4,4123,03:00 - 04:59
summer,2011-05-17,4,2,2,4,4123,03:00 - 04:59
summer,2011-05-17,5,0,22,22,4123,05:00 - 06:59
summer,2011-05-17,6,0,49,49,4123,05:00 - 06:59
summer,2011-05-17,7,13,138,151,4123,07:00 - 08:59
summer,2011-05-17,8,22,325,347,4123,07:00 - 08:59
summer,2011-05-17,9,17,190,207,4123,09:00 - 10:59
summer,2011-05-17,10,31,73,104,4123,09:00 - 10:59
summer,2011-05-17,11,26,104,130,4123,11:00 - 12:59
summer,2011-05-17,12,38,115,153,4123,11:00 - 12:59
summer,2011-05-17,13,31,141,172,4123,13:00 - 14:59
summer,2011-05-17,14,61,123,184,4123,13:00 - 14:59
summer,2011-05-17,15,79,131,210,4123,15:00 - 16:59
summer,2011-05-17,16,73,217,290,4123,15:00 - 16:59
summer,2011-05-17,17,83,521,604,4123,17:00 - 18:59
summer,2011-05-17,18,54,426,480,4123,17:00 - 18:59
summer,2011-05-17,19,51,298,349,4123,19:00 - 20:59
summer,2011-05-17,20,30,253,283,4123,19:00 - 20:59
summer,2011-05-17,21,23,151,174,4123,21:00 - 22:59
summer,2011-05-17,22,12,86,98,4123,21:00 - 22:59
summer,2011-05-17,23,7,49,56,4123,23:00 - 24:59
summer,2011-05-18,0,8,15,23,3855,
summer,2011-05-18,1,3,9,12,3855,01:00 - 02:59
summer,2011-05-18,2,1,5,6,3855,01:00 - 02:59
summer,2011-05-18,3,6,3,9,3855,03:00 - 04:59
summer,2011-05-18,4,1,2,3,3855,03:00 - 04:59
summer,2011-05-18,5,0,9,9,3855,05:00 - 06:59
summer,2011-05-18,6,2,99,101,3855,05:00 - 06:59
summer,2011-05-18,7,14,260,274,3855,07:00 - 08:59
summer,2011-05-18,8,25,428,453,3855,07:00 - 08:59
summer,2011-05-18,9,26,176,202,3855,09:00 - 10:59
summer,2011-05-18,10,33,73,106,3855,09:00 - 10:59
summer,2011-05-18,11,6,17,23,3855,11:00 - 12:59
summer,2011-05-18,12,12,42,54,3855,11:00 - 12:59
summer,2011-05-18,13,30,92,122,3855,13:00 - 14:59
summer,2011-05-18,14,44,94,138,3855,13:00 - 14:59
summer,2011-05-18,15,34,133,167,3855,15:00 - 16:59
summer,2011-05-18,16,53,241,294,3855,15:00 - 16:59
summer,2011-05-18,17,78,487,565,3855,17:00 - 18:59
summer,2011-05-18,18,58,431,489,3855,17:00 - 18:59
summer,2011-05-18,19,43,288,331,3855,19:00 - 20:59
summer,2011-05-18,20,24,189,213,3855,19:00 - 20:59
summer,2011-05-18,21,11,74,85,3855,21:00 - 22:59
summer,2011-05-18,22,14,103,117,3855,21:00 - 22:59
summer,2011-05-18,23,10,49,59,3855,23:00 - 24:59
summer,2011-05-19,0,6,23,29,4575,
summer,2011-05-19,1,2,4,6,4575,01:00 - 02:59
summer,2011-05-19,2,3,12,15,4575,01:00 - 02:59
summer,2011-05-19,3,1,3,4,4575,03:00 - 04:59
summer,2011-05-19,4,2,3,5,4575,03:00 - 04:59
summer,2011-05-19,5,2,24,26,4575,05:00 - 06:59
summer,2011-05-19,6,17,86,103,4575,05:00 - 06:59
summer,2011-05-19,7,18,239,257,4575,07:00 - 08:59
summer,2011-05-19,8,34,453,487,4575,07:00 - 08:59
summer,2011-05-19,9,40,176,216,4575,09:00 - 10:59
summer,2011-05-19,10,35,95,130,4575,09:00 - 10:59
summer,2011-05-19,11,53,111,164,4575,11:00 - 12:59
summer,2011-05-19,12,38,130,168,4575,11:00 - 12:59
summer,2011-05-19,13,44,139,183,4575,13:00 - 14:59
summer,2011-05-19,14,43,137,180,4575,13:00 - 14:59
summer,2011-05-19,15,63,125,188,4575,15:00 - 16:59
summer,2011-05-19,16,55,247,302,4575,15:00 - 16:59
summer,2011-05-19,17,60,487,547,4575,17:00 - 18:59
summer,2011-05-19,18,59,454,513,4575,17:00 - 18:59
summer,2011-05-19,19,65,345,410,4575,19:00 - 20:59
summer,2011-05-19,20,46,236,282,4575,19:00 - 20:59
summer,2011-05-19,21,29,180,209,4575,21:00 - 22:59
summer,2011-05-19,22,11,68,79,4575,21:00 - 22:59
summer,2011-05-19,23,9,63,72,4575,23:00 - 24:59
summer,2011-05-20,0,15,33,48,4917,
summer,2011-05-20,1,8,17,25,4917,01:00 - 02:59
summer,2011-05-20,2,4,4,8,4917,01:00 - 02:59
summer,2011-05-20,3,1,4,5,4917,03:00 - 04:59
summer,2011-05-20,4,1,4,5,4917,03:00 - 04:59
summer,2011-05-20,5,0,28,28,4917,05:00 - 06:59
summer,2011-05-20,6,15,102,117,4917,05:00 - 06:59
summer,2011-05-20,7,30,289,319,4917,07:00 - 08:59
summer,2011-05-20,8,41,476,517,4917,07:00 - 08:59
summer,2011-05-20,9,35,199,234,4917,09:00 - 10:59
summer,2011-05-20,10,44,104,148,4917,09:00 - 10:59
summer,2011-05-20,11,63,133,196,4917,11:00 - 12:59
summer,2011-05-20,12,69,186,255,4917,11:00 - 12:59
summer,2011-05-20,13,60,172,232,4917,13:00 - 14:59
summer,2011-05-20,14,66,131,197,4917,13:00 - 14:59
summer,2011-05-20,15,74,168,242,4917,15:00 - 16:59
summer,2011-05-20,16,61,269,330,4917,15:00 - 16:59
summer,2011-05-20,17,71,483,554,4917,17:00 - 18:59
summer,2011-05-20,18,79,394,473,4917,17:00 - 18:59
summer,2011-05-20,19,49,253,302,4917,19:00 - 20:59
summer,2011-05-20,20,40,180,220,4917,19:00 - 20:59
summer,2011-05-20,21,40,155,195,4917,21:00 - 22:59
summer,2011-05-20,22,28,124,152,4917,21:00 - 22:59
summer,2011-05-20,23,15,100,115,4917,23:00 - 24:59
summer,2011-05-21,0,20,78,98,5805,
summer,2011-05-21,1,8,64,72,5805,01:00 - 02:59
summer,2011-05-21,2,5,35,40,5805,01:00 - 02:59
summer,2011-05-21,3,7,12,19,5805,03:00 - 04:59
summer,2011-05-21,4,1,6,7,5805,03:00 - 04:59
summer,2011-05-21,5,1,4,5,5805,05:00 - 06:59
summer,2011-05-21,6,6,22,28,5805,05:00 - 06:59
summer,2011-05-21,7,10,33,43,5805,07:00 - 08:59
summer,2011-05-21,8,29,97,126,5805,07:00 - 08:59
summer,2011-05-21,9,60,165,225,5805,09:00 - 10:59
summer,2011-05-21,10,122,201,323,5805,09:00 - 10:59
summer,2011-05-21,11,173,245,418,5805,11:00 - 12:59
summer,2011-05-21,12,222,271,493,5805,11:00 - 12:59
summer,2011-05-21,13,191,271,462,5805,13:00 - 14:59
summer,2011-05-21,14,187,269,456,5805,13:00 - 14:59
summer,2011-05-21,15,232,274,506,5805,15:00 - 16:59
summer,2011-05-21,16,204,267,471,5805,15:00 - 16:59
summer,2011-05-21,17,191,253,444,5805,17:00 - 18:59
summer,2011-05-21,18,191,253,444,5805,17:00 - 18:59
summer,2011-05-21,19,117,184,301,5805,19:00 - 20:59
summer,2011-05-21,20,84,164,248,5805,19:00 - 20:59
summer,2011-05-21,21,77,150,227,5805,21:00 - 22:59
summer,2011-05-21,22,78,126,204,5805,21:00 - 22:59
summer,2011-05-21,23,42,103,145,5805,23:00 - 24:59
summer,2011-05-22,0,31,100,131,4660,
summer,2011-05-22,1,17,81,98,4660,01:00 - 02:59
summer,2011-05-22,2,18,50,68,4660,01:00 - 02:59
summer,2011-05-22,3,10,23,33,4660,03:00 - 04:59
summer,2011-05-22,4,3,9,12,4660,03:00 - 04:59
summer,2011-05-22,5,1,5,6,4660,05:00 - 06:59
summer,2011-05-22,6,5,13,18,4660,05:00 - 06:59
summer,2011-05-22,7,13,27,40,4660,07:00 - 08:59
summer,2011-05-22,8,29,65,94,4660,07:00 - 08:59
summer,2011-05-22,9,59,130,189,4660,09:00 - 10:59
summer,2011-05-22,10,135,170,305,4660,09:00 - 10:59
summer,2011-05-22,11,164,209,373,4660,11:00 - 12:59
summer,2011-05-22,12,146,255,401,4660,11:00 - 12:59
summer,2011-05-22,13,180,275,455,4660,13:00 - 14:59
summer,2011-05-22,14,125,191,316,4660,13:00 - 14:59
summer,2011-05-22,15,110,221,331,4660,15:00 - 16:59
summer,2011-05-22,16,72,201,273,4660,15:00 - 16:59
summer,2011-05-22,17,93,213,306,4660,17:00 - 18:59
summer,2011-05-22,18,120,238,358,4660,17:00 - 18:59
summer,2011-05-22,19,107,193,300,4660,19:00 - 20:59
summer,2011-05-22,20,57,174,231,4660,19:00 - 20:59
summer,2011-05-22,21,27,109,136,4660,21:00 - 22:59
summer,2011-05-22,22,35,86,121,4660,21:00 - 22:59
summer,2011-05-22,23,19,46,65,4660,23:00 - 24:59
summer,2011-05-23,0,23,18,41,4274,
summer,2011-05-23,1,4,5,9,4274,01:00 - 02:59
summer,2011-05-23,2,2,3,5,4274,01:00 - 02:59
summer,2011-05-23,3,0,4,4,4274,03:00 - 04:59
summer,2011-05-23,4,2,2,4,4274,03:00 - 04:59
summer,2011-05-23,5,0,11,11,4274,05:00 - 06:59
summer,2011-05-23,6,4,92,96,4274,05:00 - 06:59
summer,2011-05-23,7,13,223,236,4274,07:00 - 08:59
summer,2011-05-23,8,50,359,409,4274,07:00 - 08:59
summer,2011-05-23,9,36,131,167,4274,09:00 - 10:59
summer,2011-05-23,10,49,72,121,4274,09:00 - 10:59
summer,2011-05-23,11,73,107,180,4274,11:00 - 12:59
summer,2011-05-23,12,65,139,204,4274,11:00 - 12:59
summer,2011-05-23,13,49,155,204,4274,13:00 - 14:59
summer,2011-05-23,14,57,130,187,4274,13:00 - 14:59
summer,2011-05-23,15,57,119,176,4274,15:00 - 16:59
summer,2011-05-23,16,56,223,279,4274,15:00 - 16:59
summer,2011-05-23,17,56,373,429,4274,17:00 - 18:59
summer,2011-05-23,18,68,385,453,4274,17:00 - 18:59
summer,2011-05-23,19,56,302,358,4274,19:00 - 20:59
summer,2011-05-23,20,39,271,310,4274,19:00 - 20:59
summer,2011-05-23,21,33,155,188,4274,21:00 - 22:59
summer,2011-05-23,22,25,106,131,4274,21:00 - 22:59
summer,2011-05-23,23,19,53,72,4274,23:00 - 24:59
summer,2011-05-24,0,12,23,35,4492,
summer,2011-05-24,1,6,9,15,4492,01:00 - 02:59
summer,2011-05-24,2,2,8,10,4492,01:00 - 02:59
summer,2011-05-24,3,0,2,2,4492,03:00 - 04:59
summer,2011-05-24,4,1,3,4,4492,03:00 - 04:59
summer,2011-05-24,5,2,22,24,4492,05:00 - 06:59
summer,2011-05-24,6,10,102,112,4492,05:00 - 06:59
summer,2011-05-24,7,26,288,314,4492,07:00 - 08:59
summer,2011-05-24,8,31,403,434,4492,07:00 - 08:59
summer,2011-05-24,9,27,111,138,4492,09:00 - 10:59
summer,2011-05-24,10,18,90,108,4492,09:00 - 10:59
summer,2011-05-24,11,33,142,175,4492,11:00 - 12:59
summer,2011-05-24,12,41,129,170,4492,11:00 - 12:59
summer,2011-05-24,13,38,152,190,4492,13:00 - 14:59
summer,2011-05-24,14,27,126,153,4492,13:00 - 14:59
summer,2011-05-24,15,59,129,188,4492,15:00 - 16:59
summer,2011-05-24,16,52,225,277,4492,15:00 - 16:59
summer,2011-05-24,17,56,492,548,4492,17:00 - 18:59
summer,2011-05-24,18,74,490,564,4492,17:00 - 18:59
summer,2011-05-24,19,45,310,355,4492,19:00 - 20:59
summer,2011-05-24,20,39,241,280,4492,19:00 - 20:59
summer,2011-05-24,21,21,168,189,4492,21:00 - 22:59
summer,2011-05-24,22,26,115,141,4492,21:00 - 22:59
summer,2011-05-24,23,13,53,66,4492,23:00 - 24:59
summer,2011-05-25,0,3,32,35,4978,
summer,2011-05-25,1,6,2,8,4978,01:00 - 02:59
summer,2011-05-25,2,0,8,8,4978,01:00 - 02:59
summer,2011-05-25,3,0,9,9,4978,03:00 - 04:59
summer,2011-05-25,4,0,3,3,4978,03:00 - 04:59
summer,2011-05-25,5,2,23,25,4978,05:00 - 06:59
summer,2011-05-25,6,4,113,117,4978,05:00 - 06:59
summer,2011-05-25,7,29,284,313,4978,07:00 - 08:59
summer,2011-05-25,8,36,495,531,4978,07:00 - 08:59
summer,2011-05-25,9,27,207,234,4978,09:00 - 10:59
summer,2011-05-25,10,30,105,135,4978,09:00 - 10:59
summer,2011-05-25,11,36,104,140,4978,11:00 - 12:59
summer,2011-05-25,12,32,178,210,4978,11:00 - 12:59
summer,2011-05-25,13,39,163,202,4978,13:00 - 14:59
summer,2011-05-25,14,47,121,168,4978,13:00 - 14:59
summer,2011-05-25,15,37,145,182,4978,15:00 - 16:59
summer,2011-05-25,16,61,238,299,4978,15:00 - 16:59
summer,2011-05-25,17,77,524,601,4978,17:00 - 18:59
summer,2011-05-25,18,66,451,517,4978,17:00 - 18:59
summer,2011-05-25,19,73,332,405,4978,19:00 - 20:59
summer,2011-05-25,20,56,284,340,4978,19:00 - 20:59
summer,2011-05-25,21,33,203,236,4978,21:00 - 22:59
summer,2011-05-25,22,34,140,174,4978,21:00 - 22:59
summer,2011-05-25,23,12,74,86,4978,23:00 - 24:59
summer,2011-05-26,0,11,34,45,4677,
summer,2011-05-26,1,3,13,16,4677,01:00 - 02:59
summer,2011-05-26,2,7,7,14,4677,01:00 - 02:59
summer,2011-05-26,3,0,4,4,4677,03:00 - 04:59
summer,2011-05-26,4,0,2,2,4677,03:00 - 04:59
summer,2011-05-26,5,2,25,27,4677,05:00 - 06:59
summer,2011-05-26,6,4,94,98,4677,05:00 - 06:59
summer,2011-05-26,7,16,270,286,4677,07:00 - 08:59
summer,2011-05-26,8,31,458,489,4677,07:00 - 08:59
summer,2011-05-26,9,22,194,216,4677,09:00 - 10:59
summer,2011-05-26,10,49,94,143,4677,09:00 - 10:59
summer,2011-05-26,11,36,124,160,4677,11:00 - 12:59
summer,2011-05-26,12,53,141,194,4677,11:00 - 12:59
summer,2011-05-26,13,52,145,197,4677,13:00 - 14:59
summer,2011-05-26,14,44,145,189,4677,13:00 - 14:59
summer,2011-05-26,15,40,101,141,4677,15:00 - 16:59
summer,2011-05-26,16,58,233,291,4677,15:00 - 16:59
summer,2011-05-26,17,49,445,494,4677,17:00 - 18:59
summer,2011-05-26,18,74,404,478,4677,17:00 - 18:59
summer,2011-05-26,19,67,311,378,4677,19:00 - 20:59
summer,2011-05-26,20,55,267,322,4677,19:00 - 20:59
summer,2011-05-26,21,45,178,223,4677,21:00 - 22:59
summer,2011-05-26,22,23,157,180,4677,21:00 - 22:59
summer,2011-05-26,23,17,73,90,4677,23:00 - 24:59
summer,2011-05-27,0,14,55,69,4679,
summer,2011-05-27,1,14,36,50,4679,01:00 - 02:59
summer,2011-05-27,2,6,12,18,4679,01:00 - 02:59
summer,2011-05-27,3,1,11,12,4679,03:00 - 04:59
summer,2011-05-27,4,2,5,7,4679,03:00 - 04:59
summer,2011-05-27,5,2,29,31,4679,05:00 - 06:59
summer,2011-05-27,6,8,73,81,4679,05:00 - 06:59
summer,2011-05-27,7,20,229,249,4679,07:00 - 08:59
summer,2011-05-27,8,25,393,418,4679,07:00 - 08:59
summer,2011-05-27,9,37,190,227,4679,09:00 - 10:59
summer,2011-05-27,10,42,111,153,4679,09:00 - 10:59
summer,2011-05-27,11,40,126,166,4679,11:00 - 12:59
summer,2011-05-27,12,53,190,243,4679,11:00 - 12:59
summer,2011-05-27,13,51,158,209,4679,13:00 - 14:59
summer,2011-05-27,14,51,188,239,4679,13:00 - 14:59
summer,2011-05-27,15,98,258,356,4679,15:00 - 16:59
summer,2011-05-27,16,63,356,419,4679,15:00 - 16:59
summer,2011-05-27,17,77,414,491,4679,17:00 - 18:59
summer,2011-05-27,18,89,310,399,4679,17:00 - 18:59
summer,2011-05-27,19,69,210,279,4679,19:00 - 20:59
summer,2011-05-27,20,24,120,144,4679,19:00 - 20:59
summer,2011-05-27,21,37,114,151,4679,21:00 - 22:59
summer,2011-05-27,22,25,116,141,4679,21:00 - 22:59
summer,2011-05-27,23,23,104,127,4679,23:00 - 24:59
summer,2011-05-28,0,15,79,94,4758,
summer,2011-05-28,1,8,47,55,4758,01:00 - 02:59
summer,2011-05-28,2,13,35,48,4758,01:00 - 02:59
summer,2011-05-28,3,2,13,15,4758,03:00 - 04:59
summer,2011-05-28,4,0,4,4,4758,03:00 - 04:59
summer,2011-05-28,5,4,3,7,4758,05:00 - 06:59
summer,2011-05-28,6,3,16,19,4758,05:00 - 06:59
summer,2011-05-28,7,17,33,50,4758,07:00 - 08:59
summer,2011-05-28,8,27,75,102,4758,07:00 - 08:59
summer,2011-05-28,9,61,116,177,4758,09:00 - 10:59
summer,2011-05-28,10,110,166,276,4758,09:00 - 10:59
summer,2011-05-28,11,171,178,349,4758,11:00 - 12:59
summer,2011-05-28,12,145,213,358,4758,11:00 - 12:59
summer,2011-05-28,13,168,217,385,4758,13:00 - 14:59
summer,2011-05-28,14,172,210,382,4758,13:00 - 14:59
summer,2011-05-28,15,187,187,374,4758,15:00 - 16:59
summer,2011-05-28,16,201,201,402,4758,15:00 - 16:59
summer,2011-05-28,17,180,161,341,4758,17:00 - 18:59
summer,2011-05-28,18,173,212,385,4758,17:00 - 18:59
summer,2011-05-28,19,99,153,252,4758,19:00 - 20:59
summer,2011-05-28,20,68,128,196,4758,19:00 - 20:59
summer,2011-05-28,21,87,114,201,4758,21:00 - 22:59
summer,2011-05-28,22,46,115,161,4758,21:00 - 22:59
summer,2011-05-28,23,44,81,125,4758,23:00 - 24:59
summer,2011-05-29,0,32,51,83,4788,
summer,2011-05-29,1,17,49,66,4788,01:00 - 02:59
summer,2011-05-29,2,12,49,61,4788,01:00 - 02:59
summer,2011-05-29,3,2,24,26,4788,03:00 - 04:59
summer,2011-05-29,4,13,10,23,4788,03:00 - 04:59
summer,2011-05-29,5,3,3,6,4788,05:00 - 06:59
summer,2011-05-29,6,5,10,15,4788,05:00 - 06:59
summer,2011-05-29,7,13,17,30,4788,07:00 - 08:59
summer,2011-05-29,8,34,62,96,4788,07:00 - 08:59
summer,2011-05-29,9,74,78,152,4788,09:00 - 10:59
summer,2011-05-29,10,130,121,251,4788,09:00 - 10:59
summer,2011-05-29,11,139,180,319,4788,11:00 - 12:59
summer,2011-05-29,12,216,186,402,4788,11:00 - 12:59
summer,2011-05-29,13,237,181,418,4788,13:00 - 14:59
summer,2011-05-29,14,183,168,351,4788,13:00 - 14:59
summer,2011-05-29,15,221,155,376,4788,15:00 - 16:59
summer,2011-05-29,16,194,167,361,4788,15:00 - 16:59
summer,2011-05-29,17,214,169,383,4788,17:00 - 18:59
summer,2011-05-29,18,151,177,328,4788,17:00 - 18:59
summer,2011-05-29,19,141,146,287,4788,19:00 - 20:59
summer,2011-05-29,20,91,128,219,4788,19:00 - 20:59
summer,2011-05-29,21,107,122,229,4788,21:00 - 22:59
summer,2011-05-29,22,78,93,171,4788,21:00 - 22:59
summer,2011-05-29,23,48,87,135,4788,23:00 - 24:59
summer,2011-05-30,0,38,65,103,4098,
summer,2011-05-30,1,26,53,79,4098,01:00 - 02:59
summer,2011-05-30,2,17,28,45,4098,01:00 - 02:59
summer,2011-05-30,3,10,8,18,4098,03:00 - 04:59
summer,2011-05-30,4,2,4,6,4098,03:00 - 04:59
summer,2011-05-30,5,1,6,7,4098,05:00 - 06:59
summer,2011-05-30,6,6,10,16,4098,05:00 - 06:59
summer,2011-05-30,7,12,19,31,4098,07:00 - 08:59
summer,2011-05-30,8,36,58,94,4098,07:00 - 08:59
summer,2011-05-30,9,47,81,128,4098,09:00 - 10:59
summer,2011-05-30,10,116,153,269,4098,09:00 - 10:59
summer,2011-05-30,11,153,168,321,4098,11:00 - 12:59
summer,2011-05-30,12,179,187,366,4098,11:00 - 12:59
summer,2011-05-30,13,133,217,350,4098,13:00 - 14:59
summer,2011-05-30,14,142,185,327,4098,13:00 - 14:59
summer,2011-05-30,15,132,179,311,4098,15:00 - 16:59
summer,2011-05-30,16,101,208,309,4098,15:00 - 16:59
summer,2011-05-30,17,102,202,304,4098,17:00 - 18:59
summer,2011-05-30,18,77,172,249,4098,17:00 - 18:59
summer,2011-05-30,19,68,157,225,4098,19:00 - 20:59
summer,2011-05-30,20,69,168,237,4098,19:00 - 20:59
summer,2011-05-30,21,42,107,149,4098,21:00 - 22:59
summer,2011-05-30,22,26,80,106,4098,21:00 - 22:59
summer,2011-05-30,23,14,34,48,4098,23:00 - 24:59
summer,2011-05-31,0,9,20,29,3982,
summer,2011-05-31,1,8,9,17,3982,01:00 - 02:59
summer,2011-05-31,2,5,7,12,3982,01:00 - 02:59
summer,2011-05-31,3,1,3,4,3982,03:00 - 04:59
summer,2011-05-31,4,0,3,3,3982,03:00 - 04:59
summer,2011-05-31,5,0,26,26,3982,05:00 - 06:59
summer,2011-05-31,6,11,98,109,3982,05:00 - 06:59
summer,2011-05-31,7,16,219,235,3982,07:00 - 08:59
summer,2011-05-31,8,34,372,406,3982,07:00 - 08:59
summer,2011-05-31,9,22,153,175,3982,09:00 - 10:59
summer,2011-05-31,10,37,72,109,3982,09:00 - 10:59
summer,2011-05-31,11,28,78,106,3982,11:00 - 12:59
summer,2011-05-31,12,37,125,162,3982,11:00 - 12:59
summer,2011-05-31,13,37,110,147,3982,13:00 - 14:59
summer,2011-05-31,14,41,99,140,3982,13:00 - 14:59
summer,2011-05-31,15,42,133,175,3982,15:00 - 16:59
summer,2011-05-31,16,44,205,249,3982,15:00 - 16:59
summer,2011-05-31,17,67,428,495,3982,17:00 - 18:59
summer,2011-05-31,18,55,362,417,3982,17:00 - 18:59
summer,2011-05-31,19,39,246,285,3982,19:00 - 20:59
summer,2011-05-31,20,38,213,251,3982,19:00 - 20:59
summer,2011-05-31,21,45,165,210,3982,21:00 - 22:59
summer,2011-05-31,22,42,117,159,3982,21:00 - 22:59
summer,2011-05-31,23,15,46,61,3982,23:00 - 24:59
summer,2011-06-01,0,9,25,34,3974,
summer,2011-06-01,1,8,9,17,3974,01:00 - 02:59
summer,2011-06-01,2,0,3,3,3974,01:00 - 02:59
summer,2011-06-01,3,0,6,6,3974,03:00 - 04:59
summer,2011-06-01,4,0,4,4,3974,03:00 - 04:59
summer,2011-06-01,5,2,19,21,3974,05:00 - 06:59
summer,2011-06-01,6,7,121,128,3974,05:00 - 06:59
summer,2011-06-01,7,19,265,284,3974,07:00 - 08:59
summer,2011-06-01,8,37,417,454,3974,07:00 - 08:59
summer,2011-06-01,9,34,173,207,3974,09:00 - 10:59
summer,2011-06-01,10,31,84,115,3974,09:00 - 10:59
summer,2011-06-01,11,26,86,112,3974,11:00 - 12:59
summer,2011-06-01,12,32,137,169,3974,11:00 - 12:59
summer,2011-06-01,13,29,125,154,3974,13:00 - 14:59
summer,2011-06-01,14,40,105,145,3974,13:00 - 14:59
summer,2011-06-01,15,25,127,152,3974,15:00 - 16:59
summer,2011-06-01,16,39,227,266,3974,15:00 - 16:59
summer,2011-06-01,17,52,434,486,3974,17:00 - 18:59
summer,2011-06-01,18,31,278,309,3974,17:00 - 18:59
summer,2011-06-01,19,16,248,264,3974,19:00 - 20:59
summer,2011-06-01,20,23,233,256,3974,19:00 - 20:59
summer,2011-06-01,21,29,161,190,3974,21:00 - 22:59
summer,2011-06-01,22,14,115,129,3974,21:00 - 22:59
summer,2011-06-01,23,10,59,69,3974,23:00 - 24:59
summer,2011-06-02,0,11,31,42,4968,
summer,2011-06-02,1,3,12,15,4968,01:00 - 02:59
summer,2011-06-02,2,0,6,6,4968,01:00 - 02:59
summer,2011-06-02,3,0,4,4,4968,03:00 - 04:59
summer,2011-06-02,4,0,3,3,4968,03:00 - 04:59
summer,2011-06-02,5,3,28,31,4968,05:00 - 06:59
summer,2011-06-02,6,7,106,113,4968,05:00 - 06:59
summer,2011-06-02,7,19,285,304,4968,07:00 - 08:59
summer,2011-06-02,8,25,442,467,4968,07:00 - 08:59
summer,2011-06-02,9,28,197,225,4968,09:00 - 10:59
summer,2011-06-02,10,33,106,139,4968,09:00 - 10:59
summer,2011-06-02,11,42,123,165,4968,11:00 - 12:59
summer,2011-06-02,12,39,193,232,4968,11:00 - 12:59
summer,2011-06-02,13,35,168,203,4968,13:00 - 14:59
summer,2011-06-02,14,43,142,185,4968,13:00 - 14:59
summer,2011-06-02,15,44,144,188,4968,15:00 - 16:59
summer,2011-06-02,16,63,255,318,4968,15:00 - 16:59
summer,2011-06-02,17,88,484,572,4968,17:00 - 18:59
summer,2011-06-02,18,74,451,525,4968,17:00 - 18:59
summer,2011-06-02,19,58,321,379,4968,19:00 - 20:59
summer,2011-06-02,20,51,286,337,4968,19:00 - 20:59
summer,2011-06-02,21,33,215,248,4968,21:00 - 22:59
summer,2011-06-02,22,14,141,155,4968,21:00 - 22:59
summer,2011-06-02,23,23,89,112,4968,23:00 - 24:59
summer,2011-06-03,0,15,53,68,5312,
summer,2011-06-03,1,7,15,22,5312,01:00 - 02:59
summer,2011-06-03,2,0,12,12,5312,01:00 - 02:59
summer,2011-06-03,3,0,5,5,5312,03:00 - 04:59
summer,2011-06-03,4,1,5,6,5312,03:00 - 04:59
summer,2011-06-03,5,4,24,28,5312,05:00 - 06:59
summer,2011-06-03,6,8,98,106,5312,05:00 - 06:59
summer,2011-06-03,7,25,252,277,5312,07:00 - 08:59
summer,2011-06-03,8,31,471,502,5312,07:00 - 08:59
summer,2011-06-03,9,36,194,230,5312,09:00 - 10:59
summer,2011-06-03,10,54,107,161,5312,09:00 - 10:59
summer,2011-06-03,11,57,135,192,5312,11:00 - 12:59
summer,2011-06-03,12,51,208,259,5312,11:00 - 12:59
summer,2011-06-03,13,58,190,248,5312,13:00 - 14:59
summer,2011-06-03,14,66,174,240,5312,13:00 - 14:59
summer,2011-06-03,15,56,156,212,5312,15:00 - 16:59
summer,2011-06-03,16,63,286,349,5312,15:00 - 16:59
summer,2011-06-03,17,73,485,558,5312,17:00 - 18:59
summer,2011-06-03,18,76,488,564,5312,17:00 - 18:59
summer,2011-06-03,19,53,338,391,5312,19:00 - 20:59
summer,2011-06-03,20,57,236,293,5312,19:00 - 20:59
summer,2011-06-03,21,51,196,247,5312,21:00 - 22:59
summer,2011-06-03,22,26,145,171,5312,21:00 - 22:59
summer,2011-06-03,23,30,141,171,5312,23:00 - 24:59
summer,2011-06-04,0,24,69,93,5342,
summer,2011-06-04,1,14,80,94,5342,01:00 - 02:59
summer,2011-06-04,2,18,41,59,5342,01:00 - 02:59
summer,2011-06-04,3,8,10,18,5342,03:00 - 04:59
summer,2011-06-04,4,4,11,15,5342,03:00 - 04:59
summer,2011-06-04,5,3,5,8,5342,05:00 - 06:59
summer,2011-06-04,6,11,17,28,5342,05:00 - 06:59
summer,2011-06-04,7,27,60,87,5342,07:00 - 08:59
summer,2011-06-04,8,29,96,125,5342,07:00 - 08:59
summer,2011-06-04,9,55,169,224,5342,09:00 - 10:59
summer,2011-06-04,10,115,202,317,5342,09:00 - 10:59
summer,2011-06-04,11,120,249,369,5342,11:00 - 12:59
summer,2011-06-04,12,150,270,420,5342,11:00 - 12:59
summer,2011-06-04,13,188,268,456,5342,13:00 - 14:59
summer,2011-06-04,14,193,258,451,5342,13:00 - 14:59
summer,2011-06-04,15,180,224,404,5342,15:00 - 16:59
summer,2011-06-04,16,168,272,440,5342,15:00 - 16:59
summer,2011-06-04,17,142,202,344,5342,17:00 - 18:59
summer,2011-06-04,18,127,214,341,5342,17:00 - 18:59
summer,2011-06-04,19,79,206,285,5342,19:00 - 20:59
summer,2011-06-04,20,90,149,239,5342,19:00 - 20:59
summer,2011-06-04,21,46,139,185,5342,21:00 - 22:59
summer,2011-06-04,22,49,141,190,5342,21:00 - 22:59
summer,2011-06-04,23,29,121,150,5342,23:00 - 24:59
summer,2011-06-05,0,23,90,113,4906,
summer,2011-06-05,1,26,70,96,4906,01:00 - 02:59
summer,2011-06-05,2,16,48,64,4906,01:00 - 02:59
summer,2011-06-05,3,22,25,47,4906,03:00 - 04:59
summer,2011-06-05,4,4,8,12,4906,03:00 - 04:59
summer,2011-06-05,5,1,5,6,4906,05:00 - 06:59
summer,2011-06-05,6,10,11,21,4906,05:00 - 06:59
summer,2011-06-05,7,8,19,27,4906,07:00 - 08:59
summer,2011-06-05,8,24,74,98,4906,07:00 - 08:59
summer,2011-06-05,9,53,111,164,4906,09:00 - 10:59
summer,2011-06-05,10,83,168,251,4906,09:00 - 10:59
summer,2011-06-05,11,121,214,335,4906,11:00 - 12:59
summer,2011-06-05,12,123,212,335,4906,11:00 - 12:59
summer,2011-06-05,13,154,213,367,4906,13:00 - 14:59
summer,2011-06-05,14,161,224,385,4906,13:00 - 14:59
summer,2011-06-05,15,161,256,417,4906,15:00 - 16:59
summer,2011-06-05,16,138,260,398,4906,15:00 - 16:59
summer,2011-06-05,17,126,264,390,4906,17:00 - 18:59
summer,2011-06-05,18,124,239,363,4906,17:00 - 18:59
summer,2011-06-05,19,108,249,357,4906,19:00 - 20:59
summer,2011-06-05,20,84,195,279,4906,19:00 - 20:59
summer,2011-06-05,21,54,111,165,4906,21:00 - 22:59
summer,2011-06-05,22,36,94,130,4906,21:00 - 22:59
summer,2011-06-05,23,25,61,86,4906,23:00 - 24:59
summer,2011-06-06,0,11,18,29,4548,
summer,2011-06-06,1,9,5,14,4548,01:00 - 02:59
summer,2011-06-06,2,4,4,8,4548,01:00 - 02:59
summer,2011-06-06,3,2,3,5,4548,03:00 - 04:59
summer,2011-06-06,4,4,4,8,4548,03:00 - 04:59
summer,2011-06-06,5,7,24,31,4548,05:00 - 06:59
summer,2011-06-06,6,11,101,112,4548,05:00 - 06:59
summer,2011-06-06,7,18,281,299,4548,07:00 - 08:59
summer,2011-06-06,8,28,410,438,4548,07:00 - 08:59
summer,2011-06-06,9,26,162,188,4548,09:00 - 10:59
summer,2011-06-06,10,31,64,95,4548,09:00 - 10:59
summer,2011-06-06,11,39,72,111,4548,11:00 - 12:59
summer,2011-06-06,12,25,128,153,4548,11:00 - 12:59
summer,2011-06-06,13,28,152,180,4548,13:00 - 14:59
summer,2011-06-06,14,46,99,145,4548,13:00 - 14:59
summer,2011-06-06,15,38,127,165,4548,15:00 - 16:59
summer,2011-06-06,16,34,233,267,4548,15:00 - 16:59
summer,2011-06-06,17,63,516,579,4548,17:00 - 18:59
summer,2011-06-06,18,56,500,556,4548,17:00 - 18:59
summer,2011-06-06,19,64,343,407,4548,19:00 - 20:59
summer,2011-06-06,20,59,277,336,4548,19:00 - 20:59
summer,2011-06-06,21,29,160,189,4548,21:00 - 22:59
summer,2011-06-06,22,36,137,173,4548,21:00 - 22:59
summer,2011-06-06,23,5,55,60,4548,23:00 - 24:59
summer,2011-06-07,0,5,15,20,4833,
summer,2011-06-07,1,2,2,4,4833,01:00 - 02:59
summer,2011-06-07,2,3,2,5,4833,01:00 - 02:59
summer,2011-06-07,3,1,1,2,4833,03:00 - 04:59
summer,2011-06-07,4,2,3,5,4833,03:00 - 04:59
summer,2011-06-07,5,2,30,32,4833,05:00 - 06:59
summer,2011-06-07,6,10,116,126,4833,05:00 - 06:59
summer,2011-06-07,7,23,311,334,4833,07:00 - 08:59
summer,2011-06-07,8,45,432,477,4833,07:00 - 08:59
summer,2011-06-07,9,27,190,217,4833,09:00 - 10:59
summer,2011-06-07,10,37,86,123,4833,09:00 - 10:59
summer,2011-06-07,11,38,113,151,4833,11:00 - 12:59
summer,2011-06-07,12,42,141,183,4833,11:00 - 12:59
summer,2011-06-07,13,55,141,196,4833,13:00 - 14:59
summer,2011-06-07,14,34,112,146,4833,13:00 - 14:59
summer,2011-06-07,15,56,127,183,4833,15:00 - 16:59
summer,2011-06-07,16,55,253,308,4833,15:00 - 16:59
summer,2011-06-07,17,64,475,539,4833,17:00 - 18:59
summer,2011-06-07,18,72,479,551,4833,17:00 - 18:59
summer,2011-06-07,19,69,355,424,4833,19:00 - 20:59
summer,2011-06-07,20,45,301,346,4833,19:00 - 20:59
summer,2011-06-07,21,31,187,218,4833,21:00 - 22:59
summer,2011-06-07,22,27,126,153,4833,21:00 - 22:59
summer,2011-06-07,23,18,72,90,4833,23:00 - 24:59
summer,2011-06-08,0,12,29,41,4401,
summer,2011-06-08,1,3,20,23,4401,01:00 - 02:59
summer,2011-06-08,2,0,7,7,4401,01:00 - 02:59
summer,2011-06-08,3,2,1,3,4401,03:00 - 04:59
summer,2011-06-08,4,0,6,6,4401,03:00 - 04:59
summer,2011-06-08,5,0,21,21,4401,05:00 - 06:59
summer,2011-06-08,6,13,103,116,4401,05:00 - 06:59
summer,2011-06-08,7,24,329,353,4401,07:00 - 08:59
summer,2011-06-08,8,46,435,481,4401,07:00 - 08:59
summer,2011-06-08,9,34,168,202,4401,09:00 - 10:59
summer,2011-06-08,10,27,63,90,4401,09:00 - 10:59
summer,2011-06-08,11,28,106,134,4401,11:00 - 12:59
summer,2011-06-08,12,15,134,149,4401,11:00 - 12:59
summer,2011-06-08,13,20,116,136,4401,13:00 - 14:59
summer,2011-06-08,14,44,111,155,4401,13:00 - 14:59
summer,2011-06-08,15,28,100,128,4401,15:00 - 16:59
summer,2011-06-08,16,34,199,233,4401,15:00 - 16:59
summer,2011-06-08,17,80,426,506,4401,17:00 - 18:59
summer,2011-06-08,18,61,398,459,4401,17:00 - 18:59
summer,2011-06-08,19,61,323,384,4401,19:00 - 20:59
summer,2011-06-08,20,55,225,280,4401,19:00 - 20:59
summer,2011-06-08,21,34,168,202,4401,21:00 - 22:59
summer,2011-06-08,22,37,139,176,4401,21:00 - 22:59
summer,2011-06-08,23,18,98,116,4401,23:00 - 24:59
summer,2011-06-09,0,7,40,47,3915,
summer,2011-06-09,1,3,13,16,3915,01:00 - 02:59
summer,2011-06-09,2,0,6,6,3915,01:00 - 02:59
summer,2011-06-09,3,0,2,2,3915,03:00 - 04:59
summer,2011-06-09,4,2,4,6,3915,03:00 - 04:59
summer,2011-06-09,5,1,19,20,3915,05:00 - 06:59
summer,2011-06-09,6,13,105,118,3915,05:00 - 06:59
summer,2011-06-09,7,31,283,314,3915,07:00 - 08:59
summer,2011-06-09,8,32,400,432,3915,07:00 - 08:59
summer,2011-06-09,9,20,148,168,3915,09:00 - 10:59
summer,2011-06-09,10,20,74,94,3915,09:00 - 10:59
summer,2011-06-09,11,36,82,118,3915,11:00 - 12:59
summer,2011-06-09,12,40,100,140,3915,11:00 - 12:59
summer,2011-06-09,13,18,118,136,3915,13:00 - 14:59
summer,2011-06-09,14,25,93,118,3915,13:00 - 14:59
summer,2011-06-09,15,18,86,104,3915,15:00 - 16:59
summer,2011-06-09,16,30,170,200,3915,15:00 - 16:59
summer,2011-06-09,17,54,355,409,3915,17:00 - 18:59
summer,2011-06-09,18,52,414,466,3915,17:00 - 18:59
summer,2011-06-09,19,55,271,326,3915,19:00 - 20:59
summer,2011-06-09,20,40,214,254,3915,19:00 - 20:59
summer,2011-06-09,21,29,142,171,3915,21:00 - 22:59
summer,2011-06-09,22,22,131,153,3915,21:00 - 22:59
summer,2011-06-09,23,15,82,97,3915,23:00 - 24:59
summer,2011-06-10,0,8,61,69,4586,
summer,2011-06-10,1,5,18,23,4586,01:00 - 02:59
summer,2011-06-10,2,6,7,13,4586,01:00 - 02:59
summer,2011-06-10,3,3,3,6,4586,03:00 - 04:59
summer,2011-06-10,4,0,4,4,4586,03:00 - 04:59
summer,2011-06-10,5,0,28,28,4586,05:00 - 06:59
summer,2011-06-10,6,10,94,104,4586,05:00 - 06:59
summer,2011-06-10,7,25,242,267,4586,07:00 - 08:59
summer,2011-06-10,8,29,423,452,4586,07:00 - 08:59
summer,2011-06-10,9,37,176,213,4586,09:00 - 10:59
summer,2011-06-10,10,23,88,111,4586,09:00 - 10:59
summer,2011-06-10,11,46,107,153,4586,11:00 - 12:59
summer,2011-06-10,12,40,167,207,4586,11:00 - 12:59
summer,2011-06-10,13,40,149,189,4586,13:00 - 14:59
summer,2011-06-10,14,44,121,165,4586,13:00 - 14:59
summer,2011-06-10,15,49,163,212,4586,15:00 - 16:59
summer,2011-06-10,16,46,239,285,4586,15:00 - 16:59
summer,2011-06-10,17,63,454,517,4586,17:00 - 18:59
summer,2011-06-10,18,96,367,463,4586,17:00 - 18:59
summer,2011-06-10,19,61,245,306,4586,19:00 - 20:59
summer,2011-06-10,20,53,197,250,4586,19:00 - 20:59
summer,2011-06-10,21,55,163,218,4586,21:00 - 22:59
summer,2011-06-10,22,40,145,185,4586,21:00 - 22:59
summer,2011-06-10,23,36,110,146,4586,23:00 - 24:59
summer,2011-06-11,0,28,89,117,4966,
summer,2011-06-11,1,10,67,77,4966,01:00 - 02:59
summer,2011-06-11,2,10,50,60,4966,01:00 - 02:59
summer,2011-06-11,3,10,18,28,4966,03:00 - 04:59
summer,2011-06-11,4,4,9,13,4966,03:00 - 04:59
summer,2011-06-11,5,4,12,16,4966,05:00 - 06:59
summer,2011-06-11,6,9,31,40,4966,05:00 - 06:59
summer,2011-06-11,7,18,50,68,4966,07:00 - 08:59
summer,2011-06-11,8,32,111,143,4966,07:00 - 08:59
summer,2011-06-11,9,59,171,230,4966,09:00 - 10:59
summer,2011-06-11,10,91,173,264,4966,09:00 - 10:59
summer,2011-06-11,11,110,215,325,4966,11:00 - 12:59
summer,2011-06-11,12,112,235,347,4966,11:00 - 12:59
summer,2011-06-11,13,150,237,387,4966,13:00 - 14:59
summer,2011-06-11,14,148,232,380,4966,13:00 - 14:59
summer,2011-06-11,15,142,232,374,4966,15:00 - 16:59
summer,2011-06-11,16,169,225,394,4966,15:00 - 16:59
summer,2011-06-11,17,147,190,337,4966,17:00 - 18:59
summer,2011-06-11,18,131,155,286,4966,17:00 - 18:59
summer,2011-06-11,19,97,167,264,4966,19:00 - 20:59
summer,2011-06-11,20,95,180,275,4966,19:00 - 20:59
summer,2011-06-11,21,76,144,220,4966,21:00 - 22:59
summer,2011-06-11,22,53,137,190,4966,21:00 - 22:59
summer,2011-06-11,23,24,107,131,4966,23:00 - 24:59
summer,2011-06-12,0,19,100,119,4460,
summer,2011-06-12,1,19,74,93,4460,01:00 - 02:59
summer,2011-06-12,2,9,57,66,4460,01:00 - 02:59
summer,2011-06-12,3,8,20,28,4460,03:00 - 04:59
summer,2011-06-12,4,8,6,14,4460,03:00 - 04:59
summer,2011-06-12,5,5,5,10,4460,05:00 - 06:59
summer,2011-06-12,6,5,9,14,4460,05:00 - 06:59
summer,2011-06-12,7,7,27,34,4460,07:00 - 08:59
summer,2011-06-12,8,28,64,92,4460,07:00 - 08:59
summer,2011-06-12,9,75,107,182,4460,09:00 - 10:59
summer,2011-06-12,10,120,191,311,4460,09:00 - 10:59
summer,2011-06-12,11,131,236,367,4460,11:00 - 12:59
summer,2011-06-12,12,176,244,420,4460,11:00 - 12:59
summer,2011-06-12,13,109,264,373,4460,13:00 - 14:59
summer,2011-06-12,14,96,219,315,4460,13:00 - 14:59
summer,2011-06-12,15,142,218,360,4460,15:00 - 16:59
summer,2011-06-12,16,115,235,350,4460,15:00 - 16:59
summer,2011-06-12,17,94,158,252,4460,17:00 - 18:59
summer,2011-06-12,18,69,187,256,4460,17:00 - 18:59
summer,2011-06-12,19,67,156,223,4460,19:00 - 20:59
summer,2011-06-12,20,62,144,206,4460,19:00 - 20:59
summer,2011-06-12,21,39,101,140,4460,21:00 - 22:59
summer,2011-06-12,22,31,97,128,4460,21:00 - 22:59
summer,2011-06-12,23,33,74,107,4460,23:00 - 24:59
summer,2011-06-13,0,8,20,28,5020,
summer,2011-06-13,1,6,10,16,5020,01:00 - 02:59
summer,2011-06-13,2,2,8,10,5020,01:00 - 02:59
summer,2011-06-13,3,1,6,7,5020,03:00 - 04:59
summer,2011-06-13,4,1,3,4,5020,03:00 - 04:59
summer,2011-06-13,5,2,27,29,5020,05:00 - 06:59
summer,2011-06-13,6,7,98,105,5020,05:00 - 06:59
summer,2011-06-13,7,26,302,328,5020,07:00 - 08:59
summer,2011-06-13,8,44,432,476,5020,07:00 - 08:59
summer,2011-06-13,9,35,189,224,5020,09:00 - 10:59
summer,2011-06-13,10,38,80,118,5020,09:00 - 10:59
summer,2011-06-13,11,53,106,159,5020,11:00 - 12:59
summer,2011-06-13,12,35,161,196,5020,11:00 - 12:59
summer,2011-06-13,13,53,174,227,5020,13:00 - 14:59
summer,2011-06-13,14,55,145,200,5020,13:00 - 14:59
summer,2011-06-13,15,58,127,185,5020,15:00 - 16:59
summer,2011-06-13,16,64,262,326,5020,15:00 - 16:59
summer,2011-06-13,17,72,529,601,5020,17:00 - 18:59
summer,2011-06-13,18,76,510,586,5020,17:00 - 18:59
summer,2011-06-13,19,75,348,423,5020,19:00 - 20:59
summer,2011-06-13,20,78,253,331,5020,19:00 - 20:59
summer,2011-06-13,21,40,178,218,5020,21:00 - 22:59
summer,2011-06-13,22,20,114,134,5020,21:00 - 22:59
summer,2011-06-13,23,14,75,89,5020,23:00 - 24:59
summer,2011-06-14,0,13,18,31,4891,
summer,2011-06-14,1,3,10,13,4891,01:00 - 02:59
summer,2011-06-14,2,2,8,10,4891,01:00 - 02:59
summer,2011-06-14,3,1,1,2,4891,03:00 - 04:59
summer,2011-06-14,4,0,3,3,4891,03:00 - 04:59
summer,2011-06-14,5,3,23,26,4891,05:00 - 06:59
summer,2011-06-14,6,6,107,113,4891,05:00 - 06:59
summer,2011-06-14,7,19,346,365,4891,07:00 - 08:59
summer,2011-06-14,8,45,441,486,4891,07:00 - 08:59
summer,2011-06-14,9,19,174,193,4891,09:00 - 10:59
summer,2011-06-14,10,33,97,130,4891,09:00 - 10:59
summer,2011-06-14,11,40,103,143,4891,11:00 - 12:59
summer,2011-06-14,12,30,139,169,4891,11:00 - 12:59
summer,2011-06-14,13,33,176,209,4891,13:00 - 14:59
summer,2011-06-14,14,41,118,159,4891,13:00 - 14:59
summer,2011-06-14,15,42,136,178,4891,15:00 - 16:59
summer,2011-06-14,16,51,279,330,4891,15:00 - 16:59
summer,2011-06-14,17,85,484,569,4891,17:00 - 18:59
summer,2011-06-14,18,65,473,538,4891,17:00 - 18:59
summer,2011-06-14,19,51,335,386,4891,19:00 - 20:59
summer,2011-06-14,20,60,237,297,4891,19:00 - 20:59
summer,2011-06-14,21,37,206,243,4891,21:00 - 22:59
summer,2011-06-14,22,29,159,188,4891,21:00 - 22:59
summer,2011-06-14,23,19,91,110,4891,23:00 - 24:59
summer,2011-06-15,0,8,44,52,5180,
summer,2011-06-15,1,0,14,14,5180,01:00 - 02:59
summer,2011-06-15,2,0,9,9,5180,01:00 - 02:59
summer,2011-06-15,3,0,1,1,5180,03:00 - 04:59
summer,2011-06-15,4,0,4,4,5180,03:00 - 04:59
summer,2011-06-15,5,1,20,21,5180,05:00 - 06:59
summer,2011-06-15,6,11,110,121,5180,05:00 - 06:59
summer,2011-06-15,7,22,348,370,5180,07:00 - 08:59
summer,2011-06-15,8,53,445,498,5180,07:00 - 08:59
summer,2011-06-15,9,22,185,207,5180,09:00 - 10:59
summer,2011-06-15,10,27,108,135,5180,09:00 - 10:59
summer,2011-06-15,11,49,115,164,5180,11:00 - 12:59
summer,2011-06-15,12,33,178,211,5180,11:00 - 12:59
summer,2011-06-15,13,43,146,189,5180,13:00 - 14:59
summer,2011-06-15,14,50,128,178,5180,13:00 - 14:59
summer,2011-06-15,15,33,131,164,5180,15:00 - 16:59
summer,2011-06-15,16,47,265,312,5180,15:00 - 16:59
summer,2011-06-15,17,83,555,638,5180,17:00 - 18:59
summer,2011-06-15,18,80,527,607,5180,17:00 - 18:59
summer,2011-06-15,19,54,362,416,5180,19:00 - 20:59
summer,2011-06-15,20,57,273,330,5180,19:00 - 20:59
summer,2011-06-15,21,48,209,257,5180,21:00 - 22:59
summer,2011-06-15,22,31,144,175,5180,21:00 - 22:59
summer,2011-06-15,23,17,90,107,5180,23:00 - 24:59
summer,2011-06-16,0,9,38,47,3767,
summer,2011-06-16,1,4,13,17,3767,01:00 - 02:59
summer,2011-06-16,2,1,4,5,3767,01:00 - 02:59
summer,2011-06-16,3,0,4,4,3767,03:00 - 04:59
summer,2011-06-16,4,0,6,6,3767,03:00 - 04:59
summer,2011-06-16,5,7,18,25,3767,05:00 - 06:59
summer,2011-06-16,6,8,104,112,3767,05:00 - 06:59
summer,2011-06-16,7,16,172,188,3767,07:00 - 08:59
summer,2011-06-16,8,24,364,388,3767,07:00 - 08:59
summer,2011-06-16,9,29,232,261,3767,09:00 - 10:59
summer,2011-06-16,10,18,103,121,3767,09:00 - 10:59
summer,2011-06-16,11,33,117,150,3767,11:00 - 12:59
summer,2011-06-16,12,41,165,206,3767,11:00 - 12:59
summer,2011-06-16,13,37,114,151,3767,13:00 - 14:59
summer,2011-06-16,14,39,114,153,3767,13:00 - 14:59
summer,2011-06-16,15,32,127,159,3767,15:00 - 16:59
summer,2011-06-16,16,36,258,294,3767,15:00 - 16:59
summer,2011-06-16,17,42,230,272,3767,17:00 - 18:59
summer,2011-06-16,18,26,299,325,3767,17:00 - 18:59
summer,2011-06-16,19,58,269,327,3767,19:00 - 20:59
summer,2011-06-16,20,25,176,201,3767,19:00 - 20:59
summer,2011-06-16,21,34,154,188,3767,21:00 - 22:59
summer,2011-06-16,22,24,127,151,3767,21:00 - 22:59
summer,2011-06-16,23,2,14,16,3767,23:00 - 24:59
summer,2011-06-17,0,3,21,24,4844,
summer,2011-06-17,1,4,19,23,4844,01:00 - 02:59
summer,2011-06-17,2,2,11,13,4844,01:00 - 02:59
summer,2011-06-17,3,1,5,6,4844,03:00 - 04:59
summer,2011-06-17,4,1,5,6,4844,03:00 - 04:59
summer,2011-06-17,5,1,12,13,4844,05:00 - 06:59
summer,2011-06-17,6,8,89,97,4844,05:00 - 06:59
summer,2011-06-17,7,25,225,250,4844,07:00 - 08:59
summer,2011-06-17,8,28,426,454,4844,07:00 - 08:59
summer,2011-06-17,9,28,196,224,4844,09:00 - 10:59
summer,2011-06-17,10,44,126,170,4844,09:00 - 10:59
summer,2011-06-17,11,43,138,181,4844,11:00 - 12:59
summer,2011-06-17,12,49,194,243,4844,11:00 - 12:59
summer,2011-06-17,13,48,156,204,4844,13:00 - 14:59
summer,2011-06-17,14,73,142,215,4844,13:00 - 14:59
summer,2011-06-17,15,62,181,243,4844,15:00 - 16:59
summer,2011-06-17,16,69,286,355,4844,15:00 - 16:59
summer,2011-06-17,17,85,467,552,4844,17:00 - 18:59
summer,2011-06-17,18,62,388,450,4844,17:00 - 18:59
summer,2011-06-17,19,53,275,328,4844,19:00 - 20:59
summer,2011-06-17,20,40,192,232,4844,19:00 - 20:59
summer,2011-06-17,21,49,159,208,4844,21:00 - 22:59
summer,2011-06-17,22,48,127,175,4844,21:00 - 22:59
summer,2011-06-17,23,37,141,178,4844,23:00 - 24:59
summer,2011-06-18,0,21,83,104,5119,
summer,2011-06-18,1,15,80,95,5119,01:00 - 02:59
summer,2011-06-18,2,16,37,53,5119,01:00 - 02:59
summer,2011-06-18,3,4,16,20,5119,03:00 - 04:59
summer,2011-06-18,4,1,4,5,5119,03:00 - 04:59
summer,2011-06-18,5,1,6,7,5119,05:00 - 06:59
summer,2011-06-18,6,9,18,27,5119,05:00 - 06:59
summer,2011-06-18,7,12,45,57,5119,07:00 - 08:59
summer,2011-06-18,8,28,103,131,5119,07:00 - 08:59
summer,2011-06-18,9,62,156,218,5119,09:00 - 10:59
summer,2011-06-18,10,68,176,244,5119,09:00 - 10:59
summer,2011-06-18,11,134,270,404,5119,11:00 - 12:59
summer,2011-06-18,12,162,258,420,5119,11:00 - 12:59
summer,2011-06-18,13,135,192,327,5119,13:00 - 14:59
summer,2011-06-18,14,138,196,334,5119,13:00 - 14:59
summer,2011-06-18,15,153,214,367,5119,15:00 - 16:59
summer,2011-06-18,16,193,275,468,5119,15:00 - 16:59
summer,2011-06-18,17,210,239,449,5119,17:00 - 18:59
summer,2011-06-18,18,118,263,381,5119,17:00 - 18:59
summer,2011-06-18,19,99,227,326,5119,19:00 - 20:59
summer,2011-06-18,20,61,127,188,5119,19:00 - 20:59
summer,2011-06-18,21,58,125,183,5119,21:00 - 22:59
summer,2011-06-18,22,56,105,161,5119,21:00 - 22:59
summer,2011-06-18,23,53,97,150,5119,23:00 - 24:59
summer,2011-06-19,0,18,71,89,4744,
summer,2011-06-19,1,17,59,76,4744,01:00 - 02:59
summer,2011-06-19,2,13,59,72,4744,01:00 - 02:59
summer,2011-06-19,3,14,16,30,4744,03:00 - 04:59
summer,2011-06-19,4,7,10,17,4744,03:00 - 04:59
summer,2011-06-19,5,7,12,19,4744,05:00 - 06:59
summer,2011-06-19,6,11,22,33,4744,05:00 - 06:59
summer,2011-06-19,7,35,36,71,4744,07:00 - 08:59
summer,2011-06-19,8,25,59,84,4744,07:00 - 08:59
summer,2011-06-19,9,58,111,169,4744,09:00 - 10:59
summer,2011-06-19,10,86,158,244,4744,09:00 - 10:59
summer,2011-06-19,11,141,236,377,4744,11:00 - 12:59
summer,2011-06-19,12,141,255,396,4744,11:00 - 12:59
summer,2011-06-19,13,149,214,363,4744,13:00 - 14:59
summer,2011-06-19,14,124,193,317,4744,13:00 - 14:59
summer,2011-06-19,15,146,216,362,4744,15:00 - 16:59
summer,2011-06-19,16,121,257,378,4744,15:00 - 16:59
summer,2011-06-19,17,159,238,397,4744,17:00 - 18:59
summer,2011-06-19,18,78,218,296,4744,17:00 - 18:59
summer,2011-06-19,19,94,217,311,4744,19:00 - 20:59
summer,2011-06-19,20,86,146,232,4744,19:00 - 20:59
summer,2011-06-19,21,57,110,167,4744,21:00 - 22:59
summer,2011-06-19,22,38,114,152,4744,21:00 - 22:59
summer,2011-06-19,23,14,78,92,4744,23:00 - 24:59
summer,2011-06-20,0,7,19,26,4010,
summer,2011-06-20,1,9,3,12,4010,01:00 - 02:59
summer,2011-06-20,2,2,0,2,4010,01:00 - 02:59
summer,2011-06-20,3,1,0,1,4010,03:00 - 04:59
summer,2011-06-20,4,1,2,3,4010,03:00 - 04:59
summer,2011-06-20,5,0,3,3,4010,05:00 - 06:59
summer,2011-06-20,6,1,25,26,4010,05:00 - 06:59
summer,2011-06-20,7,0,46,46,4010,07:00 - 08:59
summer,2011-06-20,8,12,209,221,4010,07:00 - 08:59
summer,2011-06-20,9,19,200,219,4010,09:00 - 10:59
summer,2011-06-20,10,33,58,91,4010,09:00 - 10:59
summer,2011-06-20,11,27,67,94,4010,11:00 - 12:59
summer,2011-06-20,12,33,129,162,4010,11:00 - 12:59
summer,2011-06-20,13,50,129,179,4010,13:00 - 14:59
summer,2011-06-20,14,45,130,175,4010,13:00 - 14:59
summer,2011-06-20,15,66,139,205,4010,15:00 - 16:59
summer,2011-06-20,16,61,238,299,4010,15:00 - 16:59
summer,2011-06-20,17,81,484,565,4010,17:00 - 18:59
summer,2011-06-20,18,64,474,538,4010,17:00 - 18:59
summer,2011-06-20,19,62,369,431,4010,19:00 - 20:59
summer,2011-06-20,20,52,264,316,4010,19:00 - 20:59
summer,2011-06-20,21,39,167,206,4010,21:00 - 22:59
summer,2011-06-20,22,24,106,130,4010,21:00 - 22:59
summer,2011-06-20,23,10,50,60,4010,23:00 - 24:59
fall,2011-06-21,0,10,23,33,4835,
fall,2011-06-21,1,2,12,14,4835,01:00 - 02:59
fall,2011-06-21,2,1,5,6,4835,01:00 - 02:59
fall,2011-06-21,3,0,2,2,4835,03:00 - 04:59
fall,2011-06-21,4,2,7,9,4835,03:00 - 04:59
fall,2011-06-21,5,3,22,25,4835,05:00 - 06:59
fall,2011-06-21,6,8,107,115,4835,05:00 - 06:59
fall,2011-06-21,7,21,288,309,4835,07:00 - 08:59
fall,2011-06-21,8,33,368,401,4835,07:00 - 08:59
fall,2011-06-21,9,32,243,275,4835,09:00 - 10:59
fall,2011-06-21,10,41,120,161,4835,09:00 - 10:59
fall,2011-06-21,11,52,119,171,4835,11:00 - 12:59
fall,2011-06-21,12,40,149,189,4835,11:00 - 12:59
fall,2011-06-21,13,49,158,207,4835,13:00 - 14:59
fall,2011-06-21,14,44,108,152,4835,13:00 - 14:59
fall,2011-06-21,15,42,128,170,4835,15:00 - 16:59
fall,2011-06-21,16,62,273,335,4835,15:00 - 16:59
fall,2011-06-21,17,65,507,572,4835,17:00 - 18:59
fall,2011-06-21,18,67,469,536,4835,17:00 - 18:59
fall,2011-06-21,19,67,358,425,4835,19:00 - 20:59
fall,2011-06-21,20,72,254,326,4835,19:00 - 20:59
fall,2011-06-21,21,38,191,229,4835,21:00 - 22:59
fall,2011-06-21,22,12,97,109,4835,21:00 - 22:59
fall,2011-06-21,23,11,53,64,4835,23:00 - 24:59
fall,2011-06-22,0,15,18,33,4507,
fall,2011-06-22,1,2,19,21,4507,01:00 - 02:59
fall,2011-06-22,2,2,5,7,4507,01:00 - 02:59
fall,2011-06-22,3,0,7,7,4507,03:00 - 04:59
fall,2011-06-22,4,3,8,11,4507,03:00 - 04:59
fall,2011-06-22,5,2,21,23,4507,05:00 - 06:59
fall,2011-06-22,6,12,110,122,4507,05:00 - 06:59
fall,2011-06-22,7,23,288,311,4507,07:00 - 08:59
fall,2011-06-22,8,27,396,423,4507,07:00 - 08:59
fall,2011-06-22,9,14,205,219,4507,09:00 - 10:59
fall,2011-06-22,10,31,104,135,4507,09:00 - 10:59
fall,2011-06-22,11,37,108,145,4507,11:00 - 12:59
fall,2011-06-22,12,44,144,188,4507,11:00 - 12:59
fall,2011-06-22,13,34,113,147,4507,13:00 - 14:59
fall,2011-06-22,14,32,113,145,4507,13:00 - 14:59
fall,2011-06-22,15,32,114,146,4507,15:00 - 16:59
fall,2011-06-22,16,34,224,258,4507,15:00 - 16:59
fall,2011-06-22,17,67,462,529,4507,17:00 - 18:59
fall,2011-06-22,18,66,447,513,4507,17:00 - 18:59
fall,2011-06-22,19,62,280,342,4507,19:00 - 20:59
fall,2011-06-22,20,52,230,282,4507,19:00 - 20:59
fall,2011-06-22,21,31,216,247,4507,21:00 - 22:59
fall,2011-06-22,22,25,123,148,4507,21:00 - 22:59
fall,2011-06-22,23,14,91,105,4507,23:00 - 24:59
fall,2011-06-23,0,5,44,49,4790,
fall,2011-06-23,1,5,26,31,4790,01:00 - 02:59
fall,2011-06-23,2,0,4,4,4790,01:00 - 02:59
fall,2011-06-23,3,1,4,5,4790,03:00 - 04:59
fall,2011-06-23,4,0,7,7,4790,03:00 - 04:59
fall,2011-06-23,5,2,22,24,4790,05:00 - 06:59
fall,2011-06-23,6,8,92,100,4790,05:00 - 06:59
fall,2011-06-23,7,26,301,327,4790,07:00 - 08:59
fall,2011-06-23,8,20,412,432,4790,07:00 - 08:59
fall,2011-06-23,9,33,194,227,4790,09:00 - 10:59
fall,2011-06-23,10,39,88,127,4790,09:00 - 10:59
fall,2011-06-23,11,28,108,136,4790,11:00 - 12:59
fall,2011-06-23,12,30,130,160,4790,11:00 - 12:59
fall,2011-06-23,13,37,149,186,4790,13:00 - 14:59
fall,2011-06-23,14,46,103,149,4790,13:00 - 14:59
fall,2011-06-23,15,62,127,189,4790,15:00 - 16:59
fall,2011-06-23,16,58,217,275,4790,15:00 - 16:59
fall,2011-06-23,17,74,495,569,4790,17:00 - 18:59
fall,2011-06-23,18,57,483,540,4790,17:00 - 18:59
fall,2011-06-23,19,56,344,400,4790,19:00 - 20:59
fall,2011-06-23,20,75,277,352,4790,19:00 - 20:59
fall,2011-06-23,21,46,188,234,4790,21:00 - 22:59
fall,2011-06-23,22,23,139,162,4790,21:00 - 22:59
fall,2011-06-23,23,15,90,105,4790,23:00 - 24:59
fall,2011-06-24,0,10,53,63,4991,
fall,2011-06-24,1,8,20,28,4991,01:00 - 02:59
fall,2011-06-24,2,4,10,14,4991,01:00 - 02:59
fall,2011-06-24,3,1,4,5,4991,03:00 - 04:59
fall,2011-06-24,4,1,8,9,4991,03:00 - 04:59
fall,2011-06-24,5,2,18,20,4991,05:00 - 06:59
fall,2011-06-24,6,4,87,91,4991,05:00 - 06:59
fall,2011-06-24,7,21,247,268,4991,07:00 - 08:59
fall,2011-06-24,8,27,439,466,4991,07:00 - 08:59
fall,2011-06-24,9,28,203,231,4991,09:00 - 10:59
fall,2011-06-24,10,43,102,145,4991,09:00 - 10:59
fall,2011-06-24,11,56,147,203,4991,11:00 - 12:59
fall,2011-06-24,12,51,150,201,4991,11:00 - 12:59
fall,2011-06-24,13,43,178,221,4991,13:00 - 14:59
fall,2011-06-24,14,67,162,229,4991,13:00 - 14:59
fall,2011-06-24,15,69,147,216,4991,15:00 - 16:59
fall,2011-06-24,16,80,247,327,4991,15:00 - 16:59
fall,2011-06-24,17,85,472,557,4991,17:00 - 18:59
fall,2011-06-24,18,87,365,452,4991,17:00 - 18:59
fall,2011-06-24,19,92,293,385,4991,19:00 - 20:59
fall,2011-06-24,20,66,222,288,4991,19:00 - 20:59
fall,2011-06-24,21,50,183,233,4991,21:00 - 22:59
fall,2011-06-24,22,41,126,167,4991,21:00 - 22:59
fall,2011-06-24,23,33,139,172,4991,23:00 - 24:59
fall,2011-06-25,0,19,97,116,5202,
fall,2011-06-25,1,20,75,95,5202,01:00 - 02:59
fall,2011-06-25,2,8,51,59,5202,01:00 - 02:59
fall,2011-06-25,3,18,21,39,5202,03:00 - 04:59
fall,2011-06-25,4,7,4,11,5202,03:00 - 04:59
fall,2011-06-25,5,6,8,14,5202,05:00 - 06:59
fall,2011-06-25,6,12,17,29,5202,05:00 - 06:59
fall,2011-06-25,7,7,35,42,5202,07:00 - 08:59
fall,2011-06-25,8,27,85,112,5202,07:00 - 08:59
fall,2011-06-25,9,47,139,186,5202,09:00 - 10:59
fall,2011-06-25,10,99,203,302,5202,09:00 - 10:59
fall,2011-06-25,11,122,209,331,5202,11:00 - 12:59
fall,2011-06-25,12,140,252,392,5202,11:00 - 12:59
fall,2011-06-25,13,140,231,371,5202,13:00 - 14:59
fall,2011-06-25,14,151,232,383,5202,13:00 - 14:59
fall,2011-06-25,15,157,235,392,5202,15:00 - 16:59
fall,2011-06-25,16,175,235,410,5202,15:00 - 16:59
fall,2011-06-25,17,152,247,399,5202,17:00 - 18:59
fall,2011-06-25,18,108,199,307,5202,17:00 - 18:59
fall,2011-06-25,19,121,254,375,5202,19:00 - 20:59
fall,2011-06-25,20,74,195,269,5202,19:00 - 20:59
fall,2011-06-25,21,62,140,202,5202,21:00 - 22:59
fall,2011-06-25,22,61,126,187,5202,21:00 - 22:59
fall,2011-06-25,23,49,130,179,5202,23:00 - 24:59
fall,2011-06-26,0,30,85,115,5305,
fall,2011-06-26,1,17,73,90,5305,01:00 - 02:59
fall,2011-06-26,2,17,70,87,5305,01:00 - 02:59
fall,2011-06-26,3,12,22,34,5305,03:00 - 04:59
fall,2011-06-26,4,3,8,11,5305,03:00 - 04:59
fall,2011-06-26,5,3,9,12,5305,05:00 - 06:59
fall,2011-06-26,6,7,13,20,5305,05:00 - 06:59
fall,2011-06-26,7,24,27,51,5305,07:00 - 08:59
fall,2011-06-26,8,29,78,107,5305,07:00 - 08:59
fall,2011-06-26,9,75,131,206,5305,09:00 - 10:59
fall,2011-06-26,10,136,196,332,5305,09:00 - 10:59
fall,2011-06-26,11,127,219,346,5305,11:00 - 12:59
fall,2011-06-26,12,175,268,443,5305,11:00 - 12:59
fall,2011-06-26,13,197,245,442,5305,13:00 - 14:59
fall,2011-06-26,14,197,246,443,5305,13:00 - 14:59
fall,2011-06-26,15,174,229,403,5305,15:00 - 16:59
fall,2011-06-26,16,177,278,455,5305,15:00 - 16:59
fall,2011-06-26,17,178,243,421,5305,17:00 - 18:59
fall,2011-06-26,18,117,265,382,5305,17:00 - 18:59
fall,2011-06-26,19,89,228,317,5305,19:00 - 20:59
fall,2011-06-26,20,55,158,213,5305,19:00 - 20:59
fall,2011-06-26,21,48,135,183,5305,21:00 - 22:59
fall,2011-06-26,22,19,95,114,5305,21:00 - 22:59
fall,2011-06-26,23,14,64,78,5305,23:00 - 24:59
fall,2011-06-27,0,7,25,32,4708,
fall,2011-06-27,1,4,11,15,4708,01:00 - 02:59
fall,2011-06-27,2,3,3,6,4708,01:00 - 02:59
fall,2011-06-27,3,0,2,2,4708,03:00 - 04:59
fall,2011-06-27,4,1,8,9,4708,03:00 - 04:59
fall,2011-06-27,5,1,21,22,4708,05:00 - 06:59
fall,2011-06-27,6,4,90,94,4708,05:00 - 06:59
fall,2011-06-27,7,14,247,261,4708,07:00 - 08:59
fall,2011-06-27,8,29,418,447,4708,07:00 - 08:59
fall,2011-06-27,9,37,150,187,4708,09:00 - 10:59
fall,2011-06-27,10,55,95,150,4708,09:00 - 10:59
fall,2011-06-27,11,55,95,150,4708,11:00 - 12:59
fall,2011-06-27,12,40,130,170,4708,11:00 - 12:59
fall,2011-06-27,13,37,127,164,4708,13:00 - 14:59
fall,2011-06-27,14,58,100,158,4708,13:00 - 14:59
fall,2011-06-27,15,76,126,202,4708,15:00 - 16:59
fall,2011-06-27,16,53,222,275,4708,15:00 - 16:59
fall,2011-06-27,17,90,514,604,4708,17:00 - 18:59
fall,2011-06-27,18,79,512,591,4708,17:00 - 18:59
fall,2011-06-27,19,56,340,396,4708,19:00 - 20:59
fall,2011-06-27,20,54,251,305,4708,19:00 - 20:59
fall,2011-06-27,21,52,190,242,4708,21:00 - 22:59
fall,2011-06-27,22,33,112,145,4708,21:00 - 22:59
fall,2011-06-27,23,16,65,81,4708,23:00 - 24:59
fall,2011-06-28,0,5,25,30,4648,
fall,2011-06-28,1,5,8,13,4648,01:00 - 02:59
fall,2011-06-28,2,2,9,11,4648,01:00 - 02:59
fall,2011-06-28,3,0,2,2,4648,03:00 - 04:59
fall,2011-06-28,4,1,7,8,4648,03:00 - 04:59
fall,2011-06-28,5,1,20,21,4648,05:00 - 06:59
fall,2011-06-28,6,7,117,124,4648,05:00 - 06:59
fall,2011-06-28,7,27,320,347,4648,07:00 - 08:59
fall,2011-06-28,8,39,417,456,4648,07:00 - 08:59
fall,2011-06-28,9,38,208,246,4648,09:00 - 10:59
fall,2011-06-28,10,45,112,157,4648,09:00 - 10:59
fall,2011-06-28,11,49,118,167,4648,11:00 - 12:59
fall,2011-06-28,12,41,161,202,4648,11:00 - 12:59
fall,2011-06-28,13,33,156,189,4648,13:00 - 14:59
fall,2011-06-28,14,43,117,160,4648,13:00 - 14:59
fall,2011-06-28,15,39,127,166,4648,15:00 - 16:59
fall,2011-06-28,16,41,220,261,4648,15:00 - 16:59
fall,2011-06-28,17,70,509,579,4648,17:00 - 18:59
fall,2011-06-28,18,68,436,504,4648,17:00 - 18:59
fall,2011-06-28,19,44,255,299,4648,19:00 - 20:59
fall,2011-06-28,20,50,246,296,4648,19:00 - 20:59
fall,2011-06-28,21,31,164,195,4648,21:00 - 22:59
fall,2011-06-28,22,30,104,134,4648,21:00 - 22:59
fall,2011-06-28,23,23,58,81,4648,23:00 - 24:59
fall,2011-06-29,0,11,25,36,5225,
fall,2011-06-29,1,10,18,28,5225,01:00 - 02:59
fall,2011-06-29,2,7,9,16,5225,01:00 - 02:59
fall,2011-06-29,3,2,3,5,5225,03:00 - 04:59
fall,2011-06-29,4,0,5,5,5225,03:00 - 04:59
fall,2011-06-29,5,3,19,22,5225,05:00 - 06:59
fall,2011-06-29,6,12,104,116,5225,05:00 - 06:59
fall,2011-06-29,7,18,318,336,5225,07:00 - 08:59
fall,2011-06-29,8,41,499,540,5225,07:00 - 08:59
fall,2011-06-29,9,32,189,221,5225,09:00 - 10:59
fall,2011-06-29,10,31,95,126,5225,09:00 - 10:59
fall,2011-06-29,11,53,117,170,5225,11:00 - 12:59
fall,2011-06-29,12,55,188,243,5225,11:00 - 12:59
fall,2011-06-29,13,45,186,231,5225,13:00 - 14:59
fall,2011-06-29,14,50,138,188,5225,13:00 - 14:59
fall,2011-06-29,15,43,146,189,5225,15:00 - 16:59
fall,2011-06-29,16,60,268,328,5225,15:00 - 16:59
fall,2011-06-29,17,78,492,570,5225,17:00 - 18:59
fall,2011-06-29,18,78,510,588,5225,17:00 - 18:59
fall,2011-06-29,19,60,341,401,5225,19:00 - 20:59
fall,2011-06-29,20,69,264,333,5225,19:00 - 20:59
fall,2011-06-29,21,26,195,221,5225,21:00 - 22:59
fall,2011-06-29,22,32,151,183,5225,21:00 - 22:59
fall,2011-06-29,23,32,97,129,5225,23:00 - 24:59
fall,2011-06-30,0,15,39,54,5515,
fall,2011-06-30,1,13,19,32,5515,01:00 - 02:59
fall,2011-06-30,2,2,6,8,5515,01:00 - 02:59
fall,2011-06-30,3,2,7,9,5515,03:00 - 04:59
fall,2011-06-30,4,2,4,6,5515,03:00 - 04:59
fall,2011-06-30,5,1,24,25,5515,05:00 - 06:59
fall,2011-06-30,6,4,119,123,5515,05:00 - 06:59
fall,2011-06-30,7,29,291,320,5515,07:00 - 08:59
fall,2011-06-30,8,44,511,555,5515,07:00 - 08:59
fall,2011-06-30,9,33,227,260,5515,09:00 - 10:59
fall,2011-06-30,10,35,97,132,5515,09:00 - 10:59
fall,2011-06-30,11,47,122,169,5515,11:00 - 12:59
fall,2011-06-30,12,50,183,233,5515,11:00 - 12:59
fall,2011-06-30,13,70,162,232,5515,13:00 - 14:59
fall,2011-06-30,14,46,117,163,5515,13:00 - 14:59
fall,2011-06-30,15,64,176,240,5515,15:00 - 16:59
fall,2011-06-30,16,63,260,323,5515,15:00 - 16:59
fall,2011-06-30,17,98,496,594,5515,17:00 - 18:59
fall,2011-06-30,18,114,472,586,5515,17:00 - 18:59
fall,2011-06-30,19,89,366,455,5515,19:00 - 20:59
fall,2011-06-30,20,55,285,340,5515,19:00 - 20:59
fall,2011-06-30,21,81,242,323,5515,21:00 - 22:59
fall,2011-06-30,22,43,164,207,5515,21:00 - 22:59
fall,2011-06-30,23,27,99,126,5515,23:00 - 24:59
fall,2011-07-01,0,20,48,68,5362,
fall,2011-07-01,1,15,16,31,5362,01:00 - 02:59
fall,2011-07-01,2,6,7,13,5362,01:00 - 02:59
fall,2011-07-01,3,5,6,11,5362,03:00 - 04:59
fall,2011-07-01,4,1,5,6,5362,03:00 - 04:59
fall,2011-07-01,5,3,27,30,5362,05:00 - 06:59
fall,2011-07-01,6,11,97,108,5362,05:00 - 06:59
fall,2011-07-01,7,25,218,243,5362,07:00 - 08:59
fall,2011-07-01,8,39,453,492,5362,07:00 - 08:59
fall,2011-07-01,9,58,202,260,5362,09:00 - 10:59
fall,2011-07-01,10,61,109,170,5362,09:00 - 10:59
fall,2011-07-01,11,68,146,214,5362,11:00 - 12:59
fall,2011-07-01,12,83,180,263,5362,11:00 - 12:59
fall,2011-07-01,13,83,209,292,5362,13:00 - 14:59
fall,2011-07-01,14,78,225,303,5362,13:00 - 14:59
fall,2011-07-01,15,82,299,381,5362,15:00 - 16:59
fall,2011-07-01,16,85,342,427,5362,15:00 - 16:59
fall,2011-07-01,17,99,362,461,5362,17:00 - 18:59
fall,2011-07-01,18,98,324,422,5362,17:00 - 18:59
fall,2011-07-01,19,80,238,318,5362,19:00 - 20:59
fall,2011-07-01,20,84,185,269,5362,19:00 - 20:59
fall,2011-07-01,21,69,149,218,5362,21:00 - 22:59
fall,2011-07-01,22,49,173,222,5362,21:00 - 22:59
fall,2011-07-01,23,44,96,140,5362,23:00 - 24:59
fall,2011-07-02,0,31,84,115,5119,
fall,2011-07-02,1,20,58,78,5119,01:00 - 02:59
fall,2011-07-02,2,9,43,52,5119,01:00 - 02:59
fall,2011-07-02,3,5,21,26,5119,03:00 - 04:59
fall,2011-07-02,4,3,8,11,5119,03:00 - 04:59
fall,2011-07-02,5,1,13,14,5119,05:00 - 06:59
fall,2011-07-02,6,11,21,32,5119,05:00 - 06:59
fall,2011-07-02,7,10,35,45,5119,07:00 - 08:59
fall,2011-07-02,8,38,94,132,5119,07:00 - 08:59
fall,2011-07-02,9,55,124,179,5119,09:00 - 10:59
fall,2011-07-02,10,103,168,271,5119,09:00 - 10:59
fall,2011-07-02,11,144,213,357,5119,11:00 - 12:59
fall,2011-07-02,12,142,232,374,5119,11:00 - 12:59
fall,2011-07-02,13,178,226,404,5119,13:00 - 14:59
fall,2011-07-02,14,177,215,392,5119,13:00 - 14:59
fall,2011-07-02,15,168,163,331,5119,15:00 - 16:59
fall,2011-07-02,16,206,192,398,5119,15:00 - 16:59
fall,2011-07-02,17,179,170,349,5119,17:00 - 18:59
fall,2011-07-02,18,193,190,383,5119,17:00 - 18:59
fall,2011-07-02,19,156,149,305,5119,19:00 - 20:59
fall,2011-07-02,20,136,148,284,5119,19:00 - 20:59
fall,2011-07-02,21,95,137,232,5119,21:00 - 22:59
fall,2011-07-02,22,78,123,201,5119,21:00 - 22:59
fall,2011-07-02,23,66,88,154,5119,23:00 - 24:59
fall,2011-07-03,0,47,97,144,4649,
fall,2011-07-03,1,23,55,78,4649,01:00 - 02:59
fall,2011-07-03,2,19,50,69,4649,01:00 - 02:59
fall,2011-07-03,3,8,25,33,4649,03:00 - 04:59
fall,2011-07-03,4,3,2,5,4649,03:00 - 04:59
fall,2011-07-03,5,0,1,1,4649,05:00 - 06:59
fall,2011-07-03,6,0,3,3,4649,05:00 - 06:59
fall,2011-07-03,7,3,22,25,4649,07:00 - 08:59
fall,2011-07-03,8,39,53,92,4649,07:00 - 08:59
fall,2011-07-03,9,82,99,181,4649,09:00 - 10:59
fall,2011-07-03,10,131,133,264,4649,09:00 - 10:59
fall,2011-07-03,11,215,175,390,4649,11:00 - 12:59
fall,2011-07-03,12,198,206,404,4649,11:00 - 12:59
fall,2011-07-03,13,248,173,421,4649,13:00 - 14:59
fall,2011-07-03,14,225,150,375,4649,13:00 - 14:59
fall,2011-07-03,15,194,182,376,4649,15:00 - 16:59
fall,2011-07-03,16,195,219,414,4649,15:00 - 16:59
fall,2011-07-03,17,181,177,358,4649,17:00 - 18:59
fall,2011-07-03,18,74,107,181,4649,17:00 - 18:59
fall,2011-07-03,19,100,83,183,4649,19:00 - 20:59
fall,2011-07-03,20,83,93,176,4649,19:00 - 20:59
fall,2011-07-03,21,75,92,167,4649,21:00 - 22:59
fall,2011-07-03,22,69,93,162,4649,21:00 - 22:59
fall,2011-07-03,23,70,77,147,4649,23:00 - 24:59
fall,2011-07-04,0,63,77,140,6043,
fall,2011-07-04,1,43,76,119,6043,01:00 - 02:59
fall,2011-07-04,2,33,30,63,6043,01:00 - 02:59
fall,2011-07-04,3,13,13,26,6043,03:00 - 04:59
fall,2011-07-04,4,8,4,12,6043,03:00 - 04:59
fall,2011-07-04,5,1,3,4,6043,05:00 - 06:59
fall,2011-07-04,6,5,11,16,6043,05:00 - 06:59
fall,2011-07-04,7,17,19,36,6043,07:00 - 08:59
fall,2011-07-04,8,42,44,86,6043,07:00 - 08:59
fall,2011-07-04,9,142,96,238,6043,09:00 - 10:59
fall,2011-07-04,10,166,114,280,6043,09:00 - 10:59
fall,2011-07-04,11,177,172,349,6043,11:00 - 12:59
fall,2011-07-04,12,237,210,447,6043,11:00 - 12:59
fall,2011-07-04,13,242,181,423,6043,13:00 - 14:59
fall,2011-07-04,14,235,173,408,6043,13:00 - 14:59
fall,2011-07-04,15,224,184,408,6043,15:00 - 16:59
fall,2011-07-04,16,236,216,452,6043,15:00 - 16:59
fall,2011-07-04,17,240,196,436,6043,17:00 - 18:59
fall,2011-07-04,18,222,196,418,6043,17:00 - 18:59
fall,2011-07-04,19,170,205,375,6043,19:00 - 20:59
fall,2011-07-04,20,195,191,386,6043,19:00 - 20:59
fall,2011-07-04,21,195,262,457,6043,21:00 - 22:59
fall,2011-07-04,22,115,211,326,6043,21:00 - 22:59
fall,2011-07-04,23,44,94,138,6043,23:00 - 24:59
fall,2011-07-05,0,19,36,55,4665,
fall,2011-07-05,1,15,24,39,4665,01:00 - 02:59
fall,2011-07-05,2,8,5,13,4665,01:00 - 02:59
fall,2011-07-05,3,1,7,8,4665,03:00 - 04:59
fall,2011-07-05,4,1,4,5,4665,03:00 - 04:59
fall,2011-07-05,5,1,19,20,4665,05:00 - 06:59
fall,2011-07-05,6,3,91,94,4665,05:00 - 06:59
fall,2011-07-05,7,22,248,270,4665,07:00 - 08:59
fall,2011-07-05,8,41,391,432,4665,07:00 - 08:59
fall,2011-07-05,9,50,177,227,4665,09:00 - 10:59
fall,2011-07-05,10,55,84,139,4665,09:00 - 10:59
fall,2011-07-05,11,75,97,172,4665,11:00 - 12:59
fall,2011-07-05,12,71,130,201,4665,11:00 - 12:59
fall,2011-07-05,13,67,136,203,4665,13:00 - 14:59
fall,2011-07-05,14,66,112,178,4665,13:00 - 14:59
fall,2011-07-05,15,51,111,162,4665,15:00 - 16:59
fall,2011-07-05,16,79,202,281,4665,15:00 - 16:59
fall,2011-07-05,17,79,466,545,4665,17:00 - 18:59
fall,2011-07-05,18,70,426,496,4665,17:00 - 18:59
fall,2011-07-05,19,71,297,368,4665,19:00 - 20:59
fall,2011-07-05,20,59,225,284,4665,19:00 - 20:59
fall,2011-07-05,21,77,168,245,4665,21:00 - 22:59
fall,2011-07-05,22,31,124,155,4665,21:00 - 22:59
fall,2011-07-05,23,19,54,73,4665,23:00 - 24:59
fall,2011-07-06,0,11,26,37,4629,
fall,2011-07-06,1,4,11,15,4629,01:00 - 02:59
fall,2011-07-06,2,1,4,5,4629,01:00 - 02:59
fall,2011-07-06,3,0,6,6,4629,03:00 - 04:59
fall,2011-07-06,4,0,6,6,4629,03:00 - 04:59
fall,2011-07-06,5,5,30,35,4629,05:00 - 06:59
fall,2011-07-06,6,9,112,121,4629,05:00 - 06:59
fall,2011-07-06,7,24,288,312,4629,07:00 - 08:59
fall,2011-07-06,8,31,397,428,4629,07:00 - 08:59
fall,2011-07-06,9,31,158,189,4629,09:00 - 10:59
fall,2011-07-06,10,13,30,43,4629,09:00 - 10:59
fall,2011-07-06,11,24,103,127,4629,11:00 - 12:59
fall,2011-07-06,12,38,114,152,4629,11:00 - 12:59
fall,2011-07-06,13,33,107,140,4629,13:00 - 14:59
fall,2011-07-06,14,50,113,163,4629,13:00 - 14:59
fall,2011-07-06,15,55,130,185,4629,15:00 - 16:59
fall,2011-07-06,16,57,218,275,4629,15:00 - 16:59
fall,2011-07-06,17,79,517,596,4629,17:00 - 18:59
fall,2011-07-06,18,77,486,563,4629,17:00 - 18:59
fall,2011-07-06,19,71,323,394,4629,19:00 - 20:59
fall,2011-07-06,20,55,257,312,4629,19:00 - 20:59
fall,2011-07-06,21,66,175,241,4629,21:00 - 22:59
fall,2011-07-06,22,30,156,186,4629,21:00 - 22:59
fall,2011-07-06,23,20,78,98,4629,23:00 - 24:59
fall,2011-07-07,0,6,29,35,4592,
fall,2011-07-07,1,2,14,16,4592,01:00 - 02:59
fall,2011-07-07,2,1,7,8,4592,01:00 - 02:59
fall,2011-07-07,3,2,2,4,4592,03:00 - 04:59
fall,2011-07-07,4,0,4,4,4592,03:00 - 04:59
fall,2011-07-07,5,2,30,32,4592,05:00 - 06:59
fall,2011-07-07,6,11,107,118,4592,05:00 - 06:59
fall,2011-07-07,7,13,279,292,4592,07:00 - 08:59
fall,2011-07-07,8,28,415,443,4592,07:00 - 08:59
fall,2011-07-07,9,25,154,179,4592,09:00 - 10:59
fall,2011-07-07,10,29,72,101,4592,09:00 - 10:59
fall,2011-07-07,11,30,112,142,4592,11:00 - 12:59
fall,2011-07-07,12,32,139,171,4592,11:00 - 12:59
fall,2011-07-07,13,48,107,155,4592,13:00 - 14:59
fall,2011-07-07,14,39,121,160,4592,13:00 - 14:59
fall,2011-07-07,15,47,119,166,4592,15:00 - 16:59
fall,2011-07-07,16,47,218,265,4592,15:00 - 16:59
fall,2011-07-07,17,80,489,569,4592,17:00 - 18:59
fall,2011-07-07,18,70,492,562,4592,17:00 - 18:59
fall,2011-07-07,19,79,286,365,4592,19:00 - 20:59
fall,2011-07-07,20,61,224,285,4592,19:00 - 20:59
fall,2011-07-07,21,39,170,209,4592,21:00 - 22:59
fall,2011-07-07,22,32,150,182,4592,21:00 - 22:59
fall,2011-07-07,23,31,98,129,4592,23:00 - 24:59
fall,2011-07-08,0,6,41,47,4040,
fall,2011-07-08,1,9,25,34,4040,01:00 - 02:59
fall,2011-07-08,2,10,12,22,4040,01:00 - 02:59
fall,2011-07-08,3,2,4,6,4040,03:00 - 04:59
fall,2011-07-08,4,7,4,11,4040,03:00 - 04:59
fall,2011-07-08,5,3,24,27,4040,05:00 - 06:59
fall,2011-07-08,6,11,91,102,4040,05:00 - 06:59
fall,2011-07-08,7,30,302,332,4040,07:00 - 08:59
fall,2011-07-08,8,36,421,457,4040,07:00 - 08:59
fall,2011-07-08,9,30,211,241,4040,09:00 - 10:59
fall,2011-07-08,10,30,108,138,4040,09:00 - 10:59
fall,2011-07-08,11,61,104,165,4040,11:00 - 12:59
fall,2011-07-08,12,49,164,213,4040,11:00 - 12:59
fall,2011-07-08,13,54,175,229,4040,13:00 - 14:59
fall,2011-07-08,14,53,163,216,4040,13:00 - 14:59
fall,2011-07-08,15,39,102,141,4040,15:00 - 16:59
fall,2011-07-08,16,27,105,132,4040,15:00 - 16:59
fall,2011-07-08,17,6,161,167,4040,17:00 - 18:59
fall,2011-07-08,18,35,281,316,4040,17:00 - 18:59
fall,2011-07-08,19,45,225,270,4040,19:00 - 20:59
fall,2011-07-08,20,30,220,250,4040,19:00 - 20:59
fall,2011-07-08,21,46,158,204,4040,21:00 - 22:59
fall,2011-07-08,22,33,136,169,4040,21:00 - 22:59
fall,2011-07-08,23,40,111,151,4040,23:00 - 24:59
fall,2011-07-09,0,31,90,121,5336,
fall,2011-07-09,1,5,48,53,5336,01:00 - 02:59
fall,2011-07-09,2,12,43,55,5336,01:00 - 02:59
fall,2011-07-09,3,7,23,30,5336,03:00 - 04:59
fall,2011-07-09,4,2,4,6,5336,03:00 - 04:59
fall,2011-07-09,5,4,11,15,5336,05:00 - 06:59
fall,2011-07-09,6,11,27,38,5336,05:00 - 06:59
fall,2011-07-09,7,21,50,71,5336,07:00 - 08:59
fall,2011-07-09,8,68,114,182,5336,07:00 - 08:59
fall,2011-07-09,9,77,170,247,5336,09:00 - 10:59
fall,2011-07-09,10,87,177,264,5336,09:00 - 10:59
fall,2011-07-09,11,101,189,290,5336,11:00 - 12:59
fall,2011-07-09,12,145,221,366,5336,11:00 - 12:59
fall,2011-07-09,13,167,249,416,5336,13:00 - 14:59
fall,2011-07-09,14,158,215,373,5336,13:00 - 14:59
fall,2011-07-09,15,182,220,402,5336,15:00 - 16:59
fall,2011-07-09,16,171,245,416,5336,15:00 - 16:59
fall,2011-07-09,17,160,241,401,5336,17:00 - 18:59
fall,2011-07-09,18,132,246,378,5336,17:00 - 18:59
fall,2011-07-09,19,128,178,306,5336,19:00 - 20:59
fall,2011-07-09,20,129,185,314,5336,19:00 - 20:59
fall,2011-07-09,21,83,155,238,5336,21:00 - 22:59
fall,2011-07-09,22,60,154,214,5336,21:00 - 22:59
fall,2011-07-09,23,47,93,140,5336,23:00 - 24:59
fall,2011-07-10,0,42,112,154,4881,
fall,2011-07-10,1,19,94,113,4881,01:00 - 02:59
fall,2011-07-10,2,28,68,96,4881,01:00 - 02:59
fall,2011-07-10,3,6,19,25,4881,03:00 - 04:59
fall,2011-07-10,4,0,5,5,4881,03:00 - 04:59
fall,2011-07-10,5,7,10,17,4881,05:00 - 06:59
fall,2011-07-10,6,8,17,25,4881,05:00 - 06:59
fall,2011-07-10,7,27,38,65,4881,07:00 - 08:59
fall,2011-07-10,8,27,65,92,4881,07:00 - 08:59
fall,2011-07-10,9,62,107,169,4881,09:00 - 10:59
fall,2011-07-10,10,95,173,268,4881,09:00 - 10:59
fall,2011-07-10,11,110,177,287,4881,11:00 - 12:59
fall,2011-07-10,12,133,244,377,4881,11:00 - 12:59
fall,2011-07-10,13,139,228,367,4881,13:00 - 14:59
fall,2011-07-10,14,122,227,349,4881,13:00 - 14:59
fall,2011-07-10,15,142,219,361,4881,15:00 - 16:59
fall,2011-07-10,16,128,244,372,4881,15:00 - 16:59
fall,2011-07-10,17,146,217,363,4881,17:00 - 18:59
fall,2011-07-10,18,141,222,363,4881,17:00 - 18:59
fall,2011-07-10,19,120,183,303,4881,19:00 - 20:59
fall,2011-07-10,20,101,167,268,4881,19:00 - 20:59
fall,2011-07-10,21,65,162,227,4881,21:00 - 22:59
fall,2011-07-10,22,56,87,143,4881,21:00 - 22:59
fall,2011-07-10,23,19,53,72,4881,23:00 - 24:59
fall,2011-07-11,0,10,25,35,4086,
fall,2011-07-11,1,5,5,10,4086,01:00 - 02:59
fall,2011-07-11,2,8,4,12,4086,01:00 - 02:59
fall,2011-07-11,3,2,8,10,4086,03:00 - 04:59
fall,2011-07-11,4,0,4,4,4086,03:00 - 04:59
fall,2011-07-11,5,5,21,26,4086,05:00 - 06:59
fall,2011-07-11,6,19,102,121,4086,05:00 - 06:59
fall,2011-07-11,7,28,289,317,4086,07:00 - 08:59
fall,2011-07-11,8,35,385,420,4086,07:00 - 08:59
fall,2011-07-11,9,41,167,208,4086,09:00 - 10:59
fall,2011-07-11,10,44,73,117,4086,09:00 - 10:59
fall,2011-07-11,11,39,89,128,4086,11:00 - 12:59
fall,2011-07-11,12,40,108,148,4086,11:00 - 12:59
fall,2011-07-11,13,22,119,141,4086,13:00 - 14:59
fall,2011-07-11,14,40,94,134,4086,13:00 - 14:59
fall,2011-07-11,15,38,108,146,4086,15:00 - 16:59
fall,2011-07-11,16,57,182,239,4086,15:00 - 16:59
fall,2011-07-11,17,59,455,514,4086,17:00 - 18:59
fall,2011-07-11,18,57,415,472,4086,17:00 - 18:59
fall,2011-07-11,19,80,293,373,4086,19:00 - 20:59
fall,2011-07-11,20,42,194,236,4086,19:00 - 20:59
fall,2011-07-11,21,21,109,130,4086,21:00 - 22:59
fall,2011-07-11,22,20,70,90,4086,21:00 - 22:59
fall,2011-07-11,23,11,44,55,4086,23:00 - 24:59
fall,2011-07-12,0,3,19,22,4258,
fall,2011-07-12,1,6,8,14,4258,01:00 - 02:59
fall,2011-07-12,2,2,7,9,4258,01:00 - 02:59
fall,2011-07-12,3,2,6,8,4258,03:00 - 04:59
fall,2011-07-12,4,0,6,6,4258,03:00 - 04:59
fall,2011-07-12,5,4,21,25,4258,05:00 - 06:59
fall,2011-07-12,6,13,102,115,4258,05:00 - 06:59
fall,2011-07-12,7,29,301,330,4258,07:00 - 08:59
fall,2011-07-12,8,35,382,417,4258,07:00 - 08:59
fall,2011-07-12,9,27,149,176,4258,09:00 - 10:59
fall,2011-07-12,10,38,85,123,4258,09:00 - 10:59
fall,2011-07-12,11,39,86,125,4258,11:00 - 12:59
fall,2011-07-12,12,38,125,163,4258,11:00 - 12:59
fall,2011-07-12,13,32,104,136,4258,13:00 - 14:59
fall,2011-07-12,14,33,91,124,4258,13:00 - 14:59
fall,2011-07-12,15,37,111,148,4258,15:00 - 16:59
fall,2011-07-12,16,25,177,202,4258,15:00 - 16:59
fall,2011-07-12,17,48,380,428,4258,17:00 - 18:59
fall,2011-07-12,18,39,472,511,4258,17:00 - 18:59
fall,2011-07-12,19,42,295,337,4258,19:00 - 20:59
fall,2011-07-12,20,57,251,308,4258,19:00 - 20:59
fall,2011-07-12,21,49,209,258,4258,21:00 - 22:59
fall,2011-07-12,22,44,150,194,4258,21:00 - 22:59
fall,2011-07-12,23,20,59,79,4258,23:00 - 24:59
fall,2011-07-13,0,9,37,46,4342,
fall,2011-07-13,1,1,11,12,4342,01:00 - 02:59
fall,2011-07-13,2,2,3,5,4342,01:00 - 02:59
fall,2011-07-13,3,0,4,4,4342,03:00 - 04:59
fall,2011-07-13,4,0,5,5,4342,03:00 - 04:59
fall,2011-07-13,5,4,22,26,4342,05:00 - 06:59
fall,2011-07-13,6,18,103,121,4342,05:00 - 06:59
fall,2011-07-13,7,32,281,313,4342,07:00 - 08:59
fall,2011-07-13,8,31,418,449,4342,07:00 - 08:59
fall,2011-07-13,9,23,163,186,4342,09:00 - 10:59
fall,2011-07-13,10,33,80,113,4342,09:00 - 10:59
fall,2011-07-13,11,55,110,165,4342,11:00 - 12:59
fall,2011-07-13,12,40,134,174,4342,11:00 - 12:59
fall,2011-07-13,13,39,119,158,4342,13:00 - 14:59
fall,2011-07-13,14,27,89,116,4342,13:00 - 14:59
fall,2011-07-13,15,13,33,46,4342,15:00 - 16:59
fall,2011-07-13,16,23,118,141,4342,15:00 - 16:59
fall,2011-07-13,17,70,418,488,4342,17:00 - 18:59
fall,2011-07-13,18,51,412,463,4342,17:00 - 18:59
fall,2011-07-13,19,79,340,419,4342,19:00 - 20:59
fall,2011-07-13,20,61,281,342,4342,19:00 - 20:59
fall,2011-07-13,21,56,194,250,4342,21:00 - 22:59
fall,2011-07-13,22,48,136,184,4342,21:00 - 22:59
fall,2011-07-13,23,33,83,116,4342,23:00 - 24:59
fall,2011-07-14,0,14,32,46,5084,
fall,2011-07-14,1,4,21,25,5084,01:00 - 02:59
fall,2011-07-14,2,3,7,10,5084,01:00 - 02:59
fall,2011-07-14,3,1,5,6,5084,03:00 - 04:59
fall,2011-07-14,4,0,6,6,5084,03:00 - 04:59
fall,2011-07-14,5,6,22,28,5084,05:00 - 06:59
fall,2011-07-14,6,14,116,130,5084,05:00 - 06:59
fall,2011-07-14,7,23,311,334,5084,07:00 - 08:59
fall,2011-07-14,8,53,433,486,5084,07:00 - 08:59
fall,2011-07-14,9,29,195,224,5084,09:00 - 10:59
fall,2011-07-14,10,32,95,127,5084,09:00 - 10:59
fall,2011-07-14,11,38,110,148,5084,11:00 - 12:59
fall,2011-07-14,12,51,172,223,5084,11:00 - 12:59
fall,2011-07-14,13,39,138,177,5084,13:00 - 14:59
fall,2011-07-14,14,49,129,178,5084,13:00 - 14:59
fall,2011-07-14,15,42,138,180,5084,15:00 - 16:59
fall,2011-07-14,16,43,231,274,5084,15:00 - 16:59
fall,2011-07-14,17,78,517,595,5084,17:00 - 18:59
fall,2011-07-14,18,94,484,578,5084,17:00 - 18:59
fall,2011-07-14,19,67,333,400,5084,19:00 - 20:59
fall,2011-07-14,20,81,267,348,5084,19:00 - 20:59
fall,2011-07-14,21,58,203,261,5084,21:00 - 22:59
fall,2011-07-14,22,42,134,176,5084,21:00 - 22:59
fall,2011-07-14,23,27,97,124,5084,23:00 - 24:59
fall,2011-07-15,0,23,57,80,5538,
fall,2011-07-15,1,7,13,20,5538,01:00 - 02:59
fall,2011-07-15,2,16,22,38,5538,01:00 - 02:59
fall,2011-07-15,3,1,6,7,5538,03:00 - 04:59
fall,2011-07-15,4,2,8,10,5538,03:00 - 04:59
fall,2011-07-15,5,7,16,23,5538,05:00 - 06:59
fall,2011-07-15,6,12,108,120,5538,05:00 - 06:59
fall,2011-07-15,7,17,257,274,5538,07:00 - 08:59
fall,2011-07-15,8,50,514,564,5538,07:00 - 08:59
fall,2011-07-15,9,31,176,207,5538,09:00 - 10:59
fall,2011-07-15,10,59,107,166,5538,09:00 - 10:59
fall,2011-07-15,11,73,137,210,5538,11:00 - 12:59
fall,2011-07-15,12,61,177,238,5538,11:00 - 12:59
fall,2011-07-15,13,85,162,247,5538,13:00 - 14:59
fall,2011-07-15,14,105,160,265,5538,13:00 - 14:59
fall,2011-07-15,15,74,163,237,5538,15:00 - 16:59
fall,2011-07-15,16,96,265,361,5538,15:00 - 16:59
fall,2011-07-15,17,104,483,587,5538,17:00 - 18:59
fall,2011-07-15,18,102,394,496,5538,17:00 - 18:59
fall,2011-07-15,19,114,280,394,5538,19:00 - 20:59
fall,2011-07-15,20,92,251,343,5538,19:00 - 20:59
fall,2011-07-15,21,75,186,261,5538,21:00 - 22:59
fall,2011-07-15,22,71,152,223,5538,21:00 - 22:59
fall,2011-07-15,23,41,126,167,5538,23:00 - 24:59
fall,2011-07-16,0,42,68,110,5923,
fall,2011-07-16,1,24,51,75,5923,01:00 - 02:59
fall,2011-07-16,2,10,48,58,5923,01:00 - 02:59
fall,2011-07-16,3,6,20,26,5923,03:00 - 04:59
fall,2011-07-16,4,9,7,16,5923,03:00 - 04:59
fall,2011-07-16,5,4,6,10,5923,05:00 - 06:59
fall,2011-07-16,6,16,21,37,5923,05:00 - 06:59
fall,2011-07-16,7,14,38,52,5923,07:00 - 08:59
fall,2011-07-16,8,37,90,127,5923,07:00 - 08:59
fall,2011-07-16,9,72,150,222,5923,09:00 - 10:59
fall,2011-07-16,10,114,208,322,5923,09:00 - 10:59
fall,2011-07-16,11,171,225,396,5923,11:00 - 12:59
fall,2011-07-16,12,187,276,463,5923,11:00 - 12:59
fall,2011-07-16,13,221,276,497,5923,13:00 - 14:59
fall,2011-07-16,14,201,232,433,5923,13:00 - 14:59
fall,2011-07-16,15,205,223,428,5923,15:00 - 16:59
fall,2011-07-16,16,183,242,425,5923,15:00 - 16:59
fall,2011-07-16,17,234,241,475,5923,17:00 - 18:59
fall,2011-07-16,18,185,243,428,5923,17:00 - 18:59
fall,2011-07-16,19,164,242,406,5923,19:00 - 20:59
fall,2011-07-16,20,108,188,296,5923,19:00 - 20:59
fall,2011-07-16,21,85,167,252,5923,21:00 - 22:59
fall,2011-07-16,22,65,136,201,5923,21:00 - 22:59
fall,2011-07-16,23,61,107,168,5923,23:00 - 24:59
fall,2011-07-17,0,34,91,125,5302,
fall,2011-07-17,1,16,86,102,5302,01:00 - 02:59
fall,2011-07-17,2,28,66,94,5302,01:00 - 02:59
fall,2011-07-17,3,21,26,47,5302,03:00 - 04:59
fall,2011-07-17,4,4,6,10,5302,03:00 - 04:59
fall,2011-07-17,5,4,8,12,5302,05:00 - 06:59
fall,2011-07-17,6,10,11,21,5302,05:00 - 06:59
fall,2011-07-17,7,20,30,50,5302,07:00 - 08:59
fall,2011-07-17,8,45,73,118,5302,07:00 - 08:59
fall,2011-07-17,9,74,110,184,5302,09:00 - 10:59
fall,2011-07-17,10,127,177,304,5302,09:00 - 10:59
fall,2011-07-17,11,147,244,391,5302,11:00 - 12:59
fall,2011-07-17,12,177,243,420,5302,11:00 - 12:59
fall,2011-07-17,13,200,272,472,5302,13:00 - 14:59
fall,2011-07-17,14,168,262,430,5302,13:00 - 14:59
fall,2011-07-17,15,129,195,324,5302,15:00 - 16:59
fall,2011-07-17,16,129,188,317,5302,15:00 - 16:59
fall,2011-07-17,17,133,236,369,5302,17:00 - 18:59
fall,2011-07-17,18,147,243,390,5302,17:00 - 18:59
fall,2011-07-17,19,145,234,379,5302,19:00 - 20:59
fall,2011-07-17,20,85,177,262,5302,19:00 - 20:59
fall,2011-07-17,21,59,148,207,5302,21:00 - 22:59
fall,2011-07-17,22,65,116,181,5302,21:00 - 22:59
fall,2011-07-17,23,39,54,93,5302,23:00 - 24:59
fall,2011-07-18,0,21,30,51,4458,
fall,2011-07-18,1,17,8,25,4458,01:00 - 02:59
fall,2011-07-18,2,2,8,10,4458,01:00 - 02:59
fall,2011-07-18,3,3,4,7,4458,03:00 - 04:59
fall,2011-07-18,4,1,3,4,4458,03:00 - 04:59
fall,2011-07-18,5,2,15,17,4458,05:00 - 06:59
fall,2011-07-18,6,10,95,105,4458,05:00 - 06:59
fall,2011-07-18,7,22,255,277,4458,07:00 - 08:59
fall,2011-07-18,8,18,329,347,4458,07:00 - 08:59
fall,2011-07-18,9,33,170,203,4458,09:00 - 10:59
fall,2011-07-18,10,52,78,130,4458,09:00 - 10:59
fall,2011-07-18,11,42,99,141,4458,11:00 - 12:59
fall,2011-07-18,12,39,126,165,4458,11:00 - 12:59
fall,2011-07-18,13,27,125,152,4458,13:00 - 14:59
fall,2011-07-18,14,32,106,138,4458,13:00 - 14:59
fall,2011-07-18,15,53,111,164,4458,15:00 - 16:59
fall,2011-07-18,16,45,220,265,4458,15:00 - 16:59
fall,2011-07-18,17,72,473,545,4458,17:00 - 18:59
fall,2011-07-18,18,80,478,558,4458,17:00 - 18:59
fall,2011-07-18,19,63,335,398,4458,19:00 - 20:59
fall,2011-07-18,20,91,232,323,4458,19:00 - 20:59
fall,2011-07-18,21,48,154,202,4458,21:00 - 22:59
fall,2011-07-18,22,36,104,140,4458,21:00 - 22:59
fall,2011-07-18,23,32,59,91,4458,23:00 - 24:59
fall,2011-07-19,0,25,26,51,4541,
fall,2011-07-19,1,7,6,13,4541,01:00 - 02:59
fall,2011-07-19,2,9,4,13,4541,01:00 - 02:59
fall,2011-07-19,3,2,1,3,4541,03:00 - 04:59
fall,2011-07-19,4,1,4,5,4541,03:00 - 04:59
fall,2011-07-19,5,0,19,19,4541,05:00 - 06:59
fall,2011-07-19,6,8,126,134,4541,05:00 - 06:59
fall,2011-07-19,7,28,287,315,4541,07:00 - 08:59
fall,2011-07-19,8,31,381,412,4541,07:00 - 08:59
fall,2011-07-19,9,22,177,199,4541,09:00 - 10:59
fall,2011-07-19,10,29,112,141,4541,09:00 - 10:59
fall,2011-07-19,11,29,98,127,4541,11:00 - 12:59
fall,2011-07-19,12,26,127,153,4541,11:00 - 12:59
fall,2011-07-19,13,33,139,172,4541,13:00 - 14:59
fall,2011-07-19,14,41,111,152,4541,13:00 - 14:59
fall,2011-07-19,15,48,110,158,4541,15:00 - 16:59
fall,2011-07-19,16,61,216,277,4541,15:00 - 16:59
fall,2011-07-19,17,68,445,513,4541,17:00 - 18:59
fall,2011-07-19,18,80,450,530,4541,17:00 - 18:59
fall,2011-07-19,19,54,334,388,4541,19:00 - 20:59
fall,2011-07-19,20,48,229,277,4541,19:00 - 20:59
fall,2011-07-19,21,47,194,241,4541,21:00 - 22:59
fall,2011-07-19,22,36,120,156,4541,21:00 - 22:59
fall,2011-07-19,23,19,73,92,4541,23:00 - 24:59
fall,2011-07-20,0,11,29,40,4332,
fall,2011-07-20,1,4,7,11,4332,01:00 - 02:59
fall,2011-07-20,2,2,7,9,4332,01:00 - 02:59
fall,2011-07-20,3,2,4,6,4332,03:00 - 04:59
fall,2011-07-20,4,0,4,4,4332,03:00 - 04:59
fall,2011-07-20,5,4,19,23,4332,05:00 - 06:59
fall,2011-07-20,6,5,111,116,4332,05:00 - 06:59
fall,2011-07-20,7,27,276,303,4332,07:00 - 08:59
fall,2011-07-20,8,34,404,438,4332,07:00 - 08:59
fall,2011-07-20,9,28,181,209,4332,09:00 - 10:59
fall,2011-07-20,10,34,76,110,4332,09:00 - 10:59
fall,2011-07-20,11,26,116,142,4332,11:00 - 12:59
fall,2011-07-20,12,28,121,149,4332,11:00 - 12:59
fall,2011-07-20,13,23,97,120,4332,13:00 - 14:59
fall,2011-07-20,14,44,83,127,4332,13:00 - 14:59
fall,2011-07-20,15,36,102,138,4332,15:00 - 16:59
fall,2011-07-20,16,30,204,234,4332,15:00 - 16:59
fall,2011-07-20,17,50,405,455,4332,17:00 - 18:59
fall,2011-07-20,18,68,429,497,4332,17:00 - 18:59
fall,2011-07-20,19,59,323,382,4332,19:00 - 20:59
fall,2011-07-20,20,45,264,309,4332,19:00 - 20:59
fall,2011-07-20,21,33,209,242,4332,21:00 - 22:59
fall,2011-07-20,22,25,144,169,4332,21:00 - 22:59
fall,2011-07-20,23,26,73,99,4332,23:00 - 24:59
fall,2011-07-21,0,13,29,42,3784,
fall,2011-07-21,1,5,16,21,3784,01:00 - 02:59
fall,2011-07-21,2,2,4,6,3784,01:00 - 02:59
fall,2011-07-21,3,1,5,6,3784,03:00 - 04:59
fall,2011-07-21,4,0,4,4,3784,03:00 - 04:59
fall,2011-07-21,5,2,16,18,3784,05:00 - 06:59
fall,2011-07-21,6,6,111,117,3784,05:00 - 06:59
fall,2011-07-21,7,23,251,274,3784,07:00 - 08:59
fall,2011-07-21,8,23,358,381,3784,07:00 - 08:59
fall,2011-07-21,9,34,166,200,3784,09:00 - 10:59
fall,2011-07-21,10,31,47,78,3784,09:00 - 10:59
fall,2011-07-21,11,27,79,106,3784,11:00 - 12:59
fall,2011-07-21,12,29,106,135,3784,11:00 - 12:59
fall,2011-07-21,13,21,81,102,3784,13:00 - 14:59
fall,2011-07-21,14,50,97,147,3784,13:00 - 14:59
fall,2011-07-21,15,40,93,133,3784,15:00 - 16:59
fall,2011-07-21,16,43,167,210,3784,15:00 - 16:59
fall,2011-07-21,17,40,374,414,3784,17:00 - 18:59
fall,2011-07-21,18,39,343,382,3784,17:00 - 18:59
fall,2011-07-21,19,51,233,284,3784,19:00 - 20:59
fall,2011-07-21,20,38,199,237,3784,19:00 - 20:59
fall,2011-07-21,21,38,187,225,3784,21:00 - 22:59
fall,2011-07-21,22,36,113,149,3784,21:00 - 22:59
fall,2011-07-21,23,40,73,113,3784,23:00 - 24:59
fall,2011-07-22,0,9,51,60,3387,
fall,2011-07-22,1,7,17,24,3387,01:00 - 02:59
fall,2011-07-22,2,0,14,14,3387,01:00 - 02:59
fall,2011-07-22,3,1,6,7,3387,03:00 - 04:59
fall,2011-07-22,4,8,5,13,3387,03:00 - 04:59
fall,2011-07-22,5,2,17,19,3387,05:00 - 06:59
fall,2011-07-22,6,13,83,96,3387,05:00 - 06:59
fall,2011-07-22,7,20,232,252,3387,07:00 - 08:59
fall,2011-07-22,8,30,292,322,3387,07:00 - 08:59
fall,2011-07-22,9,31,177,208,3387,09:00 - 10:59
fall,2011-07-22,10,32,83,115,3387,09:00 - 10:59
fall,2011-07-22,11,23,86,109,3387,11:00 - 12:59
fall,2011-07-22,12,20,95,115,3387,11:00 - 12:59
fall,2011-07-22,13,25,98,123,3387,13:00 - 14:59
fall,2011-07-22,14,24,77,101,3387,13:00 - 14:59
fall,2011-07-22,15,32,101,133,3387,15:00 - 16:59
fall,2011-07-22,16,29,153,182,3387,15:00 - 16:59
fall,2011-07-22,17,35,271,306,3387,17:00 - 18:59
fall,2011-07-22,18,34,250,284,3387,17:00 - 18:59
fall,2011-07-22,19,40,210,250,3387,19:00 - 20:59
fall,2011-07-22,20,46,166,212,3387,19:00 - 20:59
fall,2011-07-22,21,38,152,190,3387,21:00 - 22:59
fall,2011-07-22,22,44,105,149,3387,21:00 - 22:59
fall,2011-07-22,23,19,84,103,3387,23:00 - 24:59
fall,2011-07-23,0,16,85,101,3285,
fall,2011-07-23,1,13,57,70,3285,01:00 - 02:59
fall,2011-07-23,2,13,48,61,3285,01:00 - 02:59
fall,2011-07-23,3,6,16,22,3285,03:00 - 04:59
fall,2011-07-23,4,5,4,9,3285,03:00 - 04:59
fall,2011-07-23,5,1,6,7,3285,05:00 - 06:59
fall,2011-07-23,6,6,19,25,3285,05:00 - 06:59
fall,2011-07-23,7,7,38,45,3285,07:00 - 08:59
fall,2011-07-23,8,24,85,109,3285,07:00 - 08:59
fall,2011-07-23,9,30,102,132,3285,09:00 - 10:59
fall,2011-07-23,10,61,137,198,3285,09:00 - 10:59
fall,2011-07-23,11,62,154,216,3285,11:00 - 12:59
fall,2011-07-23,12,71,164,235,3285,11:00 - 12:59
fall,2011-07-23,13,78,167,245,3285,13:00 - 14:59
fall,2011-07-23,14,84,152,236,3285,13:00 - 14:59
fall,2011-07-23,15,78,137,215,3285,15:00 - 16:59
fall,2011-07-23,16,70,151,221,3285,15:00 - 16:59
fall,2011-07-23,17,70,127,197,3285,17:00 - 18:59
fall,2011-07-23,18,62,134,196,3285,17:00 - 18:59
fall,2011-07-23,19,80,137,217,3285,19:00 - 20:59
fall,2011-07-23,20,47,98,145,3285,19:00 - 20:59
fall,2011-07-23,21,39,115,154,3285,21:00 - 22:59
fall,2011-07-23,22,37,88,125,3285,21:00 - 22:59
fall,2011-07-23,23,27,77,104,3285,23:00 - 24:59
fall,2011-07-24,0,42,77,119,3606,
fall,2011-07-24,1,33,63,96,3606,01:00 - 02:59
fall,2011-07-24,2,12,48,60,3606,01:00 - 02:59
fall,2011-07-24,3,17,20,37,3606,03:00 - 04:59
fall,2011-07-24,4,1,5,6,3606,03:00 - 04:59
fall,2011-07-24,5,5,3,8,3606,05:00 - 06:59
fall,2011-07-24,6,9,13,22,3606,05:00 - 06:59
fall,2011-07-24,7,6,29,35,3606,07:00 - 08:59
fall,2011-07-24,8,22,82,104,3606,07:00 - 08:59
fall,2011-07-24,9,42,112,154,3606,09:00 - 10:59
fall,2011-07-24,10,61,165,226,3606,09:00 - 10:59
fall,2011-07-24,11,74,169,243,3606,11:00 - 12:59
fall,2011-07-24,12,85,161,246,3606,11:00 - 12:59
fall,2011-07-24,13,90,162,252,3606,13:00 - 14:59
fall,2011-07-24,14,79,204,283,3606,13:00 - 14:59
fall,2011-07-24,15,68,170,238,3606,15:00 - 16:59
fall,2011-07-24,16,62,187,249,3606,15:00 - 16:59
fall,2011-07-24,17,75,174,249,3606,17:00 - 18:59
fall,2011-07-24,18,67,176,243,3606,17:00 - 18:59
fall,2011-07-24,19,70,170,240,3606,19:00 - 20:59
fall,2011-07-24,20,52,143,195,3606,19:00 - 20:59
fall,2011-07-24,21,42,111,153,3606,21:00 - 22:59
fall,2011-07-24,22,23,75,98,3606,21:00 - 22:59
fall,2011-07-24,23,13,37,50,3606,23:00 - 24:59
fall,2011-07-25,0,17,17,34,3840,
fall,2011-07-25,1,4,8,12,3840,01:00 - 02:59
fall,2011-07-25,2,3,3,6,3840,01:00 - 02:59
fall,2011-07-25,3,2,2,4,3840,03:00 - 04:59
fall,2011-07-25,4,0,6,6,3840,03:00 - 04:59
fall,2011-07-25,5,2,22,24,3840,05:00 - 06:59
fall,2011-07-25,6,7,100,107,3840,05:00 - 06:59
fall,2011-07-25,7,20,257,277,3840,07:00 - 08:59
fall,2011-07-25,8,34,353,387,3840,07:00 - 08:59
fall,2011-07-25,9,11,124,135,3840,09:00 - 10:59
fall,2011-07-25,10,30,54,84,3840,09:00 - 10:59
fall,2011-07-25,11,24,83,107,3840,11:00 - 12:59
fall,2011-07-25,12,17,50,67,3840,11:00 - 12:59
fall,2011-07-25,13,14,64,78,3840,13:00 - 14:59
fall,2011-07-25,14,28,62,90,3840,13:00 - 14:59
fall,2011-07-25,15,16,96,112,3840,15:00 - 16:59
fall,2011-07-25,16,37,161,198,3840,15:00 - 16:59
fall,2011-07-25,17,48,437,485,3840,17:00 - 18:59
fall,2011-07-25,18,60,473,533,3840,17:00 - 18:59
fall,2011-07-25,19,62,324,386,3840,19:00 - 20:59
fall,2011-07-25,20,55,247,302,3840,19:00 - 20:59
fall,2011-07-25,21,41,153,194,3840,21:00 - 22:59
fall,2011-07-25,22,13,112,125,3840,21:00 - 22:59
fall,2011-07-25,23,23,64,87,3840,23:00 - 24:59
fall,2011-07-26,0,8,20,28,4590,
fall,2011-07-26,1,6,6,12,4590,01:00 - 02:59
fall,2011-07-26,2,1,6,7,4590,01:00 - 02:59
fall,2011-07-26,3,2,2,4,4590,03:00 - 04:59
fall,2011-07-26,4,0,6,6,4590,03:00 - 04:59
fall,2011-07-26,5,3,24,27,4590,05:00 - 06:59
fall,2011-07-26,6,2,108,110,4590,05:00 - 06:59
fall,2011-07-26,7,30,288,318,4590,07:00 - 08:59
fall,2011-07-26,8,32,392,424,4590,07:00 - 08:59
fall,2011-07-26,9,25,162,187,4590,09:00 - 10:59
fall,2011-07-26,10,42,96,138,4590,09:00 - 10:59
fall,2011-07-26,11,49,102,151,4590,11:00 - 12:59
fall,2011-07-26,12,25,122,147,4590,11:00 - 12:59
fall,2011-07-26,13,43,139,182,4590,13:00 - 14:59
fall,2011-07-26,14,46,101,147,4590,13:00 - 14:59
fall,2011-07-26,15,49,114,163,4590,15:00 - 16:59
fall,2011-07-26,16,41,213,254,4590,15:00 - 16:59
fall,2011-07-26,17,72,465,537,4590,17:00 - 18:59
fall,2011-07-26,18,68,478,546,4590,17:00 - 18:59
fall,2011-07-26,19,69,329,398,4590,19:00 - 20:59
fall,2011-07-26,20,47,243,290,4590,19:00 - 20:59
fall,2011-07-26,21,45,222,267,4590,21:00 - 22:59
fall,2011-07-26,22,27,131,158,4590,21:00 - 22:59
fall,2011-07-26,23,18,71,89,4590,23:00 - 24:59
fall,2011-07-27,0,19,26,45,4656,
fall,2011-07-27,1,1,9,10,4656,01:00 - 02:59
fall,2011-07-27,2,1,5,6,4656,01:00 - 02:59
fall,2011-07-27,3,0,4,4,4656,03:00 - 04:59
fall,2011-07-27,4,1,3,4,4656,03:00 - 04:59
fall,2011-07-27,5,0,18,18,4656,05:00 - 06:59
fall,2011-07-27,6,4,119,123,4656,05:00 - 06:59
fall,2011-07-27,7,34,313,347,4656,07:00 - 08:59
fall,2011-07-27,8,28,405,433,4656,07:00 - 08:59
fall,2011-07-27,9,27,189,216,4656,09:00 - 10:59
fall,2011-07-27,10,32,82,114,4656,09:00 - 10:59
fall,2011-07-27,11,42,94,136,4656,11:00 - 12:59
fall,2011-07-27,12,37,132,169,4656,11:00 - 12:59
fall,2011-07-27,13,29,151,180,4656,13:00 - 14:59
fall,2011-07-27,14,20,107,127,4656,13:00 - 14:59
fall,2011-07-27,15,37,103,140,4656,15:00 - 16:59
fall,2011-07-27,16,40,228,268,4656,15:00 - 16:59
fall,2011-07-27,17,81,491,572,4656,17:00 - 18:59
fall,2011-07-27,18,78,463,541,4656,17:00 - 18:59
fall,2011-07-27,19,87,288,375,4656,19:00 - 20:59
fall,2011-07-27,20,55,239,294,4656,19:00 - 20:59
fall,2011-07-27,21,49,196,245,4656,21:00 - 22:59
fall,2011-07-27,22,37,143,180,4656,21:00 - 22:59
fall,2011-07-27,23,16,93,109,4656,23:00 - 24:59
fall,2011-07-28,0,14,31,45,4390,
fall,2011-07-28,1,3,26,29,4390,01:00 - 02:59
fall,2011-07-28,2,2,5,7,4390,01:00 - 02:59
fall,2011-07-28,3,0,5,5,4390,03:00 - 04:59
fall,2011-07-28,4,0,6,6,4390,03:00 - 04:59
fall,2011-07-28,5,1,26,27,4390,05:00 - 06:59
fall,2011-07-28,6,6,110,116,4390,05:00 - 06:59
fall,2011-07-28,7,27,278,305,4390,07:00 - 08:59
fall,2011-07-28,8,47,409,456,4390,07:00 - 08:59
fall,2011-07-28,9,21,189,210,4390,09:00 - 10:59
fall,2011-07-28,10,30,86,116,4390,09:00 - 10:59
fall,2011-07-28,11,41,113,154,4390,11:00 - 12:59
fall,2011-07-28,12,35,151,186,4390,11:00 - 12:59
fall,2011-07-28,13,26,126,152,4390,13:00 - 14:59
fall,2011-07-28,14,27,111,138,4390,13:00 - 14:59
fall,2011-07-28,15,22,124,146,4390,15:00 - 16:59
fall,2011-07-28,16,42,214,256,4390,15:00 - 16:59
fall,2011-07-28,17,45,423,468,4390,17:00 - 18:59
fall,2011-07-28,18,55,428,483,4390,17:00 - 18:59
fall,2011-07-28,19,37,285,322,4390,19:00 - 20:59
fall,2011-07-28,20,41,229,270,4390,19:00 - 20:59
fall,2011-07-28,21,31,165,196,4390,21:00 - 22:59
fall,2011-07-28,22,25,149,174,4390,21:00 - 22:59
fall,2011-07-28,23,28,95,123,4390,23:00 - 24:59
fall,2011-07-29,0,12,45,57,3846,
fall,2011-07-29,1,12,22,34,3846,01:00 - 02:59
fall,2011-07-29,2,3,10,13,3846,01:00 - 02:59
fall,2011-07-29,3,2,9,11,3846,03:00 - 04:59
fall,2011-07-29,4,2,4,6,3846,03:00 - 04:59
fall,2011-07-29,5,4,23,27,3846,05:00 - 06:59
fall,2011-07-29,6,7,83,90,3846,05:00 - 06:59
fall,2011-07-29,7,26,228,254,3846,07:00 - 08:59
fall,2011-07-29,8,30,354,384,3846,07:00 - 08:59
fall,2011-07-29,9,28,151,179,3846,09:00 - 10:59
fall,2011-07-29,10,37,69,106,3846,09:00 - 10:59
fall,2011-07-29,11,43,118,161,3846,11:00 - 12:59
fall,2011-07-29,12,40,95,135,3846,11:00 - 12:59
fall,2011-07-29,13,42,114,156,3846,13:00 - 14:59
fall,2011-07-29,14,34,114,148,3846,13:00 - 14:59
fall,2011-07-29,15,40,129,169,3846,15:00 - 16:59
fall,2011-07-29,16,35,198,233,3846,15:00 - 16:59
fall,2011-07-29,17,47,374,421,3846,17:00 - 18:59
fall,2011-07-29,18,49,313,362,3846,17:00 - 18:59
fall,2011-07-29,19,22,219,241,3846,19:00 - 20:59
fall,2011-07-29,20,53,153,206,3846,19:00 - 20:59
fall,2011-07-29,21,29,134,163,3846,21:00 - 22:59
fall,2011-07-29,22,47,127,174,3846,21:00 - 22:59
fall,2011-07-29,23,26,90,116,3846,23:00 - 24:59
fall,2011-07-30,0,60,73,133,4475,
fall,2011-07-30,1,15,75,90,4475,01:00 - 02:59
fall,2011-07-30,2,11,31,42,4475,01:00 - 02:59
fall,2011-07-30,3,18,25,43,4475,03:00 - 04:59
fall,2011-07-30,4,4,6,10,4475,03:00 - 04:59
fall,2011-07-30,5,4,9,13,4475,05:00 - 06:59
fall,2011-07-30,6,6,18,24,4475,05:00 - 06:59
fall,2011-07-30,7,3,39,42,4475,07:00 - 08:59
fall,2011-07-30,8,27,87,114,4475,07:00 - 08:59
fall,2011-07-30,9,49,125,174,4475,09:00 - 10:59
fall,2011-07-30,10,79,182,261,4475,09:00 - 10:59
fall,2011-07-30,11,111,206,317,4475,11:00 - 12:59
fall,2011-07-30,12,111,230,341,4475,11:00 - 12:59
fall,2011-07-30,13,125,183,308,4475,13:00 - 14:59
fall,2011-07-30,14,112,193,305,4475,13:00 - 14:59
fall,2011-07-30,15,113,189,302,4475,15:00 - 16:59
fall,2011-07-30,16,126,176,302,4475,15:00 - 16:59
fall,2011-07-30,17,93,209,302,4475,17:00 - 18:59
fall,2011-07-30,18,92,207,299,4475,17:00 - 18:59
fall,2011-07-30,19,101,155,256,4475,19:00 - 20:59
fall,2011-07-30,20,74,132,206,4475,19:00 - 20:59
fall,2011-07-30,21,82,123,205,4475,21:00 - 22:59
fall,2011-07-30,22,80,129,209,4475,21:00 - 22:59
fall,2011-07-30,23,63,114,177,4475,23:00 - 24:59
fall,2011-07-31,0,33,80,113,4302,
fall,2011-07-31,1,8,71,79,4302,01:00 - 02:59
fall,2011-07-31,2,19,48,67,4302,01:00 - 02:59
fall,2011-07-31,3,24,26,50,4302,03:00 - 04:59
fall,2011-07-31,4,6,7,13,4302,03:00 - 04:59
fall,2011-07-31,5,4,4,8,4302,05:00 - 06:59
fall,2011-07-31,6,5,8,13,4302,05:00 - 06:59
fall,2011-07-31,7,19,26,45,4302,07:00 - 08:59
fall,2011-07-31,8,54,88,142,4302,07:00 - 08:59
fall,2011-07-31,9,55,128,183,4302,09:00 - 10:59
fall,2011-07-31,10,91,163,254,4302,09:00 - 10:59
fall,2011-07-31,11,112,163,275,4302,11:00 - 12:59
fall,2011-07-31,12,146,192,338,4302,11:00 - 12:59
fall,2011-07-31,13,142,152,294,4302,13:00 - 14:59
fall,2011-07-31,14,130,196,326,4302,13:00 - 14:59
fall,2011-07-31,15,109,184,293,4302,15:00 - 16:59
fall,2011-07-31,16,98,208,306,4302,15:00 - 16:59
fall,2011-07-31,17,114,206,320,4302,17:00 - 18:59
fall,2011-07-31,18,91,213,304,4302,17:00 - 18:59
fall,2011-07-31,19,87,187,274,4302,19:00 - 20:59
fall,2011-07-31,20,70,205,275,4302,19:00 - 20:59
fall,2011-07-31,21,68,96,164,4302,21:00 - 22:59
fall,2011-07-31,22,25,71,96,4302,21:00 - 22:59
fall,2011-07-31,23,14,56,70,4302,23:00 - 24:59
fall,2011-08-01,0,7,22,29,4266,
fall,2011-08-01,1,5,12,17,4266,01:00 - 02:59
fall,2011-08-01,2,4,7,11,4266,01:00 - 02:59
fall,2011-08-01,3,0,4,4,4266,03:00 - 04:59
fall,2011-08-01,4,2,2,4,4266,03:00 - 04:59
fall,2011-08-01,5,2,24,26,4266,05:00 - 06:59
fall,2011-08-01,6,3,97,100,4266,05:00 - 06:59
fall,2011-08-01,7,24,258,282,4266,07:00 - 08:59
fall,2011-08-01,8,35,347,382,4266,07:00 - 08:59
fall,2011-08-01,9,27,139,166,4266,09:00 - 10:59
fall,2011-08-01,10,27,70,97,4266,09:00 - 10:59
fall,2011-08-01,11,53,66,119,4266,11:00 - 12:59
fall,2011-08-01,12,53,115,168,4266,11:00 - 12:59
fall,2011-08-01,13,38,112,150,4266,13:00 - 14:59
fall,2011-08-01,14,37,86,123,4266,13:00 - 14:59
fall,2011-08-01,15,52,77,129,4266,15:00 - 16:59
fall,2011-08-01,16,34,197,231,4266,15:00 - 16:59
fall,2011-08-01,17,69,445,514,4266,17:00 - 18:59
fall,2011-08-01,18,68,475,543,4266,17:00 - 18:59
fall,2011-08-01,19,63,350,413,4266,19:00 - 20:59
fall,2011-08-01,20,49,256,305,4266,19:00 - 20:59
fall,2011-08-01,21,42,178,220,4266,21:00 - 22:59
fall,2011-08-01,22,21,116,137,4266,21:00 - 22:59
fall,2011-08-01,23,14,82,96,4266,23:00 - 24:59
fall,2011-08-02,0,11,18,29,4845,
fall,2011-08-02,1,4,8,12,4845,01:00 - 02:59
fall,2011-08-02,2,2,6,8,4845,01:00 - 02:59
fall,2011-08-02,3,0,5,5,4845,03:00 - 04:59
fall,2011-08-02,4,0,10,10,4845,03:00 - 04:59
fall,2011-08-02,5,4,17,21,4845,05:00 - 06:59
fall,2011-08-02,6,12,105,117,4845,05:00 - 06:59
fall,2011-08-02,7,15,320,335,4845,07:00 - 08:59
fall,2011-08-02,8,37,398,435,4845,07:00 - 08:59
fall,2011-08-02,9,31,182,213,4845,09:00 - 10:59
fall,2011-08-02,10,50,90,140,4845,09:00 - 10:59
fall,2011-08-02,11,32,96,128,4845,11:00 - 12:59
fall,2011-08-02,12,45,112,157,4845,11:00 - 12:59
fall,2011-08-02,13,50,153,203,4845,13:00 - 14:59
fall,2011-08-02,14,45,114,159,4845,13:00 - 14:59
fall,2011-08-02,15,48,120,168,4845,15:00 - 16:59
fall,2011-08-02,16,58,216,274,4845,15:00 - 16:59
fall,2011-08-02,17,63,493,556,4845,17:00 - 18:59
fall,2011-08-02,18,65,491,556,4845,17:00 - 18:59
fall,2011-08-02,19,85,369,454,4845,19:00 - 20:59
fall,2011-08-02,20,40,248,288,4845,19:00 - 20:59
fall,2011-08-02,21,53,201,254,4845,21:00 - 22:59
fall,2011-08-02,22,22,169,191,4845,21:00 - 22:59
fall,2011-08-02,23,29,103,132,4845,23:00 - 24:59
fall,2011-08-03,0,11,32,43,3574,
fall,2011-08-03,1,7,9,16,3574,01:00 - 02:59
fall,2011-08-03,2,2,9,11,3574,01:00 - 02:59
fall,2011-08-03,3,0,4,4,3574,03:00 - 04:59
fall,2011-08-03,4,0,7,7,3574,03:00 - 04:59
fall,2011-08-03,5,2,22,24,3574,05:00 - 06:59
fall,2011-08-03,6,9,101,110,3574,05:00 - 06:59
fall,2011-08-03,7,19,252,271,3574,07:00 - 08:59
fall,2011-08-03,8,29,408,437,3574,07:00 - 08:59
fall,2011-08-03,9,23,172,195,3574,09:00 - 10:59
fall,2011-08-03,10,9,59,68,3574,09:00 - 10:59
fall,2011-08-03,11,29,93,122,3574,11:00 - 12:59
fall,2011-08-03,12,19,142,161,3574,11:00 - 12:59
fall,2011-08-03,13,37,107,144,3574,13:00 - 14:59
fall,2011-08-03,14,43,104,147,3574,13:00 - 14:59
fall,2011-08-03,15,31,87,118,3574,15:00 - 16:59
fall,2011-08-03,16,21,129,150,3574,15:00 - 16:59
fall,2011-08-03,17,47,378,425,3574,17:00 - 18:59
fall,2011-08-03,18,49,443,492,3574,17:00 - 18:59
fall,2011-08-03,19,51,270,321,3574,19:00 - 20:59
fall,2011-08-03,20,7,80,87,3574,19:00 - 20:59
fall,2011-08-03,21,7,81,88,3574,21:00 - 22:59
fall,2011-08-03,22,11,66,77,3574,21:00 - 22:59
fall,2011-08-03,23,4,52,56,3574,23:00 - 24:59
fall,2011-08-04,0,2,15,17,4576,
fall,2011-08-04,1,3,14,17,4576,01:00 - 02:59
fall,2011-08-04,2,2,5,7,4576,01:00 - 02:59
fall,2011-08-04,3,0,3,3,4576,03:00 - 04:59
fall,2011-08-04,4,0,7,7,4576,03:00 - 04:59
fall,2011-08-04,5,3,17,20,4576,05:00 - 06:59
fall,2011-08-04,6,7,90,97,4576,05:00 - 06:59
fall,2011-08-04,7,11,271,282,4576,07:00 - 08:59
fall,2011-08-04,8,29,369,398,4576,07:00 - 08:59
fall,2011-08-04,9,25,162,187,4576,09:00 - 10:59
fall,2011-08-04,10,24,89,113,4576,09:00 - 10:59
fall,2011-08-04,11,37,112,149,4576,11:00 - 12:59
fall,2011-08-04,12,53,152,205,4576,11:00 - 12:59
fall,2011-08-04,13,63,142,205,4576,13:00 - 14:59
fall,2011-08-04,14,53,114,167,4576,13:00 - 14:59
fall,2011-08-04,15,50,115,165,4576,15:00 - 16:59
fall,2011-08-04,16,70,220,290,4576,15:00 - 16:59
fall,2011-08-04,17,91,464,555,4576,17:00 - 18:59
fall,2011-08-04,18,88,435,523,4576,17:00 - 18:59
fall,2011-08-04,19,65,301,366,4576,19:00 - 20:59
fall,2011-08-04,20,41,245,286,4576,19:00 - 20:59
fall,2011-08-04,21,25,186,211,4576,21:00 - 22:59
fall,2011-08-04,22,33,141,174,4576,21:00 - 22:59
fall,2011-08-04,23,24,108,132,4576,23:00 - 24:59
fall,2011-08-05,0,13,41,54,4866,
fall,2011-08-05,1,3,16,19,4866,01:00 - 02:59
fall,2011-08-05,2,5,14,19,4866,01:00 - 02:59
fall,2011-08-05,3,0,6,6,4866,03:00 - 04:59
fall,2011-08-05,4,1,6,7,4866,03:00 - 04:59
fall,2011-08-05,5,0,16,16,4866,05:00 - 06:59
fall,2011-08-05,6,7,94,101,4866,05:00 - 06:59
fall,2011-08-05,7,23,247,270,4866,07:00 - 08:59
fall,2011-08-05,8,39,415,454,4866,07:00 - 08:59
fall,2011-08-05,9,43,183,226,4866,09:00 - 10:59
fall,2011-08-05,10,50,113,163,4866,09:00 - 10:59
fall,2011-08-05,11,44,103,147,4866,11:00 - 12:59
fall,2011-08-05,12,57,159,216,4866,11:00 - 12:59
fall,2011-08-05,13,40,164,204,4866,13:00 - 14:59
fall,2011-08-05,14,81,164,245,4866,13:00 - 14:59
fall,2011-08-05,15,50,160,210,4866,15:00 - 16:59
fall,2011-08-05,16,76,254,330,4866,15:00 - 16:59
fall,2011-08-05,17,84,466,550,4866,17:00 - 18:59
fall,2011-08-05,18,105,361,466,4866,17:00 - 18:59
fall,2011-08-05,19,90,282,372,4866,19:00 - 20:59
fall,2011-08-05,20,70,221,291,4866,19:00 - 20:59
fall,2011-08-05,21,54,119,173,4866,21:00 - 22:59
fall,2011-08-05,22,51,137,188,4866,21:00 - 22:59
fall,2011-08-05,23,37,102,139,4866,23:00 - 24:59
fall,2011-08-06,0,29,104,133,4294,
fall,2011-08-06,1,17,50,67,4294,01:00 - 02:59
fall,2011-08-06,2,14,39,53,4294,01:00 - 02:59
fall,2011-08-06,3,14,28,42,4294,03:00 - 04:59
fall,2011-08-06,4,5,5,10,4294,03:00 - 04:59
fall,2011-08-06,5,2,4,6,4294,05:00 - 06:59
fall,2011-08-06,6,5,22,27,4294,05:00 - 06:59
fall,2011-08-06,7,14,49,63,4294,07:00 - 08:59
fall,2011-08-06,8,27,94,121,4294,07:00 - 08:59
fall,2011-08-06,9,60,155,215,4294,09:00 - 10:59
fall,2011-08-06,10,91,199,290,4294,09:00 - 10:59
fall,2011-08-06,11,138,211,349,4294,11:00 - 12:59
fall,2011-08-06,12,130,252,382,4294,11:00 - 12:59
fall,2011-08-06,13,176,265,441,4294,13:00 - 14:59
fall,2011-08-06,14,176,204,380,4294,13:00 - 14:59
fall,2011-08-06,15,130,232,362,4294,15:00 - 16:59
fall,2011-08-06,16,155,188,343,4294,15:00 - 16:59
fall,2011-08-06,17,61,88,149,4294,17:00 - 18:59
fall,2011-08-06,18,81,130,211,4294,17:00 - 18:59
fall,2011-08-06,19,57,114,171,4294,19:00 - 20:59
fall,2011-08-06,20,58,79,137,4294,19:00 - 20:59
fall,2011-08-06,21,28,86,114,4294,21:00 - 22:59
fall,2011-08-06,22,24,96,120,4294,21:00 - 22:59
fall,2011-08-06,23,29,79,108,4294,23:00 - 24:59
fall,2011-08-07,0,14,66,80,3785,
fall,2011-08-07,1,10,63,73,3785,01:00 - 02:59
fall,2011-08-07,2,18,48,66,3785,01:00 - 02:59
fall,2011-08-07,3,9,23,32,3785,03:00 - 04:59
fall,2011-08-07,4,1,5,6,3785,03:00 - 04:59
fall,2011-08-07,5,1,4,5,3785,05:00 - 06:59
fall,2011-08-07,6,3,10,13,3785,05:00 - 06:59
fall,2011-08-07,7,11,28,39,3785,07:00 - 08:59
fall,2011-08-07,8,23,66,89,3785,07:00 - 08:59
fall,2011-08-07,9,82,102,184,3785,09:00 - 10:59
fall,2011-08-07,10,88,178,266,3785,09:00 - 10:59
fall,2011-08-07,11,113,156,269,3785,11:00 - 12:59
fall,2011-08-07,12,161,209,370,3785,11:00 - 12:59
fall,2011-08-07,13,118,206,324,3785,13:00 - 14:59
fall,2011-08-07,14,130,192,322,3785,13:00 - 14:59
fall,2011-08-07,15,118,208,326,3785,15:00 - 16:59
fall,2011-08-07,16,74,119,193,3785,15:00 - 16:59
fall,2011-08-07,17,63,131,194,3785,17:00 - 18:59
fall,2011-08-07,18,74,155,229,3785,17:00 - 18:59
fall,2011-08-07,19,68,160,228,3785,19:00 - 20:59
fall,2011-08-07,20,50,133,183,3785,19:00 - 20:59
fall,2011-08-07,21,36,100,136,3785,21:00 - 22:59
fall,2011-08-07,22,21,82,103,3785,21:00 - 22:59
fall,2011-08-07,23,12,43,55,3785,23:00 - 24:59
fall,2011-08-08,0,13,17,30,4326,
fall,2011-08-08,1,4,8,12,4326,01:00 - 02:59
fall,2011-08-08,2,4,3,7,4326,01:00 - 02:59
fall,2011-08-08,3,1,0,1,4326,03:00 - 04:59
fall,2011-08-08,4,2,8,10,4326,03:00 - 04:59
fall,2011-08-08,5,1,14,15,4326,05:00 - 06:59
fall,2011-08-08,6,8,87,95,4326,05:00 - 06:59
fall,2011-08-08,7,18,249,267,4326,07:00 - 08:59
fall,2011-08-08,8,29,320,349,4326,07:00 - 08:59
fall,2011-08-08,9,37,146,183,4326,09:00 - 10:59
fall,2011-08-08,10,62,62,124,4326,09:00 - 10:59
fall,2011-08-08,11,90,89,179,4326,11:00 - 12:59
fall,2011-08-08,12,48,134,182,4326,11:00 - 12:59
fall,2011-08-08,13,43,108,151,4326,13:00 - 14:59
fall,2011-08-08,14,41,109,150,4326,13:00 - 14:59
fall,2011-08-08,15,40,86,126,4326,15:00 - 16:59
fall,2011-08-08,16,64,218,282,4326,15:00 - 16:59
fall,2011-08-08,17,67,460,527,4326,17:00 - 18:59
fall,2011-08-08,18,64,465,529,4326,17:00 - 18:59
fall,2011-08-08,19,64,352,416,4326,19:00 - 20:59
fall,2011-08-08,20,71,215,286,4326,19:00 - 20:59
fall,2011-08-08,21,30,156,186,4326,21:00 - 22:59
fall,2011-08-08,22,26,121,147,4326,21:00 - 22:59
fall,2011-08-08,23,19,53,72,4326,23:00 - 24:59
fall,2011-08-09,0,10,25,35,4602,
fall,2011-08-09,1,5,9,14,4602,01:00 - 02:59
fall,2011-08-09,2,9,3,12,4602,01:00 - 02:59
fall,2011-08-09,3,0,3,3,4602,03:00 - 04:59
fall,2011-08-09,4,1,6,7,4602,03:00 - 04:59
fall,2011-08-09,5,5,25,30,4602,05:00 - 06:59
fall,2011-08-09,6,6,95,101,4602,05:00 - 06:59
fall,2011-08-09,7,30,313,343,4602,07:00 - 08:59
fall,2011-08-09,8,40,352,392,4602,07:00 - 08:59
fall,2011-08-09,9,34,141,175,4602,09:00 - 10:59
fall,2011-08-09,10,55,89,144,4602,09:00 - 10:59
fall,2011-08-09,11,61,88,149,4602,11:00 - 12:59
fall,2011-08-09,12,60,125,185,4602,11:00 - 12:59
fall,2011-08-09,13,48,127,175,4602,13:00 - 14:59
fall,2011-08-09,14,53,95,148,4602,13:00 - 14:59
fall,2011-08-09,15,58,106,164,4602,15:00 - 16:59
fall,2011-08-09,16,57,228,285,4602,15:00 - 16:59
fall,2011-08-09,17,79,453,532,4602,17:00 - 18:59
fall,2011-08-09,18,97,488,585,4602,17:00 - 18:59
fall,2011-08-09,19,69,302,371,4602,19:00 - 20:59
fall,2011-08-09,20,34,258,292,4602,19:00 - 20:59
fall,2011-08-09,21,46,184,230,4602,21:00 - 22:59
fall,2011-08-09,22,28,127,155,4602,21:00 - 22:59
fall,2011-08-09,23,22,53,75,4602,23:00 - 24:59
fall,2011-08-10,0,19,18,37,4780,
fall,2011-08-10,1,7,10,17,4780,01:00 - 02:59
fall,2011-08-10,2,1,10,11,4780,01:00 - 02:59
fall,2011-08-10,3,1,3,4,4780,03:00 - 04:59
fall,2011-08-10,4,1,4,5,4780,03:00 - 04:59
fall,2011-08-10,5,2,30,32,4780,05:00 - 06:59
fall,2011-08-10,6,9,110,119,4780,05:00 - 06:59
fall,2011-08-10,7,16,289,305,4780,07:00 - 08:59
fall,2011-08-10,8,38,361,399,4780,07:00 - 08:59
fall,2011-08-10,9,32,148,180,4780,09:00 - 10:59
fall,2011-08-10,10,41,72,113,4780,09:00 - 10:59
fall,2011-08-10,11,54,95,149,4780,11:00 - 12:59
fall,2011-08-10,12,74,166,240,4780,11:00 - 12:59
fall,2011-08-10,13,41,150,191,4780,13:00 - 14:59
fall,2011-08-10,14,62,116,178,4780,13:00 - 14:59
fall,2011-08-10,15,53,141,194,4780,15:00 - 16:59
fall,2011-08-10,16,76,206,282,4780,15:00 - 16:59
fall,2011-08-10,17,71,513,584,4780,17:00 - 18:59
fall,2011-08-10,18,70,489,559,4780,17:00 - 18:59
fall,2011-08-10,19,79,334,413,4780,19:00 - 20:59
fall,2011-08-10,20,59,253,312,4780,19:00 - 20:59
fall,2011-08-10,21,47,162,209,4780,21:00 - 22:59
fall,2011-08-10,22,17,122,139,4780,21:00 - 22:59
fall,2011-08-10,23,14,94,108,4780,23:00 - 24:59
fall,2011-08-11,0,6,40,46,4792,
fall,2011-08-11,1,9,17,26,4792,01:00 - 02:59
fall,2011-08-11,2,3,8,11,4792,01:00 - 02:59
fall,2011-08-11,3,2,7,9,4792,03:00 - 04:59
fall,2011-08-11,4,1,4,5,4792,03:00 - 04:59
fall,2011-08-11,5,2,23,25,4792,05:00 - 06:59
fall,2011-08-11,6,5,101,106,4792,05:00 - 06:59
fall,2011-08-11,7,15,292,307,4792,07:00 - 08:59
fall,2011-08-11,8,29,361,390,4792,07:00 - 08:59
fall,2011-08-11,9,31,166,197,4792,09:00 - 10:59
fall,2011-08-11,10,36,96,132,4792,09:00 - 10:59
fall,2011-08-11,11,59,128,187,4792,11:00 - 12:59
fall,2011-08-11,12,50,164,214,4792,11:00 - 12:59
fall,2011-08-11,13,51,166,217,4792,13:00 - 14:59
fall,2011-08-11,14,39,103,142,4792,13:00 - 14:59
fall,2011-08-11,15,52,126,178,4792,15:00 - 16:59
fall,2011-08-11,16,57,241,298,4792,15:00 - 16:59
fall,2011-08-11,17,96,486,582,4792,17:00 - 18:59
fall,2011-08-11,18,74,497,571,4792,17:00 - 18:59
fall,2011-08-11,19,48,323,371,4792,19:00 - 20:59
fall,2011-08-11,20,56,232,288,4792,19:00 - 20:59
fall,2011-08-11,21,35,171,206,4792,21:00 - 22:59
fall,2011-08-11,22,34,123,157,4792,21:00 - 22:59
fall,2011-08-11,23,22,105,127,4792,23:00 - 24:59
fall,2011-08-12,0,12,53,65,4905,
fall,2011-08-12,1,4,19,23,4905,01:00 - 02:59
fall,2011-08-12,2,0,15,15,4905,01:00 - 02:59
fall,2011-08-12,3,0,9,9,4905,03:00 - 04:59
fall,2011-08-12,4,0,5,5,4905,03:00 - 04:59
fall,2011-08-12,5,2,24,26,4905,05:00 - 06:59
fall,2011-08-12,6,3,73,76,4905,05:00 - 06:59
fall,2011-08-12,7,17,247,264,4905,07:00 - 08:59
fall,2011-08-12,8,29,397,426,4905,07:00 - 08:59
fall,2011-08-12,9,27,178,205,4905,09:00 - 10:59
fall,2011-08-12,10,44,86,130,4905,09:00 - 10:59
fall,2011-08-12,11,48,108,156,4905,11:00 - 12:59
fall,2011-08-12,12,55,167,222,4905,11:00 - 12:59
fall,2011-08-12,13,74,179,253,4905,13:00 - 14:59
fall,2011-08-12,14,51,135,186,4905,13:00 - 14:59
fall,2011-08-12,15,59,190,249,4905,15:00 - 16:59
fall,2011-08-12,16,68,266,334,4905,15:00 - 16:59
fall,2011-08-12,17,93,423,516,4905,17:00 - 18:59
fall,2011-08-12,18,89,376,465,4905,17:00 - 18:59
fall,2011-08-12,19,101,284,385,4905,19:00 - 20:59
fall,2011-08-12,20,77,210,287,4905,19:00 - 20:59
fall,2011-08-12,21,73,153,226,4905,21:00 - 22:59
fall,2011-08-12,22,74,157,231,4905,21:00 - 22:59
fall,2011-08-12,23,51,100,151,4905,23:00 - 24:59
fall,2011-08-13,0,15,69,84,4150,
fall,2011-08-13,1,13,64,77,4150,01:00 - 02:59
fall,2011-08-13,2,16,58,74,4150,01:00 - 02:59
fall,2011-08-13,3,9,18,27,4150,03:00 - 04:59
fall,2011-08-13,4,5,5,10,4150,03:00 - 04:59
fall,2011-08-13,5,3,15,18,4150,05:00 - 06:59
fall,2011-08-13,6,3,19,22,4150,05:00 - 06:59
fall,2011-08-13,7,10,34,44,4150,07:00 - 08:59
fall,2011-08-13,8,28,90,118,4150,07:00 - 08:59
fall,2011-08-13,9,70,138,208,4150,09:00 - 10:59
fall,2011-08-13,10,97,163,260,4150,09:00 - 10:59
fall,2011-08-13,11,122,192,314,4150,11:00 - 12:59
fall,2011-08-13,12,175,246,421,4150,11:00 - 12:59
fall,2011-08-13,13,61,92,153,4150,13:00 - 14:59
fall,2011-08-13,14,113,146,259,4150,13:00 - 14:59
fall,2011-08-13,15,150,208,358,4150,15:00 - 16:59
fall,2011-08-13,16,148,133,281,4150,15:00 - 16:59
fall,2011-08-13,17,97,172,269,4150,17:00 - 18:59
fall,2011-08-13,18,123,169,292,4150,17:00 - 18:59
fall,2011-08-13,19,67,170,237,4150,19:00 - 20:59
fall,2011-08-13,20,78,105,183,4150,19:00 - 20:59
fall,2011-08-13,21,40,127,167,4150,21:00 - 22:59
fall,2011-08-13,22,36,118,154,4150,21:00 - 22:59
fall,2011-08-13,23,25,95,120,4150,23:00 - 24:59
fall,2011-08-14,0,19,71,90,3820,
fall,2011-08-14,1,16,57,73,3820,01:00 - 02:59
fall,2011-08-14,2,13,49,62,3820,01:00 - 02:59
fall,2011-08-14,3,5,22,27,3820,03:00 - 04:59
fall,2011-08-14,4,1,2,3,3820,03:00 - 04:59
fall,2011-08-14,5,1,9,10,3820,05:00 - 06:59
fall,2011-08-14,6,2,4,6,3820,05:00 - 06:59
fall,2011-08-14,7,4,20,24,3820,07:00 - 08:59
fall,2011-08-14,8,20,21,41,3820,07:00 - 08:59
fall,2011-08-14,9,27,76,103,3820,09:00 - 10:59
fall,2011-08-14,10,67,116,183,3820,09:00 - 10:59
fall,2011-08-14,11,81,117,198,3820,11:00 - 12:59
fall,2011-08-14,12,98,183,281,3820,11:00 - 12:59
fall,2011-08-14,13,144,233,377,3820,13:00 - 14:59
fall,2011-08-14,14,126,244,370,3820,13:00 - 14:59
fall,2011-08-14,15,128,203,331,3820,15:00 - 16:59
fall,2011-08-14,16,116,176,292,3820,15:00 - 16:59
fall,2011-08-14,17,133,196,329,3820,17:00 - 18:59
fall,2011-08-14,18,125,222,347,3820,17:00 - 18:59
fall,2011-08-14,19,75,184,259,3820,19:00 - 20:59
fall,2011-08-14,20,67,126,193,3820,19:00 - 20:59
fall,2011-08-14,21,51,104,155,3820,21:00 - 22:59
fall,2011-08-14,22,14,25,39,3820,21:00 - 22:59
fall,2011-08-14,23,5,22,27,3820,23:00 - 24:59
fall,2011-08-15,0,7,18,25,4338,
fall,2011-08-15,1,1,9,10,4338,01:00 - 02:59
fall,2011-08-15,2,0,3,3,4338,01:00 - 02:59
fall,2011-08-15,3,1,6,7,4338,03:00 - 04:59
fall,2011-08-15,4,1,4,5,4338,03:00 - 04:59
fall,2011-08-15,5,3,14,17,4338,05:00 - 06:59
fall,2011-08-15,6,3,87,90,4338,05:00 - 06:59
fall,2011-08-15,7,10,248,258,4338,07:00 - 08:59
fall,2011-08-15,8,29,326,355,4338,07:00 - 08:59
fall,2011-08-15,9,52,170,222,4338,09:00 - 10:59
fall,2011-08-15,10,54,87,141,4338,09:00 - 10:59
fall,2011-08-15,11,41,112,153,4338,11:00 - 12:59
fall,2011-08-15,12,62,116,178,4338,11:00 - 12:59
fall,2011-08-15,13,53,140,193,4338,13:00 - 14:59
fall,2011-08-15,14,56,95,151,4338,13:00 - 14:59
fall,2011-08-15,15,49,133,182,4338,15:00 - 16:59
fall,2011-08-15,16,58,225,283,4338,15:00 - 16:59
fall,2011-08-15,17,59,471,530,4338,17:00 - 18:59
fall,2011-08-15,18,70,413,483,4338,17:00 - 18:59
fall,2011-08-15,19,54,343,397,4338,19:00 - 20:59
fall,2011-08-15,20,45,240,285,4338,19:00 - 20:59
fall,2011-08-15,21,34,150,184,4338,21:00 - 22:59
fall,2011-08-15,22,22,76,98,4338,21:00 - 22:59
fall,2011-08-15,23,11,77,88,4338,23:00 - 24:59
fall,2011-08-16,0,8,23,31,4725,
fall,2011-08-16,1,4,12,16,4725,01:00 - 02:59
fall,2011-08-16,2,1,3,4,4725,01:00 - 02:59
fall,2011-08-16,3,1,5,6,4725,03:00 - 04:59
fall,2011-08-16,4,0,5,5,4725,03:00 - 04:59
fall,2011-08-16,5,1,29,30,4725,05:00 - 06:59
fall,2011-08-16,6,4,115,119,4725,05:00 - 06:59
fall,2011-08-16,7,18,328,346,4725,07:00 - 08:59
fall,2011-08-16,8,24,417,441,4725,07:00 - 08:59
fall,2011-08-16,9,27,171,198,4725,09:00 - 10:59
fall,2011-08-16,10,28,83,111,4725,09:00 - 10:59
fall,2011-08-16,11,40,110,150,4725,11:00 - 12:59
fall,2011-08-16,12,42,120,162,4725,11:00 - 12:59
fall,2011-08-16,13,45,147,192,4725,13:00 - 14:59
fall,2011-08-16,14,65,117,182,4725,13:00 - 14:59
fall,2011-08-16,15,36,123,159,4725,15:00 - 16:59
fall,2011-08-16,16,55,248,303,4725,15:00 - 16:59
fall,2011-08-16,17,75,525,600,4725,17:00 - 18:59
fall,2011-08-16,18,54,516,570,4725,17:00 - 18:59
fall,2011-08-16,19,56,320,376,4725,19:00 - 20:59
fall,2011-08-16,20,48,232,280,4725,19:00 - 20:59
fall,2011-08-16,21,38,177,215,4725,21:00 - 22:59
fall,2011-08-16,22,31,121,152,4725,21:00 - 22:59
fall,2011-08-16,23,20,57,77,4725,23:00 - 24:59
fall,2011-08-17,0,8,16,24,4694,
fall,2011-08-17,1,2,12,14,4694,01:00 - 02:59
fall,2011-08-17,2,0,6,6,4694,01:00 - 02:59
fall,2011-08-17,3,1,4,5,4694,03:00 - 04:59
fall,2011-08-17,4,0,5,5,4694,03:00 - 04:59
fall,2011-08-17,5,0,28,28,4694,05:00 - 06:59
fall,2011-08-17,6,4,101,105,4694,05:00 - 06:59
fall,2011-08-17,7,12,296,308,4694,07:00 - 08:59
fall,2011-08-17,8,35,452,487,4694,07:00 - 08:59
fall,2011-08-17,9,31,178,209,4694,09:00 - 10:59
fall,2011-08-17,10,27,91,118,4694,09:00 - 10:59
fall,2011-08-17,11,20,108,128,4694,11:00 - 12:59
fall,2011-08-17,12,26,163,189,4694,11:00 - 12:59
fall,2011-08-17,13,38,138,176,4694,13:00 - 14:59
fall,2011-08-17,14,54,138,192,4694,13:00 - 14:59
fall,2011-08-17,15,42,117,159,4694,15:00 - 16:59
fall,2011-08-17,16,62,238,300,4694,15:00 - 16:59
fall,2011-08-17,17,46,506,552,4694,17:00 - 18:59
fall,2011-08-17,18,86,470,556,4694,17:00 - 18:59
fall,2011-08-17,19,50,297,347,4694,19:00 - 20:59
fall,2011-08-17,20,37,243,280,4694,19:00 - 20:59
fall,2011-08-17,21,38,192,230,4694,21:00 - 22:59
fall,2011-08-17,22,29,142,171,4694,21:00 - 22:59
fall,2011-08-17,23,20,85,105,4694,23:00 - 24:59
fall,2011-08-18,0,18,38,56,3805,
fall,2011-08-18,1,13,11,24,3805,01:00 - 02:59
fall,2011-08-18,2,2,4,6,3805,01:00 - 02:59
fall,2011-08-18,3,0,6,6,3805,03:00 - 04:59
fall,2011-08-18,4,0,9,9,3805,03:00 - 04:59
fall,2011-08-18,5,0,27,27,3805,05:00 - 06:59
fall,2011-08-18,6,6,97,103,3805,05:00 - 06:59
fall,2011-08-18,7,19,289,308,3805,07:00 - 08:59
fall,2011-08-18,8,27,393,420,3805,07:00 - 08:59
fall,2011-08-18,9,42,186,228,3805,09:00 - 10:59
fall,2011-08-18,10,37,92,129,3805,09:00 - 10:59
fall,2011-08-18,11,44,97,141,3805,11:00 - 12:59
fall,2011-08-18,12,34,139,173,3805,11:00 - 12:59
fall,2011-08-18,13,33,154,187,3805,13:00 - 14:59
fall,2011-08-18,14,67,115,182,3805,13:00 - 14:59
fall,2011-08-18,15,56,118,174,3805,15:00 - 16:59
fall,2011-08-18,16,49,196,245,3805,15:00 - 16:59
fall,2011-08-18,17,44,365,409,3805,17:00 - 18:59
fall,2011-08-18,18,48,226,274,3805,17:00 - 18:59
fall,2011-08-18,19,26,115,141,3805,19:00 - 20:59
fall,2011-08-18,20,24,141,165,3805,19:00 - 20:59
fall,2011-08-18,21,12,137,149,3805,21:00 - 22:59
fall,2011-08-18,22,18,117,135,3805,21:00 - 22:59
fall,2011-08-18,23,20,94,114,3805,23:00 - 24:59
fall,2011-08-19,0,9,53,62,4153,
fall,2011-08-19,1,1,19,20,4153,01:00 - 02:59
fall,2011-08-19,2,0,8,8,4153,01:00 - 02:59
fall,2011-08-19,3,2,1,3,4153,03:00 - 04:59
fall,2011-08-19,4,1,7,8,4153,03:00 - 04:59
fall,2011-08-19,5,1,16,17,4153,05:00 - 06:59
fall,2011-08-19,6,2,91,93,4153,05:00 - 06:59
fall,2011-08-19,7,12,251,263,4153,07:00 - 08:59
fall,2011-08-19,8,30,368,398,4153,07:00 - 08:59
fall,2011-08-19,9,31,187,218,4153,09:00 - 10:59
fall,2011-08-19,10,57,108,165,4153,09:00 - 10:59
fall,2011-08-19,11,45,120,165,4153,11:00 - 12:59
fall,2011-08-19,12,54,168,222,4153,11:00 - 12:59
fall,2011-08-19,13,63,169,232,4153,13:00 - 14:59
fall,2011-08-19,14,78,142,220,4153,13:00 - 14:59
fall,2011-08-19,15,66,156,222,4153,15:00 - 16:59
fall,2011-08-19,16,66,261,327,4153,15:00 - 16:59
fall,2011-08-19,17,85,442,527,4153,17:00 - 18:59
fall,2011-08-19,18,88,337,425,4153,17:00 - 18:59
fall,2011-08-19,19,33,132,165,4153,19:00 - 20:59
fall,2011-08-19,20,12,46,58,4153,19:00 - 20:59
fall,2011-08-19,21,18,89,107,4153,21:00 - 22:59
fall,2011-08-19,22,25,97,122,4153,21:00 - 22:59
fall,2011-08-19,23,18,88,106,4153,23:00 - 24:59
fall,2011-08-20,0,21,107,128,5191,
fall,2011-08-20,1,12,35,47,5191,01:00 - 02:59
fall,2011-08-20,2,10,59,69,5191,01:00 - 02:59
fall,2011-08-20,3,9,42,51,5191,03:00 - 04:59
fall,2011-08-20,4,1,6,7,5191,03:00 - 04:59
fall,2011-08-20,5,0,8,8,5191,05:00 - 06:59
fall,2011-08-20,6,6,18,24,5191,05:00 - 06:59
fall,2011-08-20,7,8,36,44,5191,07:00 - 08:59
fall,2011-08-20,8,27,106,133,5191,07:00 - 08:59
fall,2011-08-20,9,51,139,190,5191,09:00 - 10:59
fall,2011-08-20,10,114,192,306,5191,09:00 - 10:59
fall,2011-08-20,11,115,223,338,5191,11:00 - 12:59
fall,2011-08-20,12,156,253,409,5191,11:00 - 12:59
fall,2011-08-20,13,158,220,378,5191,13:00 - 14:59
fall,2011-08-20,14,147,228,375,5191,13:00 - 14:59
fall,2011-08-20,15,175,215,390,5191,15:00 - 16:59
fall,2011-08-20,16,151,222,373,5191,15:00 - 16:59
fall,2011-08-20,17,180,203,383,5191,17:00 - 18:59
fall,2011-08-20,18,169,225,394,5191,17:00 - 18:59
fall,2011-08-20,19,109,182,291,5191,19:00 - 20:59
fall,2011-08-20,20,78,170,248,5191,19:00 - 20:59
fall,2011-08-20,21,81,144,225,5191,21:00 - 22:59
fall,2011-08-20,22,77,146,223,5191,21:00 - 22:59
fall,2011-08-20,23,59,98,157,5191,23:00 - 24:59
fall,2011-08-21,0,6,68,74,3873,
fall,2011-08-21,1,17,69,86,3873,01:00 - 02:59
fall,2011-08-21,2,13,51,64,3873,01:00 - 02:59
fall,2011-08-21,3,25,26,51,3873,03:00 - 04:59
fall,2011-08-21,4,1,5,6,3873,03:00 - 04:59
fall,2011-08-21,5,0,8,8,3873,05:00 - 06:59
fall,2011-08-21,6,4,10,14,3873,05:00 - 06:59
fall,2011-08-21,7,12,19,31,3873,07:00 - 08:59
fall,2011-08-21,8,30,62,92,3873,07:00 - 08:59
fall,2011-08-21,9,80,151,231,3873,09:00 - 10:59
fall,2011-08-21,10,97,177,274,3873,09:00 - 10:59
fall,2011-08-21,11,132,181,313,3873,11:00 - 12:59
fall,2011-08-21,12,135,239,374,3873,11:00 - 12:59
fall,2011-08-21,13,94,216,310,3873,13:00 - 14:59
fall,2011-08-21,14,78,157,235,3873,13:00 - 14:59
fall,2011-08-21,15,17,51,68,3873,15:00 - 16:59
fall,2011-08-21,16,97,161,258,3873,15:00 - 16:59
fall,2011-08-21,17,91,179,270,3873,17:00 - 18:59
fall,2011-08-21,18,96,215,311,3873,17:00 - 18:59
fall,2011-08-21,19,81,201,282,3873,19:00 - 20:59
fall,2011-08-21,20,41,140,181,3873,19:00 - 20:59
fall,2011-08-21,21,45,93,138,3873,21:00 - 22:59
fall,2011-08-21,22,37,97,134,3873,21:00 - 22:59
fall,2011-08-21,23,20,48,68,3873,23:00 - 24:59
fall,2011-08-22,0,18,22,40,4758,
fall,2011-08-22,1,8,13,21,4758,01:00 - 02:59
fall,2011-08-22,2,2,6,8,4758,01:00 - 02:59
fall,2011-08-22,3,0,5,5,4758,03:00 - 04:59
fall,2011-08-22,4,2,10,12,4758,03:00 - 04:59
fall,2011-08-22,5,1,23,24,4758,05:00 - 06:59
fall,2011-08-22,6,6,106,112,4758,05:00 - 06:59
fall,2011-08-22,7,11,270,281,4758,07:00 - 08:59
fall,2011-08-22,8,20,331,351,4758,07:00 - 08:59
fall,2011-08-22,9,36,151,187,4758,09:00 - 10:59
fall,2011-08-22,10,36,85,121,4758,09:00 - 10:59
fall,2011-08-22,11,46,85,131,4758,11:00 - 12:59
fall,2011-08-22,12,54,153,207,4758,11:00 - 12:59
fall,2011-08-22,13,47,158,205,4758,13:00 - 14:59
fall,2011-08-22,14,88,137,225,4758,13:00 - 14:59
fall,2011-08-22,15,72,127,199,4758,15:00 - 16:59
fall,2011-08-22,16,66,254,320,4758,15:00 - 16:59
fall,2011-08-22,17,82,509,591,4758,17:00 - 18:59
fall,2011-08-22,18,72,537,609,4758,17:00 - 18:59
fall,2011-08-22,19,66,350,416,4758,19:00 - 20:59
fall,2011-08-22,20,21,247,268,4758,19:00 - 20:59
fall,2011-08-22,21,28,180,208,4758,21:00 - 22:59
fall,2011-08-22,22,32,121,153,4758,21:00 - 22:59
fall,2011-08-22,23,19,45,64,4758,23:00 - 24:59
fall,2011-08-23,0,13,22,35,5895,
fall,2011-08-23,1,6,13,19,5895,01:00 - 02:59
fall,2011-08-23,2,2,4,6,5895,01:00 - 02:59
fall,2011-08-23,3,2,4,6,5895,03:00 - 04:59
fall,2011-08-23,4,0,5,5,5895,03:00 - 04:59
fall,2011-08-23,5,1,35,36,5895,05:00 - 06:59
fall,2011-08-23,6,3,111,114,5895,05:00 - 06:59
fall,2011-08-23,7,11,333,344,5895,07:00 - 08:59
fall,2011-08-23,8,43,461,504,5895,07:00 - 08:59
fall,2011-08-23,9,34,191,225,5895,09:00 - 10:59
fall,2011-08-23,10,56,92,148,5895,09:00 - 10:59
fall,2011-08-23,11,62,124,186,5895,11:00 - 12:59
fall,2011-08-23,12,60,177,237,5895,11:00 - 12:59
fall,2011-08-23,13,70,164,234,5895,13:00 - 14:59
fall,2011-08-23,14,149,502,651,5895,13:00 - 14:59
fall,2011-08-23,15,178,423,601,5895,15:00 - 16:59
fall,2011-08-23,16,133,311,444,5895,15:00 - 16:59
fall,2011-08-23,17,133,339,472,5895,17:00 - 18:59
fall,2011-08-23,18,98,421,519,5895,17:00 - 18:59
fall,2011-08-23,19,70,297,367,5895,19:00 - 20:59
fall,2011-08-23,20,54,206,260,5895,19:00 - 20:59
fall,2011-08-23,21,38,173,211,5895,21:00 - 22:59
fall,2011-08-23,22,46,145,191,5895,21:00 - 22:59
fall,2011-08-23,23,19,61,80,5895,23:00 - 24:59
fall,2011-08-24,0,9,29,38,5130,
fall,2011-08-24,1,7,17,24,5130,01:00 - 02:59
fall,2011-08-24,2,2,4,6,5130,01:00 - 02:59
fall,2011-08-24,3,0,1,1,5130,03:00 - 04:59
fall,2011-08-24,4,0,7,7,5130,03:00 - 04:59
fall,2011-08-24,5,1,26,27,5130,05:00 - 06:59
fall,2011-08-24,6,3,105,108,5130,05:00 - 06:59
fall,2011-08-24,7,11,297,308,5130,07:00 - 08:59
fall,2011-08-24,8,32,436,468,5130,07:00 - 08:59
fall,2011-08-24,9,44,169,213,5130,09:00 - 10:59
fall,2011-08-24,10,51,95,146,5130,09:00 - 10:59
fall,2011-08-24,11,57,128,185,5130,11:00 - 12:59
fall,2011-08-24,12,60,175,235,5130,11:00 - 12:59
fall,2011-08-24,13,56,180,236,5130,13:00 - 14:59
fall,2011-08-24,14,77,127,204,5130,13:00 - 14:59
fall,2011-08-24,15,63,141,204,5130,15:00 - 16:59
fall,2011-08-24,16,49,222,271,5130,15:00 - 16:59
fall,2011-08-24,17,83,484,567,5130,17:00 - 18:59
fall,2011-08-24,18,102,519,621,5130,17:00 - 18:59
fall,2011-08-24,19,93,347,440,5130,19:00 - 20:59
fall,2011-08-24,20,45,289,334,5130,19:00 - 20:59
fall,2011-08-24,21,47,189,236,5130,21:00 - 22:59
fall,2011-08-24,22,41,140,181,5130,21:00 - 22:59
fall,2011-08-24,23,16,54,70,5130,23:00 - 24:59
fall,2011-08-25,0,11,41,52,3542,
fall,2011-08-25,1,4,11,15,3542,01:00 - 02:59
fall,2011-08-25,2,3,2,5,3542,01:00 - 02:59
fall,2011-08-25,3,2,2,4,3542,03:00 - 04:59
fall,2011-08-25,4,1,6,7,3542,03:00 - 04:59
fall,2011-08-25,5,1,25,26,3542,05:00 - 06:59
fall,2011-08-25,6,1,101,102,3542,05:00 - 06:59
fall,2011-08-25,7,17,296,313,3542,07:00 - 08:59
fall,2011-08-25,8,23,461,484,3542,07:00 - 08:59
fall,2011-08-25,9,21,141,162,3542,09:00 - 10:59
fall,2011-08-25,10,37,105,142,3542,09:00 - 10:59
fall,2011-08-25,11,39,112,151,3542,11:00 - 12:59
fall,2011-08-25,12,9,32,41,3542,11:00 - 12:59
fall,2011-08-25,13,7,30,37,3542,13:00 - 14:59
fall,2011-08-25,14,27,86,113,3542,13:00 - 14:59
fall,2011-08-25,15,28,104,132,3542,15:00 - 16:59
fall,2011-08-25,16,16,105,121,3542,15:00 - 16:59
fall,2011-08-25,17,28,284,312,3542,17:00 - 18:59
fall,2011-08-25,18,31,377,408,3542,17:00 - 18:59
fall,2011-08-25,19,31,241,272,3542,19:00 - 20:59
fall,2011-08-25,20,33,192,225,3542,19:00 - 20:59
fall,2011-08-25,21,29,158,187,3542,21:00 - 22:59
fall,2011-08-25,22,21,126,147,3542,21:00 - 22:59
fall,2011-08-25,23,15,69,84,3542,23:00 - 24:59
fall,2011-08-26,0,9,42,51,4661,
fall,2011-08-26,1,10,13,23,4661,01:00 - 02:59
fall,2011-08-26,2,4,16,20,4661,01:00 - 02:59
fall,2011-08-26,3,3,8,11,4661,03:00 - 04:59
fall,2011-08-26,4,2,6,8,4661,03:00 - 04:59
fall,2011-08-26,5,3,23,26,4661,05:00 - 06:59
fall,2011-08-26,6,5,100,105,4661,05:00 - 06:59
fall,2011-08-26,7,3,263,266,4661,07:00 - 08:59
fall,2011-08-26,8,17,387,404,4661,07:00 - 08:59
fall,2011-08-26,9,39,191,230,4661,09:00 - 10:59
fall,2011-08-26,10,34,89,123,4661,09:00 - 10:59
fall,2011-08-26,11,63,151,214,4661,11:00 - 12:59
fall,2011-08-26,12,70,173,243,4661,11:00 - 12:59
fall,2011-08-26,13,72,165,237,4661,13:00 - 14:59
fall,2011-08-26,14,55,164,219,4661,13:00 - 14:59
fall,2011-08-26,15,53,196,249,4661,15:00 - 16:59
fall,2011-08-26,16,50,293,343,4661,15:00 - 16:59
fall,2011-08-26,17,56,433,489,4661,17:00 - 18:59
fall,2011-08-26,18,40,370,410,4661,17:00 - 18:59
fall,2011-08-26,19,55,235,290,4661,19:00 - 20:59
fall,2011-08-26,20,39,183,222,4661,19:00 - 20:59
fall,2011-08-26,21,38,152,190,4661,21:00 - 22:59
fall,2011-08-26,22,26,126,152,4661,21:00 - 22:59
fall,2011-08-26,23,22,114,136,4661,23:00 - 24:59
fall,2011-08-27,0,33,112,145,1115,
fall,2011-08-27,1,13,51,64,1115,01:00 - 02:59
fall,2011-08-27,2,18,59,77,1115,01:00 - 02:59
fall,2011-08-27,3,8,22,30,1115,03:00 - 04:59
fall,2011-08-27,4,1,3,4,1115,03:00 - 04:59
fall,2011-08-27,5,1,11,12,1115,05:00 - 06:59
fall,2011-08-27,6,3,15,18,1115,05:00 - 06:59
fall,2011-08-27,7,2,26,28,1115,07:00 - 08:59
fall,2011-08-27,8,14,62,76,1115,07:00 - 08:59
fall,2011-08-27,9,28,128,156,1115,09:00 - 10:59
fall,2011-08-27,10,51,154,205,1115,09:00 - 10:59
fall,2011-08-27,11,15,73,88,1115,11:00 - 12:59
fall,2011-08-27,12,11,65,76,1115,11:00 - 12:59
fall,2011-08-27,13,10,33,43,1115,13:00 - 14:59
fall,2011-08-27,14,4,19,23,1115,13:00 - 14:59
fall,2011-08-27,15,2,28,30,1115,15:00 - 16:59
fall,2011-08-27,16,10,14,24,1115,15:00 - 16:59
fall,2011-08-27,17,2,14,16,1115,17:00 - 18:59
fall,2011-08-28,7,0,1,1,4334,07:00 - 08:59
fall,2011-08-28,8,2,6,8,4334,07:00 - 08:59
fall,2011-08-28,9,7,46,53,4334,09:00 - 10:59
fall,2011-08-28,10,27,115,142,4334,09:00 - 10:59
fall,2011-08-28,11,59,178,237,4334,11:00 - 12:59
fall,2011-08-28,12,88,218,306,4334,11:00 - 12:59
fall,2011-08-28,13,129,302,431,4334,13:00 - 14:59
fall,2011-08-28,14,157,290,447,4334,13:00 - 14:59
fall,2011-08-28,15,155,314,469,4334,15:00 - 16:59
fall,2011-08-28,16,196,295,491,4334,15:00 - 16:59
fall,2011-08-28,17,145,253,398,4334,17:00 - 18:59
fall,2011-08-28,18,145,257,402,4334,17:00 - 18:59
fall,2011-08-28,19,140,247,387,4334,19:00 - 20:59
fall,2011-08-28,20,64,150,214,4334,19:00 - 20:59
fall,2011-08-28,21,60,126,186,4334,21:00 - 22:59
fall,2011-08-28,22,25,73,98,4334,21:00 - 22:59
fall,2011-08-28,23,16,48,64,4334,23:00 - 24:59
fall,2011-08-29,0,13,21,34,4634,
fall,2011-08-29,1,5,15,20,4634,01:00 - 02:59
fall,2011-08-29,2,8,5,13,4634,01:00 - 02:59
fall,2011-08-29,3,1,5,6,4634,03:00 - 04:59
fall,2011-08-29,4,0,3,3,4634,03:00 - 04:59
fall,2011-08-29,5,0,17,17,4634,05:00 - 06:59
fall,2011-08-29,6,3,99,102,4634,05:00 - 06:59
fall,2011-08-29,7,11,273,284,4634,07:00 - 08:59
fall,2011-08-29,8,20,384,404,4634,07:00 - 08:59
fall,2011-08-29,9,22,166,188,4634,09:00 - 10:59
fall,2011-08-29,10,42,73,115,4634,09:00 - 10:59
fall,2011-08-29,11,38,100,138,4634,11:00 - 12:59
fall,2011-08-29,12,48,159,207,4634,11:00 - 12:59
fall,2011-08-29,13,48,170,218,4634,13:00 - 14:59
fall,2011-08-29,14,55,127,182,4634,13:00 - 14:59
fall,2011-08-29,15,56,164,220,4634,15:00 - 16:59
fall,2011-08-29,16,56,226,282,4634,15:00 - 16:59
fall,2011-08-29,17,67,524,591,4634,17:00 - 18:59
fall,2011-08-29,18,60,487,547,4634,17:00 - 18:59
fall,2011-08-29,19,50,317,367,4634,19:00 - 20:59
fall,2011-08-29,20,50,227,277,4634,19:00 - 20:59
fall,2011-08-29,21,34,168,202,4634,21:00 - 22:59
fall,2011-08-29,22,23,119,142,4634,21:00 - 22:59
fall,2011-08-29,23,19,56,75,4634,23:00 - 24:59
fall,2011-08-30,0,10,17,27,5204,
fall,2011-08-30,1,6,7,13,5204,01:00 - 02:59
fall,2011-08-30,2,2,8,10,5204,01:00 - 02:59
fall,2011-08-30,3,2,2,4,5204,03:00 - 04:59
fall,2011-08-30,4,0,6,6,5204,03:00 - 04:59
fall,2011-08-30,5,1,27,28,5204,05:00 - 06:59
fall,2011-08-30,6,4,115,119,5204,05:00 - 06:59
fall,2011-08-30,7,19,338,357,5204,07:00 - 08:59
fall,2011-08-30,8,34,459,493,5204,07:00 - 08:59
fall,2011-08-30,9,38,180,218,5204,09:00 - 10:59
fall,2011-08-30,10,28,109,137,5204,09:00 - 10:59
fall,2011-08-30,11,60,115,175,5204,11:00 - 12:59
fall,2011-08-30,12,65,172,237,5204,11:00 - 12:59
fall,2011-08-30,13,59,170,229,5204,13:00 - 14:59
fall,2011-08-30,14,58,151,209,5204,13:00 - 14:59
fall,2011-08-30,15,34,162,196,5204,15:00 - 16:59
fall,2011-08-30,16,42,295,337,5204,15:00 - 16:59
fall,2011-08-30,17,62,549,611,5204,17:00 - 18:59
fall,2011-08-30,18,60,516,576,5204,17:00 - 18:59
fall,2011-08-30,19,68,397,465,5204,19:00 - 20:59
fall,2011-08-30,20,39,259,298,5204,19:00 - 20:59
fall,2011-08-30,21,43,180,223,5204,21:00 - 22:59
fall,2011-08-30,22,22,121,143,5204,21:00 - 22:59
fall,2011-08-30,23,19,74,93,5204,23:00 - 24:59
fall,2011-08-31,0,8,24,32,5058,
fall,2011-08-31,1,2,13,15,5058,01:00 - 02:59
fall,2011-08-31,2,1,5,6,5058,01:00 - 02:59
fall,2011-08-31,3,2,4,6,5058,03:00 - 04:59
fall,2011-08-31,4,0,5,5,5058,03:00 - 04:59
fall,2011-08-31,5,2,25,27,5058,05:00 - 06:59
fall,2011-08-31,6,4,107,111,5058,05:00 - 06:59
fall,2011-08-31,7,12,316,328,5058,07:00 - 08:59
fall,2011-08-31,8,27,440,467,5058,07:00 - 08:59
fall,2011-08-31,9,27,217,244,5058,09:00 - 10:59
fall,2011-08-31,10,33,105,138,5058,09:00 - 10:59
fall,2011-08-31,11,28,143,171,5058,11:00 - 12:59
fall,2011-08-31,12,68,192,260,5058,11:00 - 12:59
fall,2011-08-31,13,39,182,221,5058,13:00 - 14:59
fall,2011-08-31,14,48,148,196,5058,13:00 - 14:59
fall,2011-08-31,15,34,138,172,5058,15:00 - 16:59
fall,2011-08-31,16,46,263,309,5058,15:00 - 16:59
fall,2011-08-31,17,83,525,608,5058,17:00 - 18:59
fall,2011-08-31,18,70,495,565,5058,17:00 - 18:59
fall,2011-08-31,19,53,393,446,5058,19:00 - 20:59
fall,2011-08-31,20,30,259,289,5058,19:00 - 20:59
fall,2011-08-31,21,27,174,201,5058,21:00 - 22:59
fall,2011-08-31,22,20,137,157,5058,21:00 - 22:59
fall,2011-08-31,23,24,60,84,5058,23:00 - 24:59
fall,2011-09-01,0,18,33,51,5115,
fall,2011-09-01,1,7,14,21,5115,01:00 - 02:59
fall,2011-09-01,2,14,11,25,5115,01:00 - 02:59
fall,2011-09-01,3,7,7,14,5115,03:00 - 04:59
fall,2011-09-01,4,0,7,7,5115,03:00 - 04:59
fall,2011-09-01,5,1,22,23,5115,05:00 - 06:59
fall,2011-09-01,6,2,103,105,5115,05:00 - 06:59
fall,2011-09-01,7,7,335,342,5115,07:00 - 08:59
fall,2011-09-01,8,31,467,498,5115,07:00 - 08:59
fall,2011-09-01,9,29,178,207,5115,09:00 - 10:59
fall,2011-09-01,10,46,92,138,5115,09:00 - 10:59
fall,2011-09-01,11,51,141,192,5115,11:00 - 12:59
fall,2011-09-01,12,64,165,229,5115,11:00 - 12:59
fall,2011-09-01,13,50,169,219,5115,13:00 - 14:59
fall,2011-09-01,14,54,144,198,5115,13:00 - 14:59
fall,2011-09-01,15,39,135,174,5115,15:00 - 16:59
fall,2011-09-01,16,55,253,308,5115,15:00 - 16:59
fall,2011-09-01,17,61,567,628,5115,17:00 - 18:59
fall,2011-09-01,18,69,462,531,5115,17:00 - 18:59
fall,2011-09-01,19,79,364,443,5115,19:00 - 20:59
fall,2011-09-01,20,33,247,280,5115,19:00 - 20:59
fall,2011-09-01,21,17,160,177,5115,21:00 - 22:59
fall,2011-09-01,22,34,145,179,5115,21:00 - 22:59
fall,2011-09-01,23,15,111,126,5115,23:00 - 24:59
fall,2011-09-02,0,6,58,64,4727,
fall,2011-09-02,1,4,28,32,4727,01:00 - 02:59
fall,2011-09-02,2,9,11,20,4727,01:00 - 02:59
fall,2011-09-02,3,4,4,8,4727,03:00 - 04:59
fall,2011-09-02,4,2,2,4,4727,03:00 - 04:59
fall,2011-09-02,5,0,20,20,4727,05:00 - 06:59
fall,2011-09-02,6,3,73,76,4727,05:00 - 06:59
fall,2011-09-02,7,6,253,259,4727,07:00 - 08:59
fall,2011-09-02,8,22,434,456,4727,07:00 - 08:59
fall,2011-09-02,9,30,190,220,4727,09:00 - 10:59
fall,2011-09-02,10,34,106,140,4727,09:00 - 10:59
fall,2011-09-02,11,51,141,192,4727,11:00 - 12:59
fall,2011-09-02,12,82,178,260,4727,11:00 - 12:59
fall,2011-09-02,13,72,207,279,4727,13:00 - 14:59
fall,2011-09-02,14,75,208,283,4727,13:00 - 14:59
fall,2011-09-02,15,69,277,346,4727,15:00 - 16:59
fall,2011-09-02,16,82,299,381,4727,15:00 - 16:59
fall,2011-09-02,17,78,377,455,4727,17:00 - 18:59
fall,2011-09-02,18,50,305,355,4727,17:00 - 18:59
fall,2011-09-02,19,67,220,287,4727,19:00 - 20:59
fall,2011-09-02,20,38,158,196,4727,19:00 - 20:59
fall,2011-09-02,21,28,121,149,4727,21:00 - 22:59
fall,2011-09-02,22,33,114,147,4727,21:00 - 22:59
fall,2011-09-02,23,30,68,98,4727,23:00 - 24:59
fall,2011-09-03,0,22,65,87,4484,
fall,2011-09-03,1,17,57,74,4484,01:00 - 02:59
fall,2011-09-03,2,15,26,41,4484,01:00 - 02:59
fall,2011-09-03,3,17,18,35,4484,03:00 - 04:59
fall,2011-09-03,4,3,4,7,4484,03:00 - 04:59
fall,2011-09-03,5,3,9,12,4484,05:00 - 06:59
fall,2011-09-03,6,4,19,23,4484,05:00 - 06:59
fall,2011-09-03,7,5,33,38,4484,07:00 - 08:59
fall,2011-09-03,8,24,65,89,4484,07:00 - 08:59
fall,2011-09-03,9,83,118,201,4484,09:00 - 10:59
fall,2011-09-03,10,90,168,258,4484,09:00 - 10:59
fall,2011-09-03,11,66,128,194,4484,11:00 - 12:59
fall,2011-09-03,12,97,160,257,4484,11:00 - 12:59
fall,2011-09-03,13,153,200,353,4484,13:00 - 14:59
fall,2011-09-03,14,204,176,380,4484,13:00 - 14:59
fall,2011-09-03,15,187,201,388,4484,15:00 - 16:59
fall,2011-09-03,16,186,188,374,4484,15:00 - 16:59
fall,2011-09-03,17,170,201,371,4484,17:00 - 18:59
fall,2011-09-03,18,160,179,339,4484,17:00 - 18:59
fall,2011-09-03,19,147,148,295,4484,19:00 - 20:59
fall,2011-09-03,20,99,120,219,4484,19:00 - 20:59
fall,2011-09-03,21,71,93,164,4484,21:00 - 22:59
fall,2011-09-03,22,66,96,162,4484,21:00 - 22:59
fall,2011-09-03,23,46,77,123,4484,23:00 - 24:59
fall,2011-09-04,0,33,76,109,4940,
fall,2011-09-04,1,37,38,75,4940,01:00 - 02:59
fall,2011-09-04,2,17,43,60,4940,01:00 - 02:59
fall,2011-09-04,3,20,23,43,4940,03:00 - 04:59
fall,2011-09-04,4,0,4,4,4940,03:00 - 04:59
fall,2011-09-04,5,1,5,6,4940,05:00 - 06:59
fall,2011-09-04,6,0,3,3,4940,05:00 - 06:59
fall,2011-09-04,7,10,20,30,4940,07:00 - 08:59
fall,2011-09-04,8,21,49,70,4940,07:00 - 08:59
fall,2011-09-04,9,87,102,189,4940,09:00 - 10:59
fall,2011-09-04,10,150,147,297,4940,09:00 - 10:59
fall,2011-09-04,11,174,163,337,4940,11:00 - 12:59
fall,2011-09-04,12,214,221,435,4940,11:00 - 12:59
fall,2011-09-04,13,245,174,419,4940,13:00 - 14:59
fall,2011-09-04,14,205,156,361,4940,13:00 - 14:59
fall,2011-09-04,15,218,192,410,4940,15:00 - 16:59
fall,2011-09-04,16,196,141,337,4940,15:00 - 16:59
fall,2011-09-04,17,204,172,376,4940,17:00 - 18:59
fall,2011-09-04,18,187,169,356,4940,17:00 - 18:59
fall,2011-09-04,19,178,150,328,4940,19:00 - 20:59
fall,2011-09-04,20,104,125,229,4940,19:00 - 20:59
fall,2011-09-04,21,104,103,207,4940,21:00 - 22:59
fall,2011-09-04,22,70,85,155,4940,21:00 - 22:59
fall,2011-09-04,23,46,58,104,4940,23:00 - 24:59
fall,2011-09-05,0,31,66,97,3351,
fall,2011-09-05,1,19,35,54,3351,01:00 - 02:59
fall,2011-09-05,2,17,22,39,3351,01:00 - 02:59
fall,2011-09-05,3,4,12,16,3351,03:00 - 04:59
fall,2011-09-05,4,3,5,8,3351,03:00 - 04:59
fall,2011-09-05,5,2,4,6,3351,05:00 - 06:59
fall,2011-09-05,6,6,5,11,3351,05:00 - 06:59
fall,2011-09-05,7,11,30,41,3351,07:00 - 08:59
fall,2011-09-05,8,45,56,101,3351,07:00 - 08:59
fall,2011-09-05,9,63,89,152,3351,09:00 - 10:59
fall,2011-09-05,10,107,137,244,3351,09:00 - 10:59
fall,2011-09-05,11,101,207,308,3351,11:00 - 12:59
fall,2011-09-05,12,141,212,353,3351,11:00 - 12:59
fall,2011-09-05,13,154,235,389,3351,13:00 - 14:59
fall,2011-09-05,14,145,212,357,3351,13:00 - 14:59
fall,2011-09-05,15,111,142,253,3351,15:00 - 16:59
fall,2011-09-05,16,92,192,284,3351,15:00 - 16:59
fall,2011-09-05,17,37,77,114,3351,17:00 - 18:59
fall,2011-09-05,18,31,92,123,3351,17:00 - 18:59
fall,2011-09-05,19,52,123,175,3351,19:00 - 20:59
fall,2011-09-05,20,26,56,82,3351,19:00 - 20:59
fall,2011-09-05,21,20,40,60,3351,21:00 - 22:59
fall,2011-09-05,22,15,49,64,3351,21:00 - 22:59
fall,2011-09-05,23,3,17,20,3351,23:00 - 24:59
fall,2011-09-06,0,1,7,8,2710,
fall,2011-09-06,2,0,2,2,2710,01:00 - 02:59
fall,2011-09-06,3,1,0,1,2710,03:00 - 04:59
fall,2011-09-06,4,1,3,4,2710,03:00 - 04:59
fall,2011-09-06,5,1,20,21,2710,05:00 - 06:59
fall,2011-09-06,6,0,72,72,2710,05:00 - 06:59
fall,2011-09-06,7,6,166,172,2710,07:00 - 08:59
fall,2011-09-06,8,15,349,364,2710,07:00 - 08:59
fall,2011-09-06,9,18,167,185,2710,09:00 - 10:59
fall,2011-09-06,10,16,90,106,2710,09:00 - 10:59
fall,2011-09-06,11,11,78,89,2710,11:00 - 12:59
fall,2011-09-06,12,16,51,67,2710,11:00 - 12:59
fall,2011-09-06,13,5,24,29,2710,13:00 - 14:59
fall,2011-09-06,14,3,21,24,2710,13:00 - 14:59
fall,2011-09-06,15,18,71,89,2710,15:00 - 16:59
fall,2011-09-06,16,11,95,106,2710,15:00 - 16:59
fall,2011-09-06,17,15,276,291,2710,17:00 - 18:59
fall,2011-09-06,18,22,351,373,2710,17:00 - 18:59
fall,2011-09-06,19,12,269,281,2710,19:00 - 20:59
fall,2011-09-06,20,13,150,163,2710,19:00 - 20:59
fall,2011-09-06,21,12,109,121,2710,21:00 - 22:59
fall,2011-09-06,22,5,79,84,2710,21:00 - 22:59
fall,2011-09-06,23,2,56,58,2710,23:00 - 24:59
fall,2011-09-07,0,1,12,13,1996,
fall,2011-09-07,1,2,3,5,1996,01:00 - 02:59
fall,2011-09-07,2,2,4,6,1996,01:00 - 02:59
fall,2011-09-07,3,1,1,2,1996,03:00 - 04:59
fall,2011-09-07,4,0,4,4,1996,03:00 - 04:59
fall,2011-09-07,5,1,15,16,1996,05:00 - 06:59
fall,2011-09-07,6,1,74,75,1996,05:00 - 06:59
fall,2011-09-07,7,3,83,86,1996,07:00 - 08:59
fall,2011-09-07,8,9,319,328,1996,07:00 - 08:59
fall,2011-09-07,9,14,176,190,1996,09:00 - 10:59
fall,2011-09-07,10,3,63,66,1996,09:00 - 10:59
fall,2011-09-07,11,1,9,10,1996,11:00 - 12:59
fall,2011-09-07,12,1,21,22,1996,11:00 - 12:59
fall,2011-09-07,13,2,9,11,1996,13:00 - 14:59
fall,2011-09-07,14,1,24,25,1996,13:00 - 14:59
fall,2011-09-07,15,3,55,58,1996,15:00 - 16:59
fall,2011-09-07,16,7,137,144,1996,15:00 - 16:59
fall,2011-09-07,17,21,264,285,1996,17:00 - 18:59
fall,2011-09-07,18,18,219,237,1996,17:00 - 18:59
fall,2011-09-07,19,14,212,226,1996,19:00 - 20:59
fall,2011-09-07,20,3,93,96,1996,19:00 - 20:59
fall,2011-09-07,21,4,34,38,1996,21:00 - 22:59
fall,2011-09-07,22,3,26,29,1996,21:00 - 22:59
fall,2011-09-07,23,3,21,24,1996,23:00 - 24:59
fall,2011-09-08,0,3,11,14,1842,
fall,2011-09-08,1,0,4,4,1842,01:00 - 02:59
fall,2011-09-08,3,0,2,2,1842,03:00 - 04:59
fall,2011-09-08,4,0,3,3,1842,03:00 - 04:59
fall,2011-09-08,5,1,13,14,1842,05:00 - 06:59
fall,2011-09-08,6,1,55,56,1842,05:00 - 06:59
fall,2011-09-08,7,7,172,179,1842,07:00 - 08:59
fall,2011-09-08,8,7,188,195,1842,07:00 - 08:59
fall,2011-09-08,9,4,65,69,1842,09:00 - 10:59
fall,2011-09-08,10,8,57,65,1842,09:00 - 10:59
fall,2011-09-08,11,16,82,98,1842,11:00 - 12:59
fall,2011-09-08,12,17,85,102,1842,11:00 - 12:59
fall,2011-09-08,13,14,112,126,1842,13:00 - 14:59
fall,2011-09-08,14,15,105,120,1842,13:00 - 14:59
fall,2011-09-08,15,24,115,139,1842,15:00 - 16:59
fall,2011-09-08,16,5,151,156,1842,15:00 - 16:59
fall,2011-09-08,17,11,102,113,1842,17:00 - 18:59
fall,2011-09-08,18,2,66,68,1842,17:00 - 18:59
fall,2011-09-08,19,1,51,52,1842,19:00 - 20:59
fall,2011-09-08,20,6,83,89,1842,19:00 - 20:59
fall,2011-09-08,21,6,76,82,1842,21:00 - 22:59
fall,2011-09-08,22,5,65,70,1842,21:00 - 22:59
fall,2011-09-08,23,0,26,26,1842,23:00 - 24:59
fall,2011-09-09,0,1,15,16,3544,
fall,2011-09-09,1,0,8,8,3544,01:00 - 02:59
fall,2011-09-09,2,1,7,8,3544,01:00 - 02:59
fall,2011-09-09,3,1,1,2,3544,03:00 - 04:59
fall,2011-09-09,4,0,3,3,3544,03:00 - 04:59
fall,2011-09-09,5,0,14,14,3544,05:00 - 06:59
fall,2011-09-09,6,3,54,57,3544,05:00 - 06:59
fall,2011-09-09,7,4,104,108,3544,07:00 - 08:59
fall,2011-09-09,8,12,276,288,3544,07:00 - 08:59
fall,2011-09-09,9,5,131,136,3544,09:00 - 10:59
fall,2011-09-09,10,2,27,29,3544,09:00 - 10:59
fall,2011-09-09,11,6,66,72,3544,11:00 - 12:59
fall,2011-09-09,12,4,71,75,3544,11:00 - 12:59
fall,2011-09-09,13,14,108,122,3544,13:00 - 14:59
fall,2011-09-09,14,29,119,148,3544,13:00 - 14:59
fall,2011-09-09,15,27,161,188,3544,15:00 - 16:59
fall,2011-09-09,16,41,244,285,3544,15:00 - 16:59
fall,2011-09-09,17,54,451,505,3544,17:00 - 18:59
fall,2011-09-09,18,33,377,410,3544,17:00 - 18:59
fall,2011-09-09,19,33,316,349,3544,19:00 - 20:59
fall,2011-09-09,20,30,180,210,3544,19:00 - 20:59
fall,2011-09-09,21,49,154,203,3544,21:00 - 22:59
fall,2011-09-09,22,33,127,160,3544,21:00 - 22:59
fall,2011-09-09,23,35,113,148,3544,23:00 - 24:59
fall,2011-09-10,0,32,84,116,5345,
fall,2011-09-10,1,16,67,83,5345,01:00 - 02:59
fall,2011-09-10,2,18,46,64,5345,01:00 - 02:59
fall,2011-09-10,3,8,29,37,5345,03:00 - 04:59
fall,2011-09-10,4,3,4,7,5345,03:00 - 04:59
fall,2011-09-10,5,2,6,8,5345,05:00 - 06:59
fall,2011-09-10,6,0,6,6,5345,05:00 - 06:59
fall,2011-09-10,7,9,43,52,5345,07:00 - 08:59
fall,2011-09-10,8,16,103,119,5345,07:00 - 08:59
fall,2011-09-10,9,39,168,207,5345,09:00 - 10:59
fall,2011-09-10,10,85,233,318,5345,09:00 - 10:59
fall,2011-09-10,11,108,252,360,5345,11:00 - 12:59
fall,2011-09-10,12,144,260,404,5345,11:00 - 12:59
fall,2011-09-10,13,131,239,370,5345,13:00 - 14:59
fall,2011-09-10,14,129,230,359,5345,13:00 - 14:59
fall,2011-09-10,15,217,263,480,5345,15:00 - 16:59
fall,2011-09-10,16,170,261,431,5345,15:00 - 16:59
fall,2011-09-10,17,185,275,460,5345,17:00 - 18:59
fall,2011-09-10,18,119,241,360,5345,17:00 - 18:59
fall,2011-09-10,19,101,214,315,5345,19:00 - 20:59
fall,2011-09-10,20,78,167,245,5345,19:00 - 20:59
fall,2011-09-10,21,59,171,230,5345,21:00 - 22:59
fall,2011-09-10,22,49,126,175,5345,21:00 - 22:59
fall,2011-09-10,23,32,107,139,5345,23:00 - 24:59
fall,2011-09-11,0,29,79,108,5046,
fall,2011-09-11,1,22,66,88,5046,01:00 - 02:59
fall,2011-09-11,2,16,60,76,5046,01:00 - 02:59
fall,2011-09-11,3,15,30,45,5046,03:00 - 04:59
fall,2011-09-11,4,3,6,9,5046,03:00 - 04:59
fall,2011-09-11,5,15,24,39,5046,05:00 - 06:59
fall,2011-09-11,6,4,16,20,5046,05:00 - 06:59
fall,2011-09-11,7,9,28,37,5046,07:00 - 08:59
fall,2011-09-11,8,25,69,94,5046,07:00 - 08:59
fall,2011-09-11,9,59,168,227,5046,09:00 - 10:59
fall,2011-09-11,10,120,214,334,5046,09:00 - 10:59
fall,2011-09-11,11,144,258,402,5046,11:00 - 12:59
fall,2011-09-11,12,113,298,411,5046,11:00 - 12:59
fall,2011-09-11,13,119,231,350,5046,13:00 - 14:59
fall,2011-09-11,14,120,222,342,5046,13:00 - 14:59
fall,2011-09-11,15,134,270,404,5046,15:00 - 16:59
fall,2011-09-11,16,180,303,483,5046,15:00 - 16:59
fall,2011-09-11,17,152,228,380,5046,17:00 - 18:59
fall,2011-09-11,18,110,229,339,5046,17:00 - 18:59
fall,2011-09-11,19,101,232,333,5046,19:00 - 20:59
fall,2011-09-11,20,65,161,226,5046,19:00 - 20:59
fall,2011-09-11,21,45,114,159,5046,21:00 - 22:59
fall,2011-09-11,22,21,74,95,5046,21:00 - 22:59
fall,2011-09-11,23,12,33,45,5046,23:00 - 24:59
fall,2011-09-12,0,5,11,16,4713,
fall,2011-09-12,1,1,11,12,4713,01:00 - 02:59
fall,2011-09-12,2,2,0,2,4713,01:00 - 02:59
fall,2011-09-12,4,0,4,4,4713,03:00 - 04:59
fall,2011-09-12,5,1,23,24,4713,05:00 - 06:59
fall,2011-09-12,6,1,108,109,4713,05:00 - 06:59
fall,2011-09-12,7,12,300,312,4713,07:00 - 08:59
fall,2011-09-12,8,26,382,408,4713,07:00 - 08:59
fall,2011-09-12,9,21,155,176,4713,09:00 - 10:59
fall,2011-09-12,10,40,89,129,4713,09:00 - 10:59
fall,2011-09-12,11,34,131,165,4713,11:00 - 12:59
fall,2011-09-12,12,37,147,184,4713,11:00 - 12:59
fall,2011-09-12,13,43,120,163,4713,13:00 - 14:59
fall,2011-09-12,14,60,129,189,4713,13:00 - 14:59
fall,2011-09-12,15,60,152,212,4713,15:00 - 16:59
fall,2011-09-12,16,60,238,298,4713,15:00 - 16:59
fall,2011-09-12,17,75,515,590,4713,17:00 - 18:59
fall,2011-09-12,18,56,515,571,4713,17:00 - 18:59
fall,2011-09-12,19,63,373,436,4713,19:00 - 20:59
fall,2011-09-12,20,41,258,299,4713,19:00 - 20:59
fall,2011-09-12,21,29,166,195,4713,21:00 - 22:59
fall,2011-09-12,22,16,134,150,4713,21:00 - 22:59
fall,2011-09-12,23,7,62,69,4713,23:00 - 24:59
fall,2011-09-13,0,7,19,26,4763,
fall,2011-09-13,1,4,6,10,4763,01:00 - 02:59
fall,2011-09-13,2,2,0,2,4763,01:00 - 02:59
fall,2011-09-13,3,2,2,4,4763,03:00 - 04:59
fall,2011-09-13,4,2,6,8,4763,03:00 - 04:59
fall,2011-09-13,5,1,19,20,4763,05:00 - 06:59
fall,2011-09-13,6,6,116,122,4763,05:00 - 06:59
fall,2011-09-13,7,14,348,362,4763,07:00 - 08:59
fall,2011-09-13,8,26,399,425,4763,07:00 - 08:59
fall,2011-09-13,9,35,179,214,4763,09:00 - 10:59
fall,2011-09-13,10,42,93,135,4763,09:00 - 10:59
fall,2011-09-13,11,33,120,153,4763,11:00 - 12:59
fall,2011-09-13,12,43,144,187,4763,11:00 - 12:59
fall,2011-09-13,13,48,136,184,4763,13:00 - 14:59
fall,2011-09-13,14,51,139,190,4763,13:00 - 14:59
fall,2011-09-13,15,35,145,180,4763,15:00 - 16:59
fall,2011-09-13,16,41,251,292,4763,15:00 - 16:59
fall,2011-09-13,17,72,507,579,4763,17:00 - 18:59
fall,2011-09-13,18,67,472,539,4763,17:00 - 18:59
fall,2011-09-13,19,55,341,396,4763,19:00 - 20:59
fall,2011-09-13,20,31,241,272,4763,19:00 - 20:59
fall,2011-09-13,21,45,200,245,4763,21:00 - 22:59
fall,2011-09-13,22,24,120,144,4763,21:00 - 22:59
fall,2011-09-13,23,15,59,74,4763,23:00 - 24:59
fall,2011-09-14,0,5,28,33,4785,
fall,2011-09-14,1,1,7,8,4785,01:00 - 02:59
fall,2011-09-14,2,1,4,5,4785,01:00 - 02:59
fall,2011-09-14,3,1,7,8,4785,03:00 - 04:59
fall,2011-09-14,4,1,8,9,4785,03:00 - 04:59
fall,2011-09-14,5,1,30,31,4785,05:00 - 06:59
fall,2011-09-14,6,7,138,145,4785,05:00 - 06:59
fall,2011-09-14,7,20,350,370,4785,07:00 - 08:59
fall,2011-09-14,8,33,396,429,4785,07:00 - 08:59
fall,2011-09-14,9,19,183,202,4785,09:00 - 10:59
fall,2011-09-14,10,27,115,142,4785,09:00 - 10:59
fall,2011-09-14,11,43,121,164,4785,11:00 - 12:59
fall,2011-09-14,12,56,156,212,4785,11:00 - 12:59
fall,2011-09-14,13,39,139,178,4785,13:00 - 14:59
fall,2011-09-14,14,19,105,124,4785,13:00 - 14:59
fall,2011-09-14,15,30,146,176,4785,15:00 - 16:59
fall,2011-09-14,16,36,241,277,4785,15:00 - 16:59
fall,2011-09-14,17,87,512,599,4785,17:00 - 18:59
fall,2011-09-14,18,83,503,586,4785,17:00 - 18:59
fall,2011-09-14,19,44,337,381,4785,19:00 - 20:59
fall,2011-09-14,20,40,221,261,4785,19:00 - 20:59
fall,2011-09-14,21,24,189,213,4785,21:00 - 22:59
fall,2011-09-14,22,20,140,160,4785,21:00 - 22:59
fall,2011-09-14,23,10,62,72,4785,23:00 - 24:59
fall,2011-09-15,0,3,34,37,3659,
fall,2011-09-15,1,0,20,20,3659,01:00 - 02:59
fall,2011-09-15,2,0,5,5,3659,01:00 - 02:59
fall,2011-09-15,3,3,5,8,3659,03:00 - 04:59
fall,2011-09-15,4,2,5,7,3659,03:00 - 04:59
fall,2011-09-15,5,1,30,31,3659,05:00 - 06:59
fall,2011-09-15,6,5,119,124,3659,05:00 - 06:59
fall,2011-09-15,7,17,321,338,3659,07:00 - 08:59
fall,2011-09-15,8,27,364,391,3659,07:00 - 08:59
fall,2011-09-15,9,23,186,209,3659,09:00 - 10:59
fall,2011-09-15,10,25,96,121,3659,09:00 - 10:59
fall,2011-09-15,11,39,120,159,3659,11:00 - 12:59
fall,2011-09-15,12,31,148,179,3659,11:00 - 12:59
fall,2011-09-15,13,38,151,189,3659,13:00 - 14:59
fall,2011-09-15,14,36,134,170,3659,13:00 - 14:59
fall,2011-09-15,15,25,110,135,3659,15:00 - 16:59
fall,2011-09-15,16,29,193,222,3659,15:00 - 16:59
fall,2011-09-15,17,31,230,261,3659,17:00 - 18:59
fall,2011-09-15,18,22,222,244,3659,17:00 - 18:59
fall,2011-09-15,19,20,212,232,3659,19:00 - 20:59
fall,2011-09-15,20,25,223,248,3659,19:00 - 20:59
fall,2011-09-15,21,11,134,145,3659,21:00 - 22:59
fall,2011-09-15,22,7,108,115,3659,21:00 - 22:59
fall,2011-09-15,23,8,61,69,3659,23:00 - 24:59
fall,2011-09-16,0,5,43,48,4760,
fall,2011-09-16,1,7,19,26,4760,01:00 - 02:59
fall,2011-09-16,2,3,7,10,4760,01:00 - 02:59
fall,2011-09-16,3,2,4,6,4760,03:00 - 04:59
fall,2011-09-16,4,1,3,4,4760,03:00 - 04:59
fall,2011-09-16,5,2,30,32,4760,05:00 - 06:59
fall,2011-09-16,6,6,87,93,4760,05:00 - 06:59
fall,2011-09-16,7,16,283,299,4760,07:00 - 08:59
fall,2011-09-16,8,23,386,409,4760,07:00 - 08:59
fall,2011-09-16,9,21,189,210,4760,09:00 - 10:59
fall,2011-09-16,10,36,104,140,4760,09:00 - 10:59
fall,2011-09-16,11,40,139,179,4760,11:00 - 12:59
fall,2011-09-16,12,39,212,251,4760,11:00 - 12:59
fall,2011-09-16,13,55,168,223,4760,13:00 - 14:59
fall,2011-09-16,14,49,176,225,4760,13:00 - 14:59
fall,2011-09-16,15,38,165,203,4760,15:00 - 16:59
fall,2011-09-16,16,67,291,358,4760,15:00 - 16:59
fall,2011-09-16,17,86,480,566,4760,17:00 - 18:59
fall,2011-09-16,18,55,427,482,4760,17:00 - 18:59
fall,2011-09-16,19,59,256,315,4760,19:00 - 20:59
fall,2011-09-16,20,41,184,225,4760,19:00 - 20:59
fall,2011-09-16,21,39,124,163,4760,21:00 - 22:59
fall,2011-09-16,22,32,135,167,4760,21:00 - 22:59
fall,2011-09-16,23,20,106,126,4760,23:00 - 24:59
fall,2011-09-17,0,28,80,108,4511,
fall,2011-09-17,1,28,52,80,4511,01:00 - 02:59
fall,2011-09-17,2,18,61,79,4511,01:00 - 02:59
fall,2011-09-17,3,7,21,28,4511,03:00 - 04:59
fall,2011-09-17,4,1,4,5,4511,03:00 - 04:59
fall,2011-09-17,5,2,3,5,4511,05:00 - 06:59
fall,2011-09-17,6,5,17,22,4511,05:00 - 06:59
fall,2011-09-17,7,4,33,37,4511,07:00 - 08:59
fall,2011-09-17,8,27,81,108,4511,07:00 - 08:59
fall,2011-09-17,9,32,145,177,4511,09:00 - 10:59
fall,2011-09-17,10,72,177,249,4511,09:00 - 10:59
fall,2011-09-17,11,119,248,367,4511,11:00 - 12:59
fall,2011-09-17,12,115,257,372,4511,11:00 - 12:59
fall,2011-09-17,13,124,225,349,4511,13:00 - 14:59
fall,2011-09-17,14,123,174,297,4511,13:00 - 14:59
fall,2011-09-17,15,148,206,354,4511,15:00 - 16:59
fall,2011-09-17,16,116,189,305,4511,15:00 - 16:59
fall,2011-09-17,17,141,218,359,4511,17:00 - 18:59
fall,2011-09-17,18,95,234,329,4511,17:00 - 18:59
fall,2011-09-17,19,70,186,256,4511,19:00 - 20:59
fall,2011-09-17,20,43,133,176,4511,19:00 - 20:59
fall,2011-09-17,21,49,121,170,4511,21:00 - 22:59
fall,2011-09-17,22,31,112,143,4511,21:00 - 22:59
fall,2011-09-17,23,36,100,136,4511,23:00 - 24:59
fall,2011-09-18,0,24,88,112,4274,
fall,2011-09-18,1,13,66,79,4274,01:00 - 02:59
fall,2011-09-18,2,21,68,89,4274,01:00 - 02:59
fall,2011-09-18,3,11,25,36,4274,03:00 - 04:59
fall,2011-09-18,4,1,0,1,4274,03:00 - 04:59
fall,2011-09-18,5,1,5,6,4274,05:00 - 06:59
fall,2011-09-18,6,2,10,12,4274,05:00 - 06:59
fall,2011-09-18,7,15,29,44,4274,07:00 - 08:59
fall,2011-09-18,8,16,53,69,4274,07:00 - 08:59
fall,2011-09-18,9,46,94,140,4274,09:00 - 10:59
fall,2011-09-18,10,82,178,260,4274,09:00 - 10:59
fall,2011-09-18,11,116,201,317,4274,11:00 - 12:59
fall,2011-09-18,12,135,229,364,4274,11:00 - 12:59
fall,2011-09-18,13,162,214,376,4274,13:00 - 14:59
fall,2011-09-18,14,127,184,311,4274,13:00 - 14:59
fall,2011-09-18,15,132,233,365,4274,15:00 - 16:59
fall,2011-09-18,16,134,235,369,4274,15:00 - 16:59
fall,2011-09-18,17,95,230,325,4274,17:00 - 18:59
fall,2011-09-18,18,66,223,289,4274,17:00 - 18:59
fall,2011-09-18,19,54,191,245,4274,19:00 - 20:59
fall,2011-09-18,20,44,136,180,4274,19:00 - 20:59
fall,2011-09-18,21,37,110,147,4274,21:00 - 22:59
fall,2011-09-18,22,9,75,84,4274,21:00 - 22:59
fall,2011-09-18,23,10,44,54,4274,23:00 - 24:59
fall,2011-09-19,0,14,23,37,4539,
fall,2011-09-19,1,3,7,10,4539,01:00 - 02:59
fall,2011-09-19,2,6,7,13,4539,01:00 - 02:59
fall,2011-09-19,3,1,4,5,4539,03:00 - 04:59
fall,2011-09-19,4,2,6,8,4539,03:00 - 04:59
fall,2011-09-19,5,2,26,28,4539,05:00 - 06:59
fall,2011-09-19,6,6,107,113,4539,05:00 - 06:59
fall,2011-09-19,7,20,312,332,4539,07:00 - 08:59
fall,2011-09-19,8,29,391,420,4539,07:00 - 08:59
fall,2011-09-19,9,32,183,215,4539,09:00 - 10:59
fall,2011-09-19,10,21,84,105,4539,09:00 - 10:59
fall,2011-09-19,11,41,98,139,4539,11:00 - 12:59
fall,2011-09-19,12,51,138,189,4539,11:00 - 12:59
fall,2011-09-19,13,53,124,177,4539,13:00 - 14:59
fall,2011-09-19,14,45,143,188,4539,13:00 - 14:59
fall,2011-09-19,15,44,143,187,4539,15:00 - 16:59
fall,2011-09-19,16,55,208,263,4539,15:00 - 16:59
fall,2011-09-19,17,85,483,568,4539,17:00 - 18:59
fall,2011-09-19,18,56,484,540,4539,17:00 - 18:59
fall,2011-09-19,19,41,333,374,4539,19:00 - 20:59
fall,2011-09-19,20,27,204,231,4539,19:00 - 20:59
fall,2011-09-19,21,19,181,200,4539,21:00 - 22:59
fall,2011-09-19,22,25,104,129,4539,21:00 - 22:59
fall,2011-09-19,23,13,55,68,4539,23:00 - 24:59
fall,2011-09-20,0,4,21,25,3641,
fall,2011-09-20,1,3,11,14,3641,01:00 - 02:59
fall,2011-09-20,2,1,4,5,3641,01:00 - 02:59
fall,2011-09-20,3,0,3,3,3641,03:00 - 04:59
fall,2011-09-20,4,2,4,6,3641,03:00 - 04:59
fall,2011-09-20,5,1,21,22,3641,05:00 - 06:59
fall,2011-09-20,6,3,111,114,3641,05:00 - 06:59
fall,2011-09-20,7,23,306,329,3641,07:00 - 08:59
fall,2011-09-20,8,13,196,209,3641,07:00 - 08:59
fall,2011-09-20,9,5,64,69,3641,09:00 - 10:59
fall,2011-09-20,10,4,26,30,3641,09:00 - 10:59
fall,2011-09-20,11,8,48,56,3641,11:00 - 12:59
fall,2011-09-20,12,13,47,60,3641,11:00 - 12:59
fall,2011-09-20,13,22,81,103,3641,13:00 - 14:59
fall,2011-09-20,14,27,85,112,3641,13:00 - 14:59
fall,2011-09-20,15,34,158,192,3641,15:00 - 16:59
fall,2011-09-20,16,23,241,264,3641,15:00 - 16:59
fall,2011-09-20,17,66,445,511,3641,17:00 - 18:59
fall,2011-09-20,18,39,453,492,3641,17:00 - 18:59
fall,2011-09-20,19,43,294,337,3641,19:00 - 20:59
fall,2011-09-20,20,41,212,253,3641,19:00 - 20:59
fall,2011-09-20,21,29,177,206,3641,21:00 - 22:59
fall,2011-09-20,22,23,125,148,3641,21:00 - 22:59
fall,2011-09-20,23,11,70,81,3641,23:00 - 24:59
fall,2011-09-21,0,7,20,27,4352,
fall,2011-09-21,1,0,17,17,4352,01:00 - 02:59
fall,2011-09-21,2,1,5,6,4352,01:00 - 02:59
fall,2011-09-21,3,0,6,6,4352,03:00 - 04:59
fall,2011-09-21,4,2,5,7,4352,03:00 - 04:59
fall,2011-09-21,5,1,30,31,4352,05:00 - 06:59
fall,2011-09-21,6,5,112,117,4352,05:00 - 06:59
fall,2011-09-21,7,18,312,330,4352,07:00 - 08:59
fall,2011-09-21,8,18,444,462,4352,07:00 - 08:59
fall,2011-09-21,9,21,187,208,4352,09:00 - 10:59
fall,2011-09-21,10,30,103,133,4352,09:00 - 10:59
fall,2011-09-21,11,42,138,180,4352,11:00 - 12:59
fall,2011-09-21,12,42,151,193,4352,11:00 - 12:59
fall,2011-09-21,13,37,144,181,4352,13:00 - 14:59
fall,2011-09-21,14,40,139,179,4352,13:00 - 14:59
fall,2011-09-21,15,43,142,185,4352,15:00 - 16:59
fall,2011-09-21,16,51,230,281,4352,15:00 - 16:59
fall,2011-09-21,17,61,475,536,4352,17:00 - 18:59
fall,2011-09-21,18,24,384,408,4352,17:00 - 18:59
fall,2011-09-21,19,30,253,283,4352,19:00 - 20:59
fall,2011-09-21,20,11,149,160,4352,19:00 - 20:59
fall,2011-09-21,21,25,175,200,4352,21:00 - 22:59
fall,2011-09-21,22,15,112,127,4352,21:00 - 22:59
fall,2011-09-21,23,15,80,95,4352,23:00 - 24:59
fall,2011-09-22,0,11,30,41,4795,
fall,2011-09-22,1,5,6,11,4795,01:00 - 02:59
fall,2011-09-22,2,2,8,10,4795,01:00 - 02:59
fall,2011-09-22,3,5,7,12,4795,03:00 - 04:59
fall,2011-09-22,4,0,2,2,4795,03:00 - 04:59
fall,2011-09-22,5,2,28,30,4795,05:00 - 06:59
fall,2011-09-22,6,7,94,101,4795,05:00 - 06:59
fall,2011-09-22,7,16,295,311,4795,07:00 - 08:59
fall,2011-09-22,8,26,389,415,4795,07:00 - 08:59
fall,2011-09-22,9,35,168,203,4795,09:00 - 10:59
fall,2011-09-22,10,19,101,120,4795,09:00 - 10:59
fall,2011-09-22,11,23,142,165,4795,11:00 - 12:59
fall,2011-09-22,12,25,151,176,4795,11:00 - 12:59
fall,2011-09-22,13,38,155,193,4795,13:00 - 14:59
fall,2011-09-22,14,41,142,183,4795,13:00 - 14:59
fall,2011-09-22,15,32,149,181,4795,15:00 - 16:59
fall,2011-09-22,16,39,262,301,4795,15:00 - 16:59
fall,2011-09-22,17,50,513,563,4795,17:00 - 18:59
fall,2011-09-22,18,50,501,551,4795,17:00 - 18:59
fall,2011-09-22,19,32,388,420,4795,19:00 - 20:59
fall,2011-09-22,20,35,250,285,4795,19:00 - 20:59
fall,2011-09-22,21,27,194,221,4795,21:00 - 22:59
fall,2011-09-22,22,21,166,187,4795,21:00 - 22:59
fall,2011-09-22,23,14,99,113,4795,23:00 - 24:59
winter,2011-09-23,0,11,41,52,2395,
winter,2011-09-23,1,2,29,31,2395,01:00 - 02:59
winter,2011-09-23,2,6,14,20,2395,01:00 - 02:59
winter,2011-09-23,3,3,5,8,2395,03:00 - 04:59
winter,2011-09-23,4,6,7,13,2395,03:00 - 04:59
winter,2011-09-23,5,2,20,22,2395,05:00 - 06:59
winter,2011-09-23,6,5,99,104,2395,05:00 - 06:59
winter,2011-09-23,7,14,240,254,2395,07:00 - 08:59
winter,2011-09-23,8,20,297,317,2395,07:00 - 08:59
winter,2011-09-23,9,3,108,111,2395,09:00 - 10:59
winter,2011-09-23,10,7,28,35,2395,09:00 - 10:59
winter,2011-09-23,11,1,20,21,2395,11:00 - 12:59
winter,2011-09-23,12,1,28,29,2395,11:00 - 12:59
winter,2011-09-23,13,7,27,34,2395,13:00 - 14:59
winter,2011-09-23,14,3,21,24,2395,13:00 - 14:59
winter,2011-09-23,15,9,52,61,2395,15:00 - 16:59
winter,2011-09-23,16,5,51,56,2395,15:00 - 16:59
winter,2011-09-23,17,13,86,99,2395,17:00 - 18:59
winter,2011-09-23,18,14,220,234,2395,17:00 - 18:59
winter,2011-09-23,19,16,232,248,2395,19:00 - 20:59
winter,2011-09-23,20,21,158,179,2395,19:00 - 20:59
winter,2011-09-23,21,17,121,138,2395,21:00 - 22:59
winter,2011-09-23,22,31,126,157,2395,21:00 - 22:59
winter,2011-09-23,23,41,107,148,2395,23:00 - 24:59
winter,2011-09-24,0,7,86,93,5423,
winter,2011-09-24,1,18,61,79,5423,01:00 - 02:59
winter,2011-09-24,2,14,54,68,5423,01:00 - 02:59
winter,2011-09-24,3,4,27,31,5423,03:00 - 04:59
winter,2011-09-24,4,1,7,8,5423,03:00 - 04:59
winter,2011-09-24,5,2,3,5,5423,05:00 - 06:59
winter,2011-09-24,6,6,12,18,5423,05:00 - 06:59
winter,2011-09-24,7,12,34,46,5423,07:00 - 08:59
winter,2011-09-24,8,19,102,121,5423,07:00 - 08:59
winter,2011-09-24,9,41,134,175,5423,09:00 - 10:59
winter,2011-09-24,10,90,203,293,5423,09:00 - 10:59
winter,2011-09-24,11,118,268,386,5423,11:00 - 12:59
winter,2011-09-24,12,141,266,407,5423,11:00 - 12:59
winter,2011-09-24,13,170,290,460,5423,13:00 - 14:59
winter,2011-09-24,14,164,226,390,5423,13:00 - 14:59
winter,2011-09-24,15,168,284,452,5423,15:00 - 16:59
winter,2011-09-24,16,167,282,449,5423,15:00 - 16:59
winter,2011-09-24,17,180,246,426,5423,17:00 - 18:59
winter,2011-09-24,18,157,243,400,5423,17:00 - 18:59
winter,2011-09-24,19,77,231,308,5423,19:00 - 20:59
winter,2011-09-24,20,77,166,243,5423,19:00 - 20:59
winter,2011-09-24,21,66,156,222,5423,21:00 - 22:59
winter,2011-09-24,22,50,143,193,5423,21:00 - 22:59
winter,2011-09-24,23,27,123,150,5423,23:00 - 24:59
winter,2011-09-25,0,37,136,173,5010,
winter,2011-09-25,1,31,93,124,5010,01:00 - 02:59
winter,2011-09-25,2,27,79,106,5010,01:00 - 02:59
winter,2011-09-25,3,20,39,59,5010,03:00 - 04:59
winter,2011-09-25,4,3,5,8,5010,03:00 - 04:59
winter,2011-09-25,5,1,2,3,5010,05:00 - 06:59
winter,2011-09-25,6,4,13,17,5010,05:00 - 06:59
winter,2011-09-25,7,15,23,38,5010,07:00 - 08:59
winter,2011-09-25,8,27,59,86,5010,07:00 - 08:59
winter,2011-09-25,9,55,100,155,5010,09:00 - 10:59
winter,2011-09-25,10,85,190,275,5010,09:00 - 10:59
winter,2011-09-25,11,131,230,361,5010,11:00 - 12:59
winter,2011-09-25,12,143,270,413,5010,11:00 - 12:59
winter,2011-09-25,13,122,247,369,5010,13:00 - 14:59
winter,2011-09-25,14,116,231,347,5010,13:00 - 14:59
winter,2011-09-25,15,119,234,353,5010,15:00 - 16:59
winter,2011-09-25,16,144,320,464,5010,15:00 - 16:59
winter,2011-09-25,17,145,275,420,5010,17:00 - 18:59
winter,2011-09-25,18,125,279,404,5010,17:00 - 18:59
winter,2011-09-25,19,87,242,329,5010,19:00 - 20:59
winter,2011-09-25,20,51,135,186,5010,19:00 - 20:59
winter,2011-09-25,21,24,113,137,5010,21:00 - 22:59
winter,2011-09-25,22,20,84,104,5010,21:00 - 22:59
winter,2011-09-25,23,12,67,79,5010,23:00 - 24:59
winter,2011-09-26,0,6,23,29,4630,
winter,2011-09-26,1,3,14,17,4630,01:00 - 02:59
winter,2011-09-26,2,4,4,8,4630,01:00 - 02:59
winter,2011-09-26,3,0,5,5,4630,03:00 - 04:59
winter,2011-09-26,4,2,4,6,4630,03:00 - 04:59
winter,2011-09-26,5,0,25,25,4630,05:00 - 06:59
winter,2011-09-26,6,6,107,113,4630,05:00 - 06:59
winter,2011-09-26,7,17,315,332,4630,07:00 - 08:59
winter,2011-09-26,8,29,326,355,4630,07:00 - 08:59
winter,2011-09-26,9,44,161,205,4630,09:00 - 10:59
winter,2011-09-26,10,37,117,154,4630,09:00 - 10:59
winter,2011-09-26,11,43,116,159,4630,11:00 - 12:59
winter,2011-09-26,12,48,161,209,4630,11:00 - 12:59
winter,2011-09-26,13,48,139,187,4630,13:00 - 14:59
winter,2011-09-26,14,44,110,154,4630,13:00 - 14:59
winter,2011-09-26,15,52,157,209,4630,15:00 - 16:59
winter,2011-09-26,16,74,239,313,4630,15:00 - 16:59
winter,2011-09-26,17,61,509,570,4630,17:00 - 18:59
winter,2011-09-26,18,63,490,553,4630,17:00 - 18:59
winter,2011-09-26,19,36,347,383,4630,19:00 - 20:59
winter,2011-09-26,20,24,227,251,4630,19:00 - 20:59
winter,2011-09-26,21,18,164,182,4630,21:00 - 22:59
winter,2011-09-26,22,14,122,136,4630,21:00 - 22:59
winter,2011-09-26,23,11,64,75,4630,23:00 - 24:59
winter,2011-09-27,0,9,28,37,4120,
winter,2011-09-27,1,4,6,10,4120,01:00 - 02:59
winter,2011-09-27,2,7,4,11,4120,01:00 - 02:59
winter,2011-09-27,3,5,5,10,4120,03:00 - 04:59
winter,2011-09-27,4,5,3,8,4120,03:00 - 04:59
winter,2011-09-27,5,0,24,24,4120,05:00 - 06:59
winter,2011-09-27,6,8,116,124,4120,05:00 - 06:59
winter,2011-09-27,7,15,234,249,4120,07:00 - 08:59
winter,2011-09-27,8,27,400,427,4120,07:00 - 08:59
winter,2011-09-27,9,20,173,193,4120,09:00 - 10:59
winter,2011-09-27,10,21,101,122,4120,09:00 - 10:59
winter,2011-09-27,11,26,97,123,4120,11:00 - 12:59
winter,2011-09-27,12,33,129,162,4120,11:00 - 12:59
winter,2011-09-27,13,29,122,151,4120,13:00 - 14:59
winter,2011-09-27,14,29,123,152,4120,13:00 - 14:59
winter,2011-09-27,15,35,170,205,4120,15:00 - 16:59
winter,2011-09-27,16,33,225,258,4120,15:00 - 16:59
winter,2011-09-27,17,50,480,530,4120,17:00 - 18:59
winter,2011-09-27,18,31,325,356,4120,17:00 - 18:59
winter,2011-09-27,19,26,294,320,4120,19:00 - 20:59
winter,2011-09-27,20,17,221,238,4120,19:00 - 20:59
winter,2011-09-27,21,17,179,196,4120,21:00 - 22:59
winter,2011-09-27,22,19,102,121,4120,21:00 - 22:59
winter,2011-09-27,23,11,82,93,4120,23:00 - 24:59
winter,2011-09-28,0,7,29,36,3907,
winter,2011-09-28,1,1,13,14,3907,01:00 - 02:59
winter,2011-09-28,2,0,9,9,3907,01:00 - 02:59
winter,2011-09-28,3,0,3,3,3907,03:00 - 04:59
winter,2011-09-28,4,1,3,4,3907,03:00 - 04:59
winter,2011-09-28,5,2,20,22,3907,05:00 - 06:59
winter,2011-09-28,6,3,111,114,3907,05:00 - 06:59
winter,2011-09-28,7,8,177,185,3907,07:00 - 08:59
winter,2011-09-28,8,17,270,287,3907,07:00 - 08:59
winter,2011-09-28,9,14,141,155,3907,09:00 - 10:59
winter,2011-09-28,10,20,109,129,3907,09:00 - 10:59
winter,2011-09-28,11,24,127,151,3907,11:00 - 12:59
winter,2011-09-28,12,25,159,184,3907,11:00 - 12:59
winter,2011-09-28,13,24,138,162,3907,13:00 - 14:59
winter,2011-09-28,14,25,145,170,3907,13:00 - 14:59
winter,2011-09-28,15,35,146,181,3907,15:00 - 16:59
winter,2011-09-28,16,39,241,280,3907,15:00 - 16:59
winter,2011-09-28,17,64,527,591,3907,17:00 - 18:59
winter,2011-09-28,18,65,459,524,3907,17:00 - 18:59
winter,2011-09-28,19,57,315,372,3907,19:00 - 20:59
winter,2011-09-28,20,11,91,102,3907,19:00 - 20:59
winter,2011-09-28,21,7,67,74,3907,21:00 - 22:59
winter,2011-09-28,22,19,68,87,3907,21:00 - 22:59
winter,2011-09-28,23,12,59,71,3907,23:00 - 24:59
winter,2011-09-29,0,7,33,40,4839,
winter,2011-09-29,1,3,20,23,4839,01:00 - 02:59
winter,2011-09-29,2,0,2,2,4839,01:00 - 02:59
winter,2011-09-29,3,0,8,8,4839,03:00 - 04:59
winter,2011-09-29,4,2,5,7,4839,03:00 - 04:59
winter,2011-09-29,5,0,22,22,4839,05:00 - 06:59
winter,2011-09-29,6,5,106,111,4839,05:00 - 06:59
winter,2011-09-29,7,14,269,283,4839,07:00 - 08:59
winter,2011-09-29,8,29,402,431,4839,07:00 - 08:59
winter,2011-09-29,9,27,198,225,4839,09:00 - 10:59
winter,2011-09-29,10,24,103,127,4839,09:00 - 10:59
winter,2011-09-29,11,36,122,158,4839,11:00 - 12:59
winter,2011-09-29,12,38,157,195,4839,11:00 - 12:59
winter,2011-09-29,13,36,175,211,4839,13:00 - 14:59
winter,2011-09-29,14,33,134,167,4839,13:00 - 14:59
winter,2011-09-29,15,42,185,227,4839,15:00 - 16:59
winter,2011-09-29,16,64,227,291,4839,15:00 - 16:59
winter,2011-09-29,17,62,527,589,4839,17:00 - 18:59
winter,2011-09-29,18,84,500,584,4839,17:00 - 18:59
winter,2011-09-29,19,36,348,384,4839,19:00 - 20:59
winter,2011-09-29,20,39,234,273,4839,19:00 - 20:59
winter,2011-09-29,21,30,195,225,4839,21:00 - 22:59
winter,2011-09-29,22,25,150,175,4839,21:00 - 22:59
winter,2011-09-29,23,17,64,81,4839,23:00 - 24:59
winter,2011-09-30,0,7,53,60,5202,
winter,2011-09-30,1,5,18,23,5202,01:00 - 02:59
winter,2011-09-30,2,6,9,15,5202,01:00 - 02:59
winter,2011-09-30,3,0,3,3,5202,03:00 - 04:59
winter,2011-09-30,4,2,6,8,5202,03:00 - 04:59
winter,2011-09-30,5,3,23,26,5202,05:00 - 06:59
winter,2011-09-30,6,0,98,98,5202,05:00 - 06:59
winter,2011-09-30,7,14,283,297,5202,07:00 - 08:59
winter,2011-09-30,8,31,425,456,5202,07:00 - 08:59
winter,2011-09-30,9,23,214,237,5202,09:00 - 10:59
winter,2011-09-30,10,46,122,168,5202,09:00 - 10:59
winter,2011-09-30,11,49,168,217,5202,11:00 - 12:59
winter,2011-09-30,12,59,195,254,5202,11:00 - 12:59
winter,2011-09-30,13,72,194,266,5202,13:00 - 14:59
winter,2011-09-30,14,93,173,266,5202,13:00 - 14:59
winter,2011-09-30,15,52,193,245,5202,15:00 - 16:59
winter,2011-09-30,16,62,298,360,5202,15:00 - 16:59
winter,2011-09-30,17,94,497,591,5202,17:00 - 18:59
winter,2011-09-30,18,62,449,511,5202,17:00 - 18:59
winter,2011-09-30,19,42,332,374,5202,19:00 - 20:59
winter,2011-09-30,20,28,202,230,5202,19:00 - 20:59
winter,2011-09-30,21,27,179,206,5202,21:00 - 22:59
winter,2011-09-30,22,30,129,159,5202,21:00 - 22:59
winter,2011-09-30,23,23,109,132,5202,23:00 - 24:59
winter,2011-10-01,0,24,106,130,2429,
winter,2011-10-01,1,11,47,58,2429,01:00 - 02:59
winter,2011-10-01,2,21,46,67,2429,01:00 - 02:59
winter,2011-10-01,3,8,17,25,2429,03:00 - 04:59
winter,2011-10-01,4,2,6,8,2429,03:00 - 04:59
winter,2011-10-01,5,1,4,5,2429,05:00 - 06:59
winter,2011-10-01,6,4,15,19,2429,05:00 - 06:59
winter,2011-10-01,7,6,30,36,2429,07:00 - 08:59
winter,2011-10-01,8,9,58,67,2429,07:00 - 08:59
winter,2011-10-01,9,17,112,129,2429,09:00 - 10:59
winter,2011-10-01,10,21,100,121,2429,09:00 - 10:59
winter,2011-10-01,11,30,102,132,2429,11:00 - 12:59
winter,2011-10-01,12,28,130,158,2429,11:00 - 12:59
winter,2011-10-01,13,27,98,125,2429,13:00 - 14:59
winter,2011-10-01,14,33,147,180,2429,13:00 - 14:59
winter,2011-10-01,15,41,154,195,2429,15:00 - 16:59
winter,2011-10-01,16,58,165,223,2429,15:00 - 16:59
winter,2011-10-01,17,58,170,228,2429,17:00 - 18:59
winter,2011-10-01,18,23,117,140,2429,17:00 - 18:59
winter,2011-10-01,19,27,99,126,2429,19:00 - 20:59
winter,2011-10-01,20,8,58,66,2429,19:00 - 20:59
winter,2011-10-01,21,3,53,56,2429,21:00 - 22:59
winter,2011-10-01,22,12,58,70,2429,21:00 - 22:59
winter,2011-10-01,23,8,57,65,2429,23:00 - 24:59
winter,2011-10-02,0,4,43,47,2918,
winter,2011-10-02,1,1,23,24,2918,01:00 - 02:59
winter,2011-10-02,2,3,27,30,2918,01:00 - 02:59
winter,2011-10-02,3,4,5,9,2918,03:00 - 04:59
winter,2011-10-02,4,4,3,7,2918,03:00 - 04:59
winter,2011-10-02,5,0,7,7,2918,05:00 - 06:59
winter,2011-10-02,6,2,13,15,2918,05:00 - 06:59
winter,2011-10-02,7,5,24,29,2918,07:00 - 08:59
winter,2011-10-02,8,14,50,64,2918,07:00 - 08:59
winter,2011-10-02,9,19,96,115,2918,09:00 - 10:59
winter,2011-10-02,10,60,188,248,2918,09:00 - 10:59
winter,2011-10-02,11,74,218,292,2918,11:00 - 12:59
winter,2011-10-02,12,78,243,321,2918,11:00 - 12:59
winter,2011-10-02,13,84,224,308,2918,13:00 - 14:59
winter,2011-10-02,14,61,195,256,2918,13:00 - 14:59
winter,2011-10-02,15,29,144,173,2918,15:00 - 16:59
winter,2011-10-02,16,44,162,206,2918,15:00 - 16:59
winter,2011-10-02,17,32,135,167,2918,17:00 - 18:59
winter,2011-10-02,18,16,158,174,2918,17:00 - 18:59
winter,2011-10-02,19,34,128,162,2918,19:00 - 20:59
winter,2011-10-02,20,16,71,87,2918,19:00 - 20:59
winter,2011-10-02,21,17,71,88,2918,21:00 - 22:59
winter,2011-10-02,22,9,55,64,2918,21:00 - 22:59
winter,2011-10-02,23,6,19,25,2918,23:00 - 24:59
winter,2011-10-03,0,3,13,16,3570,
winter,2011-10-03,1,1,5,6,3570,01:00 - 02:59
winter,2011-10-03,2,0,4,4,3570,01:00 - 02:59
winter,2011-10-03,3,1,6,7,3570,03:00 - 04:59
winter,2011-10-03,4,2,6,8,3570,03:00 - 04:59
winter,2011-10-03,5,4,17,21,3570,05:00 - 06:59
winter,2011-10-03,6,3,91,94,3570,05:00 - 06:59
winter,2011-10-03,7,8,241,249,3570,07:00 - 08:59
winter,2011-10-03,8,13,359,372,3570,07:00 - 08:59
winter,2011-10-03,9,12,141,153,3570,09:00 - 10:59
winter,2011-10-03,10,19,82,101,3570,09:00 - 10:59
winter,2011-10-03,11,26,100,126,3570,11:00 - 12:59
winter,2011-10-03,12,29,118,147,3570,11:00 - 12:59
winter,2011-10-03,13,16,102,118,3570,13:00 - 14:59
winter,2011-10-03,14,26,94,120,3570,13:00 - 14:59
winter,2011-10-03,15,22,79,101,3570,15:00 - 16:59
winter,2011-10-03,16,16,202,218,3570,15:00 - 16:59
winter,2011-10-03,17,40,455,495,3570,17:00 - 18:59
winter,2011-10-03,18,28,384,412,3570,17:00 - 18:59
winter,2011-10-03,19,15,300,315,3570,19:00 - 20:59
winter,2011-10-03,20,13,191,204,3570,19:00 - 20:59
winter,2011-10-03,21,10,128,138,3570,21:00 - 22:59
winter,2011-10-03,22,12,79,91,3570,21:00 - 22:59
winter,2011-10-03,23,11,43,54,3570,23:00 - 24:59
winter,2011-10-04,0,5,22,27,4456,
winter,2011-10-04,1,1,8,9,4456,01:00 - 02:59
winter,2011-10-04,2,1,2,3,4456,01:00 - 02:59
winter,2011-10-04,3,3,3,6,4456,03:00 - 04:59
winter,2011-10-04,4,3,4,7,4456,03:00 - 04:59
winter,2011-10-04,5,2,25,27,4456,05:00 - 06:59
winter,2011-10-04,6,3,109,112,4456,05:00 - 06:59
winter,2011-10-04,7,11,298,309,4456,07:00 - 08:59
winter,2011-10-04,8,28,372,400,4456,07:00 - 08:59
winter,2011-10-04,9,19,168,187,4456,09:00 - 10:59
winter,2011-10-04,10,19,107,126,4456,09:00 - 10:59
winter,2011-10-04,11,22,102,124,4456,11:00 - 12:59
winter,2011-10-04,12,39,160,199,4456,11:00 - 12:59
winter,2011-10-04,13,20,153,173,4456,13:00 - 14:59
winter,2011-10-04,14,27,156,183,4456,13:00 - 14:59
winter,2011-10-04,15,28,166,194,4456,15:00 - 16:59
winter,2011-10-04,16,36,273,309,4456,15:00 - 16:59
winter,2011-10-04,17,55,530,585,4456,17:00 - 18:59
winter,2011-10-04,18,68,456,524,4456,17:00 - 18:59
winter,2011-10-04,19,35,310,345,4456,19:00 - 20:59
winter,2011-10-04,20,25,236,261,4456,19:00 - 20:59
winter,2011-10-04,21,22,144,166,4456,21:00 - 22:59
winter,2011-10-04,22,8,106,114,4456,21:00 - 22:59
winter,2011-10-04,23,6,60,66,4456,23:00 - 24:59
winter,2011-10-05,0,7,36,43,4826,
winter,2011-10-05,1,4,7,11,4826,01:00 - 02:59
winter,2011-10-05,2,1,2,3,4826,01:00 - 02:59
winter,2011-10-05,3,1,5,6,4826,03:00 - 04:59
winter,2011-10-05,4,1,4,5,4826,03:00 - 04:59
winter,2011-10-05,5,3,29,32,4826,05:00 - 06:59
winter,2011-10-05,6,5,112,117,4826,05:00 - 06:59
winter,2011-10-05,7,9,292,301,4826,07:00 - 08:59
winter,2011-10-05,8,26,441,467,4826,07:00 - 08:59
winter,2011-10-05,9,32,187,219,4826,09:00 - 10:59
winter,2011-10-05,10,30,103,133,4826,09:00 - 10:59
winter,2011-10-05,11,32,138,170,4826,11:00 - 12:59
winter,2011-10-05,12,34,180,214,4826,11:00 - 12:59
winter,2011-10-05,13,30,189,219,4826,13:00 - 14:59
winter,2011-10-05,14,34,156,190,4826,13:00 - 14:59
winter,2011-10-05,15,35,147,182,4826,15:00 - 16:59
winter,2011-10-05,16,37,245,282,4826,15:00 - 16:59
winter,2011-10-05,17,66,525,591,4826,17:00 - 18:59
winter,2011-10-05,18,57,536,593,4826,17:00 - 18:59
winter,2011-10-05,19,40,334,374,4826,19:00 - 20:59
winter,2011-10-05,20,18,228,246,4826,19:00 - 20:59
winter,2011-10-05,21,28,173,201,4826,21:00 - 22:59
winter,2011-10-05,22,20,134,154,4826,21:00 - 22:59
winter,2011-10-05,23,9,64,73,4826,23:00 - 24:59
winter,2011-10-06,0,6,34,40,4765,
winter,2011-10-06,1,5,17,22,4765,01:00 - 02:59
winter,2011-10-06,2,2,8,10,4765,01:00 - 02:59
winter,2011-10-06,3,1,4,5,4765,03:00 - 04:59
winter,2011-10-06,4,0,5,5,4765,03:00 - 04:59
winter,2011-10-06,5,0,24,24,4765,05:00 - 06:59
winter,2011-10-06,6,4,110,114,4765,05:00 - 06:59
winter,2011-10-06,7,15,287,302,4765,07:00 - 08:59
winter,2011-10-06,8,20,437,457,4765,07:00 - 08:59
winter,2011-10-06,9,20,188,208,4765,09:00 - 10:59
winter,2011-10-06,10,24,105,129,4765,09:00 - 10:59
winter,2011-10-06,11,29,115,144,4765,11:00 - 12:59
winter,2011-10-06,12,46,180,226,4765,11:00 - 12:59
winter,2011-10-06,13,33,158,191,4765,13:00 - 14:59
winter,2011-10-06,14,56,139,195,4765,13:00 - 14:59
winter,2011-10-06,15,62,157,219,4765,15:00 - 16:59
winter,2011-10-06,16,51,272,323,4765,15:00 - 16:59
winter,2011-10-06,17,63,505,568,4765,17:00 - 18:59
winter,2011-10-06,18,59,479,538,4765,17:00 - 18:59
winter,2011-10-06,19,38,305,343,4765,19:00 - 20:59
winter,2011-10-06,20,29,231,260,4765,19:00 - 20:59
winter,2011-10-06,21,34,161,195,4765,21:00 - 22:59
winter,2011-10-06,22,24,124,148,4765,21:00 - 22:59
winter,2011-10-06,23,18,81,99,4765,23:00 - 24:59
winter,2011-10-07,0,19,48,67,4985,
winter,2011-10-07,1,3,25,28,4985,01:00 - 02:59
winter,2011-10-07,2,0,5,5,4985,01:00 - 02:59
winter,2011-10-07,3,1,9,10,4985,03:00 - 04:59
winter,2011-10-07,4,0,5,5,4985,03:00 - 04:59
winter,2011-10-07,5,3,24,27,4985,05:00 - 06:59
winter,2011-10-07,6,3,84,87,4985,05:00 - 06:59
winter,2011-10-07,7,5,237,242,4985,07:00 - 08:59
winter,2011-10-07,8,31,386,417,4985,07:00 - 08:59
winter,2011-10-07,9,34,207,241,4985,09:00 - 10:59
winter,2011-10-07,10,48,126,174,4985,09:00 - 10:59
winter,2011-10-07,11,80,150,230,4985,11:00 - 12:59
winter,2011-10-07,12,61,174,235,4985,11:00 - 12:59
winter,2011-10-07,13,95,210,305,4985,13:00 - 14:59
winter,2011-10-07,14,77,179,256,4985,13:00 - 14:59
winter,2011-10-07,15,68,202,270,4985,15:00 - 16:59
winter,2011-10-07,16,73,346,419,4985,15:00 - 16:59
winter,2011-10-07,17,101,462,563,4985,17:00 - 18:59
winter,2011-10-07,18,94,371,465,4985,17:00 - 18:59
winter,2011-10-07,19,51,243,294,4985,19:00 - 20:59
winter,2011-10-07,20,30,167,197,4985,19:00 - 20:59
winter,2011-10-07,21,22,144,166,4985,21:00 - 22:59
winter,2011-10-07,22,27,119,146,4985,21:00 - 22:59
winter,2011-10-07,23,23,113,136,4985,23:00 - 24:59
winter,2011-10-08,0,17,72,89,5409,
winter,2011-10-08,1,14,51,65,5409,01:00 - 02:59
winter,2011-10-08,2,4,41,45,5409,01:00 - 02:59
winter,2011-10-08,3,4,16,20,5409,03:00 - 04:59
winter,2011-10-08,4,3,7,10,5409,03:00 - 04:59
winter,2011-10-08,5,1,7,8,5409,05:00 - 06:59
winter,2011-10-08,6,6,16,22,5409,05:00 - 06:59
winter,2011-10-08,7,27,46,73,5409,07:00 - 08:59
winter,2011-10-08,8,14,89,103,5409,07:00 - 08:59
winter,2011-10-08,9,54,163,217,5409,09:00 - 10:59
winter,2011-10-08,10,120,217,337,5409,09:00 - 10:59
winter,2011-10-08,11,176,221,397,5409,11:00 - 12:59
winter,2011-10-08,12,191,255,446,5409,11:00 - 12:59
winter,2011-10-08,13,256,229,485,5409,13:00 - 14:59
winter,2011-10-08,14,251,214,465,5409,13:00 - 14:59
winter,2011-10-08,15,262,234,496,5409,15:00 - 16:59
winter,2011-10-08,16,221,230,451,5409,15:00 - 16:59
winter,2011-10-08,17,174,219,393,5409,17:00 - 18:59
winter,2011-10-08,18,135,224,359,5409,17:00 - 18:59
winter,2011-10-08,19,76,172,248,5409,19:00 - 20:59
winter,2011-10-08,20,78,124,202,5409,19:00 - 20:59
winter,2011-10-08,21,54,133,187,5409,21:00 - 22:59
winter,2011-10-08,22,45,104,149,5409,21:00 - 22:59
winter,2011-10-08,23,52,90,142,5409,23:00 - 24:59
winter,2011-10-09,0,46,83,129,5511,
winter,2011-10-09,1,15,63,78,5511,01:00 - 02:59
winter,2011-10-09,2,20,35,55,5511,01:00 - 02:59
winter,2011-10-09,3,10,20,30,5511,03:00 - 04:59
winter,2011-10-09,4,7,7,14,5511,03:00 - 04:59
winter,2011-10-09,5,1,14,15,5511,05:00 - 06:59
winter,2011-10-09,6,7,14,21,5511,05:00 - 06:59
winter,2011-10-09,7,18,26,44,5511,07:00 - 08:59
winter,2011-10-09,8,25,82,107,5511,07:00 - 08:59
winter,2011-10-09,9,66,119,185,5511,09:00 - 10:59
winter,2011-10-09,10,155,210,365,5511,09:00 - 10:59
winter,2011-10-09,11,189,234,423,5511,11:00 - 12:59
winter,2011-10-09,12,212,243,455,5511,11:00 - 12:59
winter,2011-10-09,13,225,193,418,5511,13:00 - 14:59
winter,2011-10-09,14,272,228,500,5511,13:00 - 14:59
winter,2011-10-09,15,198,209,407,5511,15:00 - 16:59
winter,2011-10-09,16,223,247,470,5511,15:00 - 16:59
winter,2011-10-09,17,208,230,438,5511,17:00 - 18:59
winter,2011-10-09,18,186,228,414,5511,17:00 - 18:59
winter,2011-10-09,19,116,186,302,5511,19:00 - 20:59
winter,2011-10-09,20,59,134,193,5511,19:00 - 20:59
winter,2011-10-09,21,53,120,173,5511,21:00 - 22:59
winter,2011-10-09,22,48,104,152,5511,21:00 - 22:59
winter,2011-10-09,23,38,85,123,5511,23:00 - 24:59
winter,2011-10-10,0,11,42,53,5117,
winter,2011-10-10,1,4,30,34,5117,01:00 - 02:59
winter,2011-10-10,2,4,15,19,5117,01:00 - 02:59
winter,2011-10-10,3,2,9,11,5117,03:00 - 04:59
winter,2011-10-10,4,2,4,6,5117,03:00 - 04:59
winter,2011-10-10,5,2,19,21,5117,05:00 - 06:59
winter,2011-10-10,6,5,39,44,5117,05:00 - 06:59
winter,2011-10-10,7,12,102,114,5117,07:00 - 08:59
winter,2011-10-10,8,27,227,254,5117,07:00 - 08:59
winter,2011-10-10,9,58,161,219,5117,09:00 - 10:59
winter,2011-10-10,10,107,158,265,5117,09:00 - 10:59
winter,2011-10-10,11,139,183,322,5117,11:00 - 12:59
winter,2011-10-10,12,164,201,365,5117,11:00 - 12:59
winter,2011-10-10,13,146,219,365,5117,13:00 - 14:59
winter,2011-10-10,14,147,223,370,5117,13:00 - 14:59
winter,2011-10-10,15,130,254,384,5117,15:00 - 16:59
winter,2011-10-10,16,154,248,402,5117,15:00 - 16:59
winter,2011-10-10,17,125,334,459,5117,17:00 - 18:59
winter,2011-10-10,18,108,365,473,5117,17:00 - 18:59
winter,2011-10-10,19,69,267,336,5117,19:00 - 20:59
winter,2011-10-10,20,37,188,225,5117,19:00 - 20:59
winter,2011-10-10,21,27,148,175,5117,21:00 - 22:59
winter,2011-10-10,22,22,104,126,5117,21:00 - 22:59
winter,2011-10-10,23,12,63,75,5117,23:00 - 24:59
winter,2011-10-11,0,14,16,30,4563,
winter,2011-10-11,1,2,9,11,4563,01:00 - 02:59
winter,2011-10-11,2,1,4,5,4563,01:00 - 02:59
winter,2011-10-11,3,2,1,3,4563,03:00 - 04:59
winter,2011-10-11,4,0,5,5,4563,03:00 - 04:59
winter,2011-10-11,5,0,20,20,4563,05:00 - 06:59
winter,2011-10-11,6,9,114,123,4563,05:00 - 06:59
winter,2011-10-11,7,19,333,352,4563,07:00 - 08:59
winter,2011-10-11,8,31,375,406,4563,07:00 - 08:59
winter,2011-10-11,9,40,195,235,4563,09:00 - 10:59
winter,2011-10-11,10,38,111,149,4563,09:00 - 10:59
winter,2011-10-11,11,31,92,123,4563,11:00 - 12:59
winter,2011-10-11,12,51,130,181,4563,11:00 - 12:59
winter,2011-10-11,13,42,138,180,4563,13:00 - 14:59
winter,2011-10-11,14,54,117,171,4563,13:00 - 14:59
winter,2011-10-11,15,36,139,175,4563,15:00 - 16:59
winter,2011-10-11,16,63,257,320,4563,15:00 - 16:59
winter,2011-10-11,17,70,534,604,4563,17:00 - 18:59
winter,2011-10-11,18,46,493,539,4563,17:00 - 18:59
winter,2011-10-11,19,33,285,318,4563,19:00 - 20:59
winter,2011-10-11,20,31,203,234,4563,19:00 - 20:59
winter,2011-10-11,21,17,158,175,4563,21:00 - 22:59
winter,2011-10-11,22,27,120,147,4563,21:00 - 22:59
winter,2011-10-11,23,10,47,57,4563,23:00 - 24:59
winter,2011-10-12,0,2,23,25,2416,
winter,2011-10-12,1,2,8,10,2416,01:00 - 02:59
winter,2011-10-12,2,0,2,2,2416,01:00 - 02:59
winter,2011-10-12,3,0,2,2,2416,03:00 - 04:59
winter,2011-10-12,4,1,6,7,2416,03:00 - 04:59
winter,2011-10-12,5,0,22,22,2416,05:00 - 06:59
winter,2011-10-12,6,5,107,112,2416,05:00 - 06:59
winter,2011-10-12,7,15,244,259,2416,07:00 - 08:59
winter,2011-10-12,8,27,377,404,2416,07:00 - 08:59
winter,2011-10-12,9,14,183,197,2416,09:00 - 10:59
winter,2011-10-12,10,15,98,113,2416,09:00 - 10:59
winter,2011-10-12,11,18,102,120,2416,11:00 - 12:59
winter,2011-10-12,12,9,53,62,2416,11:00 - 12:59
winter,2011-10-12,13,25,76,101,2416,13:00 - 14:59
winter,2011-10-12,14,8,70,78,2416,13:00 - 14:59
winter,2011-10-12,15,3,42,45,2416,15:00 - 16:59
winter,2011-10-12,16,5,50,55,2416,15:00 - 16:59
winter,2011-10-12,17,16,235,251,2416,17:00 - 18:59
winter,2011-10-12,18,11,161,172,2416,17:00 - 18:59
winter,2011-10-12,19,7,102,109,2416,19:00 - 20:59
winter,2011-10-12,20,9,81,90,2416,19:00 - 20:59
winter,2011-10-12,21,9,74,83,2416,21:00 - 22:59
winter,2011-10-12,22,3,40,43,2416,21:00 - 22:59
winter,2011-10-12,23,13,41,54,2416,23:00 - 24:59
winter,2011-10-13,0,1,14,15,2913,
winter,2011-10-13,1,3,9,12,2913,01:00 - 02:59
winter,2011-10-13,2,0,4,4,2913,01:00 - 02:59
winter,2011-10-13,3,2,4,6,2913,03:00 - 04:59
winter,2011-10-13,4,2,5,7,2913,03:00 - 04:59
winter,2011-10-13,5,1,16,17,2913,05:00 - 06:59
winter,2011-10-13,6,1,51,52,2913,05:00 - 06:59
winter,2011-10-13,7,5,76,81,2913,07:00 - 08:59
winter,2011-10-13,8,10,199,209,2913,07:00 - 08:59
winter,2011-10-13,9,3,106,109,2913,09:00 - 10:59
winter,2011-10-13,10,16,53,69,2913,09:00 - 10:59
winter,2011-10-13,11,8,76,84,2913,11:00 - 12:59
winter,2011-10-13,12,10,95,105,2913,11:00 - 12:59
winter,2011-10-13,13,20,142,162,2913,13:00 - 14:59
winter,2011-10-13,14,22,111,133,2913,13:00 - 14:59
winter,2011-10-13,15,27,128,155,2913,15:00 - 16:59
winter,2011-10-13,16,36,240,276,2913,15:00 - 16:59
winter,2011-10-13,17,47,432,479,2913,17:00 - 18:59
winter,2011-10-13,18,20,248,268,2913,17:00 - 18:59
winter,2011-10-13,19,18,187,205,2913,19:00 - 20:59
winter,2011-10-13,20,15,166,181,2913,19:00 - 20:59
winter,2011-10-13,21,8,115,123,2913,21:00 - 22:59
winter,2011-10-13,22,13,101,114,2913,21:00 - 22:59
winter,2011-10-13,23,2,45,47,2913,23:00 - 24:59
winter,2011-10-14,0,10,29,39,3644,
winter,2011-10-14,1,8,16,24,3644,01:00 - 02:59
winter,2011-10-14,2,0,6,6,3644,01:00 - 02:59
winter,2011-10-14,3,1,6,7,3644,03:00 - 04:59
winter,2011-10-14,4,0,8,8,3644,03:00 - 04:59
winter,2011-10-14,5,0,17,17,3644,05:00 - 06:59
winter,2011-10-14,6,4,90,94,3644,05:00 - 06:59
winter,2011-10-14,7,10,137,147,3644,07:00 - 08:59
winter,2011-10-14,8,23,186,209,3644,07:00 - 08:59
winter,2011-10-14,9,16,164,180,3644,09:00 - 10:59
winter,2011-10-14,10,17,108,125,3644,09:00 - 10:59
winter,2011-10-14,11,11,76,87,3644,11:00 - 12:59
winter,2011-10-14,12,13,62,75,3644,11:00 - 12:59
winter,2011-10-14,13,18,114,132,3644,13:00 - 14:59
winter,2011-10-14,14,37,119,156,3644,13:00 - 14:59
winter,2011-10-14,15,61,169,230,3644,15:00 - 16:59
winter,2011-10-14,16,80,264,344,3644,15:00 - 16:59
winter,2011-10-14,17,55,426,481,3644,17:00 - 18:59
winter,2011-10-14,18,62,361,423,3644,17:00 - 18:59
winter,2011-10-14,19,27,221,248,3644,19:00 - 20:59
winter,2011-10-14,20,19,177,196,3644,19:00 - 20:59
winter,2011-10-14,21,22,156,178,3644,21:00 - 22:59
winter,2011-10-14,22,20,123,143,3644,21:00 - 22:59
winter,2011-10-14,23,15,80,95,3644,23:00 - 24:59
winter,2011-10-15,0,18,88,106,5217,
winter,2011-10-15,1,9,64,73,5217,01:00 - 02:59
winter,2011-10-15,2,17,39,56,5217,01:00 - 02:59
winter,2011-10-15,3,5,18,23,5217,03:00 - 04:59
winter,2011-10-15,4,0,6,6,5217,03:00 - 04:59
winter,2011-10-15,5,1,6,7,5217,05:00 - 06:59
winter,2011-10-15,6,5,15,20,5217,05:00 - 06:59
winter,2011-10-15,7,17,40,57,5217,07:00 - 08:59
winter,2011-10-15,8,24,101,125,5217,07:00 - 08:59
winter,2011-10-15,9,50,157,207,5217,09:00 - 10:59
winter,2011-10-15,10,115,207,322,5217,09:00 - 10:59
winter,2011-10-15,11,153,221,374,5217,11:00 - 12:59
winter,2011-10-15,12,195,261,456,5217,11:00 - 12:59
winter,2011-10-15,13,171,223,394,5217,13:00 - 14:59
winter,2011-10-15,14,242,230,472,5217,13:00 - 14:59
winter,2011-10-15,15,166,211,377,5217,15:00 - 16:59
winter,2011-10-15,16,179,264,443,5217,15:00 - 16:59
winter,2011-10-15,17,177,264,441,5217,17:00 - 18:59
winter,2011-10-15,18,121,251,372,5217,17:00 - 18:59
winter,2011-10-15,19,61,177,238,5217,19:00 - 20:59
winter,2011-10-15,20,42,137,179,5217,19:00 - 20:59
winter,2011-10-15,21,53,115,168,5217,21:00 - 22:59
winter,2011-10-15,22,45,121,166,5217,21:00 - 22:59
winter,2011-10-15,23,33,102,135,5217,23:00 - 24:59
winter,2011-10-16,0,22,85,107,5041,
winter,2011-10-16,1,13,64,77,5041,01:00 - 02:59
winter,2011-10-16,2,13,52,65,5041,01:00 - 02:59
winter,2011-10-16,3,11,31,42,5041,03:00 - 04:59
winter,2011-10-16,4,5,7,12,5041,03:00 - 04:59
winter,2011-10-16,5,1,6,7,5041,05:00 - 06:59
winter,2011-10-16,6,3,7,10,5041,05:00 - 06:59
winter,2011-10-16,7,9,39,48,5041,07:00 - 08:59
winter,2011-10-16,8,28,71,99,5041,07:00 - 08:59
winter,2011-10-16,9,39,151,190,5041,09:00 - 10:59
winter,2011-10-16,10,121,226,347,5041,09:00 - 10:59
winter,2011-10-16,11,159,218,377,5041,11:00 - 12:59
winter,2011-10-16,12,167,277,444,5041,11:00 - 12:59
winter,2011-10-16,13,169,269,438,5041,13:00 - 14:59
winter,2011-10-16,14,204,258,462,5041,13:00 - 14:59
winter,2011-10-16,15,182,230,412,5041,15:00 - 16:59
winter,2011-10-16,16,177,289,466,5041,15:00 - 16:59
winter,2011-10-16,17,152,253,405,5041,17:00 - 18:59
winter,2011-10-16,18,102,226,328,5041,17:00 - 18:59
winter,2011-10-16,19,52,181,233,5041,19:00 - 20:59
winter,2011-10-16,20,49,129,178,5041,19:00 - 20:59
winter,2011-10-16,21,14,88,102,5041,21:00 - 22:59
winter,2011-10-16,22,42,88,130,5041,21:00 - 22:59
winter,2011-10-16,23,14,48,62,5041,23:00 - 24:59
winter,2011-10-17,0,12,25,37,4570,
winter,2011-10-17,1,2,15,17,4570,01:00 - 02:59
winter,2011-10-17,2,4,3,7,4570,01:00 - 02:59
winter,2011-10-17,3,0,2,2,4570,03:00 - 04:59
winter,2011-10-17,4,2,3,5,4570,03:00 - 04:59
winter,2011-10-17,5,1,28,29,4570,05:00 - 06:59
winter,2011-10-17,6,7,107,114,4570,05:00 - 06:59
winter,2011-10-17,7,10,299,309,4570,07:00 - 08:59
winter,2011-10-17,8,33,381,414,4570,07:00 - 08:59
winter,2011-10-17,9,26,180,206,4570,09:00 - 10:59
winter,2011-10-17,10,43,92,135,4570,09:00 - 10:59
winter,2011-10-17,11,35,131,166,4570,11:00 - 12:59
winter,2011-10-17,12,39,166,205,4570,11:00 - 12:59
winter,2011-10-17,13,49,156,205,4570,13:00 - 14:59
winter,2011-10-17,14,44,122,166,4570,13:00 - 14:59
winter,2011-10-17,15,66,142,208,4570,15:00 - 16:59
winter,2011-10-17,16,64,238,302,4570,15:00 - 16:59
winter,2011-10-17,17,80,540,620,4570,17:00 - 18:59
winter,2011-10-17,18,49,469,518,4570,17:00 - 18:59
winter,2011-10-17,19,45,288,333,4570,19:00 - 20:59
winter,2011-10-17,20,40,189,229,4570,19:00 - 20:59
winter,2011-10-17,21,36,141,177,4570,21:00 - 22:59
winter,2011-10-17,22,16,88,104,4570,21:00 - 22:59
winter,2011-10-17,23,10,52,62,4570,23:00 - 24:59
winter,2011-10-18,0,8,23,31,4748,
winter,2011-10-18,1,4,7,11,4748,01:00 - 02:59
winter,2011-10-18,2,1,4,5,4748,01:00 - 02:59
winter,2011-10-18,3,0,1,1,4748,03:00 - 04:59
winter,2011-10-18,4,0,4,4,4748,03:00 - 04:59
winter,2011-10-18,5,2,19,21,4748,05:00 - 06:59
winter,2011-10-18,6,4,105,109,4748,05:00 - 06:59
winter,2011-10-18,7,15,326,341,4748,07:00 - 08:59
winter,2011-10-18,8,25,474,499,4748,07:00 - 08:59
winter,2011-10-18,9,29,198,227,4748,09:00 - 10:59
winter,2011-10-18,10,27,75,102,4748,09:00 - 10:59
winter,2011-10-18,11,35,112,147,4748,11:00 - 12:59
winter,2011-10-18,12,42,159,201,4748,11:00 - 12:59
winter,2011-10-18,13,48,171,219,4748,13:00 - 14:59
winter,2011-10-18,14,32,137,169,4748,13:00 - 14:59
winter,2011-10-18,15,66,139,205,4748,15:00 - 16:59
winter,2011-10-18,16,58,246,304,4748,15:00 - 16:59
winter,2011-10-18,17,72,553,625,4748,17:00 - 18:59
winter,2011-10-18,18,58,512,570,4748,17:00 - 18:59
winter,2011-10-18,19,31,286,317,4748,19:00 - 20:59
winter,2011-10-18,20,23,204,227,4748,19:00 - 20:59
winter,2011-10-18,21,28,178,206,4748,21:00 - 22:59
winter,2011-10-18,22,22,115,137,4748,21:00 - 22:59
winter,2011-10-18,23,7,63,70,4748,23:00 - 24:59
winter,2011-10-19,0,11,23,34,2424,
winter,2011-10-19,1,7,9,16,2424,01:00 - 02:59
winter,2011-10-19,2,1,6,7,2424,01:00 - 02:59
winter,2011-10-19,4,0,3,3,2424,03:00 - 04:59
winter,2011-10-19,5,0,3,3,2424,05:00 - 06:59
winter,2011-10-19,6,3,28,31,2424,05:00 - 06:59
winter,2011-10-19,7,1,67,68,2424,07:00 - 08:59
winter,2011-10-19,8,10,200,210,2424,07:00 - 08:59
winter,2011-10-19,9,17,185,202,2424,09:00 - 10:59
winter,2011-10-19,10,14,109,123,2424,09:00 - 10:59
winter,2011-10-19,11,33,116,149,2424,11:00 - 12:59
winter,2011-10-19,12,13,117,130,2424,11:00 - 12:59
winter,2011-10-19,13,20,86,106,2424,13:00 - 14:59
winter,2011-10-19,14,17,80,97,2424,13:00 - 14:59
winter,2011-10-19,15,21,99,120,2424,15:00 - 16:59
winter,2011-10-19,16,21,180,201,2424,15:00 - 16:59
winter,2011-10-19,17,11,170,181,2424,17:00 - 18:59
winter,2011-10-19,18,8,132,140,2424,17:00 - 18:59
winter,2011-10-19,19,8,189,197,2424,19:00 - 20:59
winter,2011-10-19,20,5,140,145,2424,19:00 - 20:59
winter,2011-10-19,21,6,79,85,2424,21:00 - 22:59
winter,2011-10-19,22,13,94,107,2424,21:00 - 22:59
winter,2011-10-19,23,14,55,69,2424,23:00 - 24:59
winter,2011-10-20,0,4,22,26,4195,
winter,2011-10-20,1,4,11,15,4195,01:00 - 02:59
winter,2011-10-20,2,0,4,4,4195,01:00 - 02:59
winter,2011-10-20,3,0,1,1,4195,03:00 - 04:59
winter,2011-10-20,4,2,6,8,4195,03:00 - 04:59
winter,2011-10-20,5,2,24,26,4195,05:00 - 06:59
winter,2011-10-20,6,5,87,92,4195,05:00 - 06:59
winter,2011-10-20,7,15,303,318,4195,07:00 - 08:59
winter,2011-10-20,8,17,409,426,4195,07:00 - 08:59
winter,2011-10-20,9,26,197,223,4195,09:00 - 10:59
winter,2011-10-20,10,25,105,130,4195,09:00 - 10:59
winter,2011-10-20,11,30,99,129,4195,11:00 - 12:59
winter,2011-10-20,12,28,171,199,4195,11:00 - 12:59
winter,2011-10-20,13,28,136,164,4195,13:00 - 14:59
winter,2011-10-20,14,38,117,155,4195,13:00 - 14:59
winter,2011-10-20,15,22,138,160,4195,15:00 - 16:59
winter,2011-10-20,16,31,203,234,4195,15:00 - 16:59
winter,2011-10-20,17,56,438,494,4195,17:00 - 18:59
winter,2011-10-20,18,39,430,469,4195,17:00 - 18:59
winter,2011-10-20,19,20,278,298,4195,19:00 - 20:59
winter,2011-10-20,20,34,207,241,4195,19:00 - 20:59
winter,2011-10-20,21,16,149,165,4195,21:00 - 22:59
winter,2011-10-20,22,22,106,128,4195,21:00 - 22:59
winter,2011-10-20,23,7,83,90,4195,23:00 - 24:59
winter,2011-10-21,0,8,42,50,4304,
winter,2011-10-21,1,7,19,26,4304,01:00 - 02:59
winter,2011-10-21,2,6,12,18,4304,01:00 - 02:59
winter,2011-10-21,3,0,7,7,4304,03:00 - 04:59
winter,2011-10-21,4,0,6,6,4304,03:00 - 04:59
winter,2011-10-21,5,0,31,31,4304,05:00 - 06:59
winter,2011-10-21,6,7,78,85,4304,05:00 - 06:59
winter,2011-10-21,7,5,228,233,4304,07:00 - 08:59
winter,2011-10-21,8,16,386,402,4304,07:00 - 08:59
winter,2011-10-21,9,33,189,222,4304,09:00 - 10:59
winter,2011-10-21,10,32,106,138,4304,09:00 - 10:59
winter,2011-10-21,11,39,135,174,4304,11:00 - 12:59
winter,2011-10-21,12,47,193,240,4304,11:00 - 12:59
winter,2011-10-21,13,43,163,206,4304,13:00 - 14:59
winter,2011-10-21,14,67,131,198,4304,13:00 - 14:59
winter,2011-10-21,15,57,178,235,4304,15:00 - 16:59
winter,2011-10-21,16,60,242,302,4304,15:00 - 16:59
winter,2011-10-21,17,79,445,524,4304,17:00 - 18:59
winter,2011-10-21,18,43,354,397,4304,17:00 - 18:59
winter,2011-10-21,19,25,228,253,4304,19:00 - 20:59
winter,2011-10-21,20,29,155,184,4304,19:00 - 20:59
winter,2011-10-21,21,31,112,143,4304,21:00 - 22:59
winter,2011-10-21,22,24,89,113,4304,21:00 - 22:59
winter,2011-10-21,23,18,99,117,4304,23:00 - 24:59
winter,2011-10-22,0,16,80,96,4308,
winter,2011-10-22,1,20,50,70,4308,01:00 - 02:59
winter,2011-10-22,2,6,25,31,4308,01:00 - 02:59
winter,2011-10-22,3,1,19,20,4308,03:00 - 04:59
winter,2011-10-22,4,4,4,8,4308,03:00 - 04:59
winter,2011-10-22,5,1,7,8,4308,05:00 - 06:59
winter,2011-10-22,6,1,17,18,4308,05:00 - 06:59
winter,2011-10-22,7,8,49,57,4308,07:00 - 08:59
winter,2011-10-22,8,26,88,114,4308,07:00 - 08:59
winter,2011-10-22,9,47,122,169,4308,09:00 - 10:59
winter,2011-10-22,10,87,149,236,4308,09:00 - 10:59
winter,2011-10-22,11,110,172,282,4308,11:00 - 12:59
winter,2011-10-22,12,132,211,343,4308,11:00 - 12:59
winter,2011-10-22,13,136,186,322,4308,13:00 - 14:59
winter,2011-10-22,14,133,177,310,4308,13:00 - 14:59
winter,2011-10-22,15,159,223,382,4308,15:00 - 16:59
winter,2011-10-22,16,169,190,359,4308,15:00 - 16:59
winter,2011-10-22,17,143,217,360,4308,17:00 - 18:59
winter,2011-10-22,18,111,224,335,4308,17:00 - 18:59
winter,2011-10-22,19,47,173,220,4308,19:00 - 20:59
winter,2011-10-22,20,48,111,159,4308,19:00 - 20:59
winter,2011-10-22,21,37,120,157,4308,21:00 - 22:59
winter,2011-10-22,22,30,114,144,4308,21:00 - 22:59
winter,2011-10-22,23,27,81,108,4308,23:00 - 24:59
winter,2011-10-23,0,24,64,88,4381,
winter,2011-10-23,1,11,60,71,4381,01:00 - 02:59
winter,2011-10-23,2,10,40,50,4381,01:00 - 02:59
winter,2011-10-23,3,15,31,46,4381,03:00 - 04:59
winter,2011-10-23,4,5,1,6,4381,03:00 - 04:59
winter,2011-10-23,5,1,2,3,4381,05:00 - 06:59
winter,2011-10-23,6,0,12,12,4381,05:00 - 06:59
winter,2011-10-23,7,3,18,21,4381,07:00 - 08:59
winter,2011-10-23,8,32,56,88,4381,07:00 - 08:59
winter,2011-10-23,9,48,95,143,4381,09:00 - 10:59
winter,2011-10-23,10,104,185,289,4381,09:00 - 10:59
winter,2011-10-23,11,131,202,333,4381,11:00 - 12:59
winter,2011-10-23,12,164,249,413,4381,11:00 - 12:59
winter,2011-10-23,13,160,255,415,4381,13:00 - 14:59
winter,2011-10-23,14,192,216,408,4381,13:00 - 14:59
winter,2011-10-23,15,171,216,387,4381,15:00 - 16:59
winter,2011-10-23,16,188,217,405,4381,15:00 - 16:59
winter,2011-10-23,17,120,220,340,4381,17:00 - 18:59
winter,2011-10-23,18,88,196,284,4381,17:00 - 18:59
winter,2011-10-23,19,53,140,193,4381,19:00 - 20:59
winter,2011-10-23,20,32,112,144,4381,19:00 - 20:59
winter,2011-10-23,21,24,75,99,4381,21:00 - 22:59
winter,2011-10-23,22,25,69,94,4381,21:00 - 22:59
winter,2011-10-23,23,18,31,49,4381,23:00 - 24:59
winter,2011-10-24,0,6,26,32,4187,
winter,2011-10-24,1,7,8,15,4187,01:00 - 02:59
winter,2011-10-24,2,1,6,7,4187,01:00 - 02:59
winter,2011-10-24,3,1,3,4,4187,03:00 - 04:59
winter,2011-10-24,4,1,5,6,4187,03:00 - 04:59
winter,2011-10-24,5,2,19,21,4187,05:00 - 06:59
winter,2011-10-24,6,3,83,86,4187,05:00 - 06:59
winter,2011-10-24,7,11,274,285,4187,07:00 - 08:59
winter,2011-10-24,8,20,378,398,4187,07:00 - 08:59
winter,2011-10-24,9,29,166,195,4187,09:00 - 10:59
winter,2011-10-24,10,47,82,129,4187,09:00 - 10:59
winter,2011-10-24,11,59,109,168,4187,11:00 - 12:59
winter,2011-10-24,12,64,156,220,4187,11:00 - 12:59
winter,2011-10-24,13,60,138,198,4187,13:00 - 14:59
winter,2011-10-24,14,63,143,206,4187,13:00 - 14:59
winter,2011-10-24,15,52,125,177,4187,15:00 - 16:59
winter,2011-10-24,16,68,242,310,4187,15:00 - 16:59
winter,2011-10-24,17,87,527,614,4187,17:00 - 18:59
winter,2011-10-24,18,58,428,486,4187,17:00 - 18:59
winter,2011-10-24,19,25,212,237,4187,19:00 - 20:59
winter,2011-10-24,20,11,118,129,4187,19:00 - 20:59
winter,2011-10-24,21,12,114,126,4187,21:00 - 22:59
winter,2011-10-24,22,3,76,79,4187,21:00 - 22:59
winter,2011-10-24,23,9,50,59,4187,23:00 - 24:59
winter,2011-10-25,0,4,26,30,4687,
winter,2011-10-25,1,5,6,11,4687,01:00 - 02:59
winter,2011-10-25,2,2,3,5,4687,01:00 - 02:59
winter,2011-10-25,3,1,3,4,4687,03:00 - 04:59
winter,2011-10-25,4,0,5,5,4687,03:00 - 04:59
winter,2011-10-25,5,0,24,24,4687,05:00 - 06:59
winter,2011-10-25,6,3,95,98,4687,05:00 - 06:59
winter,2011-10-25,7,15,299,314,4687,07:00 - 08:59
winter,2011-10-25,8,25,383,408,4687,07:00 - 08:59
winter,2011-10-25,9,29,194,223,4687,09:00 - 10:59
winter,2011-10-25,10,26,102,128,4687,09:00 - 10:59
winter,2011-10-25,11,46,120,166,4687,11:00 - 12:59
winter,2011-10-25,12,35,165,200,4687,11:00 - 12:59
winter,2011-10-25,13,37,161,198,4687,13:00 - 14:59
winter,2011-10-25,14,66,134,200,4687,13:00 - 14:59
winter,2011-10-25,15,63,171,234,4687,15:00 - 16:59
winter,2011-10-25,16,52,233,285,4687,15:00 - 16:59
winter,2011-10-25,17,68,517,585,4687,17:00 - 18:59
winter,2011-10-25,18,65,453,518,4687,17:00 - 18:59
winter,2011-10-25,19,44,294,338,4687,19:00 - 20:59
winter,2011-10-25,20,40,208,248,4687,19:00 - 20:59
winter,2011-10-25,21,32,169,201,4687,21:00 - 22:59
winter,2011-10-25,22,22,148,170,4687,21:00 - 22:59
winter,2011-10-25,23,15,79,94,4687,23:00 - 24:59
winter,2011-10-26,0,4,28,32,3894,
winter,2011-10-26,1,3,9,12,3894,01:00 - 02:59
winter,2011-10-26,2,2,1,3,3894,01:00 - 02:59
winter,2011-10-26,3,0,3,3,3894,03:00 - 04:59
winter,2011-10-26,4,0,5,5,3894,03:00 - 04:59
winter,2011-10-26,5,0,21,21,3894,05:00 - 06:59
winter,2011-10-26,6,0,92,92,3894,05:00 - 06:59
winter,2011-10-26,7,15,284,299,3894,07:00 - 08:59
winter,2011-10-26,8,26,438,464,3894,07:00 - 08:59
winter,2011-10-26,9,14,226,240,3894,09:00 - 10:59
winter,2011-10-26,10,26,105,131,3894,09:00 - 10:59
winter,2011-10-26,11,23,132,155,3894,11:00 - 12:59
winter,2011-10-26,12,39,155,194,3894,11:00 - 12:59
winter,2011-10-26,13,20,62,82,3894,13:00 - 14:59
winter,2011-10-26,14,14,52,66,3894,13:00 - 14:59
winter,2011-10-26,15,11,59,70,3894,15:00 - 16:59
winter,2011-10-26,16,17,196,213,3894,15:00 - 16:59
winter,2011-10-26,17,40,414,454,3894,17:00 - 18:59
winter,2011-10-26,18,55,398,453,3894,17:00 - 18:59
winter,2011-10-26,19,25,306,331,3894,19:00 - 20:59
winter,2011-10-26,20,27,180,207,3894,19:00 - 20:59
winter,2011-10-26,21,17,140,157,3894,21:00 - 22:59
winter,2011-10-26,22,23,112,135,3894,21:00 - 22:59
winter,2011-10-26,23,3,72,75,3894,23:00 - 24:59
winter,2011-10-27,0,3,23,26,2659,
winter,2011-10-27,1,2,9,11,2659,01:00 - 02:59
winter,2011-10-27,2,3,5,8,2659,01:00 - 02:59
winter,2011-10-27,3,1,3,4,2659,03:00 - 04:59
winter,2011-10-27,4,1,3,4,2659,03:00 - 04:59
winter,2011-10-27,5,1,14,15,2659,05:00 - 06:59
winter,2011-10-27,6,4,42,46,2659,05:00 - 06:59
winter,2011-10-27,7,9,128,137,2659,07:00 - 08:59
winter,2011-10-27,8,12,304,316,2659,07:00 - 08:59
winter,2011-10-27,9,16,155,171,2659,09:00 - 10:59
winter,2011-10-27,10,10,52,62,2659,09:00 - 10:59
winter,2011-10-27,11,8,44,52,2659,11:00 - 12:59
winter,2011-10-27,12,8,45,53,2659,11:00 - 12:59
winter,2011-10-27,13,10,64,74,2659,13:00 - 14:59
winter,2011-10-27,14,16,76,92,2659,13:00 - 14:59
winter,2011-10-27,15,12,95,107,2659,15:00 - 16:59
winter,2011-10-27,16,14,193,207,2659,15:00 - 16:59
winter,2011-10-27,17,31,291,322,2659,17:00 - 18:59
winter,2011-10-27,18,14,226,240,2659,17:00 - 18:59
winter,2011-10-27,19,19,200,219,2659,19:00 - 20:59
winter,2011-10-27,20,11,171,182,2659,19:00 - 20:59
winter,2011-10-27,21,13,119,132,2659,21:00 - 22:59
winter,2011-10-27,22,14,97,111,2659,21:00 - 22:59
winter,2011-10-27,23,8,60,68,2659,23:00 - 24:59
winter,2011-10-28,0,4,40,44,3747,
winter,2011-10-28,1,7,9,16,3747,01:00 - 02:59
winter,2011-10-28,2,1,3,4,3747,01:00 - 02:59
winter,2011-10-28,3,4,4,8,3747,03:00 - 04:59
winter,2011-10-28,4,5,5,10,3747,03:00 - 04:59
winter,2011-10-28,5,0,25,25,3747,05:00 - 06:59
winter,2011-10-28,6,1,74,75,3747,05:00 - 06:59
winter,2011-10-28,7,6,199,205,3747,07:00 - 08:59
winter,2011-10-28,8,13,361,374,3747,07:00 - 08:59
winter,2011-10-28,9,19,210,229,3747,09:00 - 10:59
winter,2011-10-28,10,28,102,130,3747,09:00 - 10:59
winter,2011-10-28,11,40,128,168,3747,11:00 - 12:59
winter,2011-10-28,12,46,167,213,3747,11:00 - 12:59
winter,2011-10-28,13,43,185,228,3747,13:00 - 14:59
winter,2011-10-28,14,33,152,185,3747,13:00 - 14:59
winter,2011-10-28,15,44,171,215,3747,15:00 - 16:59
winter,2011-10-28,16,46,262,308,3747,15:00 - 16:59
winter,2011-10-28,17,35,411,446,3747,17:00 - 18:59
winter,2011-10-28,18,36,332,368,3747,17:00 - 18:59
winter,2011-10-28,19,16,188,204,3747,19:00 - 20:59
winter,2011-10-28,20,12,131,143,3747,19:00 - 20:59
winter,2011-10-28,21,5,69,74,3747,21:00 - 22:59
winter,2011-10-28,22,4,32,36,3747,21:00 - 22:59
winter,2011-10-28,23,8,31,39,3747,23:00 - 24:59
winter,2011-10-29,0,0,19,19,627,
winter,2011-10-29,1,0,18,18,627,01:00 - 02:59
winter,2011-10-29,2,1,16,17,627,01:00 - 02:59
winter,2011-10-29,3,0,8,8,627,03:00 - 04:59
winter,2011-10-29,4,0,1,1,627,03:00 - 04:59
winter,2011-10-29,5,0,1,1,627,05:00 - 06:59
winter,2011-10-29,6,4,1,5,627,05:00 - 06:59
winter,2011-10-29,7,1,6,7,627,07:00 - 08:59
winter,2011-10-29,8,4,16,20,627,07:00 - 08:59
winter,2011-10-29,9,1,19,20,627,09:00 - 10:59
winter,2011-10-29,10,0,12,12,627,09:00 - 10:59
winter,2011-10-29,11,1,26,27,627,11:00 - 12:59
winter,2011-10-29,12,6,44,50,627,11:00 - 12:59
winter,2011-10-29,13,0,30,30,627,13:00 - 14:59
winter,2011-10-29,14,0,29,29,627,13:00 - 14:59
winter,2011-10-29,15,3,38,41,627,15:00 - 16:59
winter,2011-10-29,16,3,19,22,627,15:00 - 16:59
winter,2011-10-29,17,3,28,31,627,17:00 - 18:59
winter,2011-10-29,18,6,37,43,627,17:00 - 18:59
winter,2011-10-29,19,3,36,39,627,19:00 - 20:59
winter,2011-10-29,20,7,40,47,627,19:00 - 20:59
winter,2011-10-29,21,1,49,50,627,21:00 - 22:59
winter,2011-10-29,22,10,44,54,627,21:00 - 22:59
winter,2011-10-29,23,3,33,36,627,23:00 - 24:59
winter,2011-10-30,0,7,47,54,3331,
winter,2011-10-30,1,9,34,43,3331,01:00 - 02:59
winter,2011-10-30,2,7,43,50,3331,01:00 - 02:59
winter,2011-10-30,3,7,26,33,3331,03:00 - 04:59
winter,2011-10-30,4,1,10,11,3331,03:00 - 04:59
winter,2011-10-30,5,0,4,4,3331,05:00 - 06:59
winter,2011-10-30,6,2,8,10,3331,05:00 - 06:59
winter,2011-10-30,7,7,15,22,3331,07:00 - 08:59
winter,2011-10-30,8,20,60,80,3331,07:00 - 08:59
winter,2011-10-30,9,55,92,147,3331,09:00 - 10:59
winter,2011-10-30,10,53,125,178,3331,09:00 - 10:59
winter,2011-10-30,11,58,182,240,3331,11:00 - 12:59
winter,2011-10-30,12,85,229,314,3331,11:00 - 12:59
winter,2011-10-30,13,113,232,345,3331,13:00 - 14:59
winter,2011-10-30,14,91,209,300,3331,13:00 - 14:59
winter,2011-10-30,15,88,202,290,3331,15:00 - 16:59
winter,2011-10-30,16,107,213,320,3331,15:00 - 16:59
winter,2011-10-30,17,54,191,245,3331,17:00 - 18:59
winter,2011-10-30,18,51,162,213,3331,17:00 - 18:59
winter,2011-10-30,19,28,125,153,3331,19:00 - 20:59
winter,2011-10-30,20,18,74,92,3331,19:00 - 20:59
winter,2011-10-30,21,4,75,79,3331,21:00 - 22:59
winter,2011-10-30,22,13,58,71,3331,21:00 - 22:59
winter,2011-10-30,23,7,30,37,3331,23:00 - 24:59
winter,2011-10-31,0,3,20,23,3669,
winter,2011-10-31,1,5,8,13,3669,01:00 - 02:59
winter,2011-10-31,2,0,3,3,3669,01:00 - 02:59
winter,2011-10-31,3,0,3,3,3669,03:00 - 04:59
winter,2011-10-31,4,1,5,6,3669,03:00 - 04:59
winter,2011-10-31,5,0,18,18,3669,05:00 - 06:59
winter,2011-10-31,6,4,82,86,3669,05:00 - 06:59
winter,2011-10-31,7,11,216,227,3669,07:00 - 08:59
winter,2011-10-31,8,17,355,372,3669,07:00 - 08:59
winter,2011-10-31,9,14,197,211,3669,09:00 - 10:59
winter,2011-10-31,10,18,87,105,3669,09:00 - 10:59
winter,2011-10-31,11,31,97,128,3669,11:00 - 12:59
winter,2011-10-31,12,30,140,170,3669,11:00 - 12:59
winter,2011-10-31,13,24,128,152,3669,13:00 - 14:59
winter,2011-10-31,14,22,119,141,3669,13:00 - 14:59
winter,2011-10-31,15,27,141,168,3669,15:00 - 16:59
winter,2011-10-31,16,30,242,272,3669,15:00 - 16:59
winter,2011-10-31,17,44,442,486,3669,17:00 - 18:59
winter,2011-10-31,18,30,392,422,3669,17:00 - 18:59
winter,2011-10-31,19,12,226,238,3669,19:00 - 20:59
winter,2011-10-31,20,18,154,172,3669,19:00 - 20:59
winter,2011-10-31,21,7,109,116,3669,21:00 - 22:59
winter,2011-10-31,22,8,77,85,3669,21:00 - 22:59
winter,2011-10-31,23,6,46,52,3669,23:00 - 24:59
winter,2011-11-01,0,3,18,21,4068,
winter,2011-11-01,1,3,8,11,4068,01:00 - 02:59
winter,2011-11-01,2,1,3,4,4068,01:00 - 02:59
winter,2011-11-01,3,1,5,6,4068,03:00 - 04:59
winter,2011-11-01,4,1,7,8,4068,03:00 - 04:59
winter,2011-11-01,5,0,18,18,4068,05:00 - 06:59
winter,2011-11-01,6,3,90,93,4068,05:00 - 06:59
winter,2011-11-01,7,8,246,254,4068,07:00 - 08:59
winter,2011-11-01,8,17,402,419,4068,07:00 - 08:59
winter,2011-11-01,9,16,206,222,4068,09:00 - 10:59
winter,2011-11-01,10,21,114,135,4068,09:00 - 10:59
winter,2011-11-01,11,16,101,117,4068,11:00 - 12:59
winter,2011-11-01,12,23,153,176,4068,11:00 - 12:59
winter,2011-11-01,13,20,147,167,4068,13:00 - 14:59
winter,2011-11-01,14,32,118,150,4068,13:00 - 14:59
winter,2011-11-01,15,38,148,186,4068,15:00 - 16:59
winter,2011-11-01,16,46,252,298,4068,15:00 - 16:59
winter,2011-11-01,17,36,470,506,4068,17:00 - 18:59
winter,2011-11-01,18,39,421,460,4068,17:00 - 18:59
winter,2011-11-01,19,39,274,313,4068,19:00 - 20:59
winter,2011-11-01,20,18,191,209,4068,19:00 - 20:59
winter,2011-11-01,21,13,114,127,4068,21:00 - 22:59
winter,2011-11-01,22,5,91,96,4068,21:00 - 22:59
winter,2011-11-01,23,11,61,72,4068,23:00 - 24:59
winter,2011-11-02,0,0,19,19,4186,
winter,2011-11-02,1,2,8,10,4186,01:00 - 02:59
winter,2011-11-02,2,0,2,2,4186,01:00 - 02:59
winter,2011-11-02,3,0,2,2,4186,03:00 - 04:59
winter,2011-11-02,4,0,4,4,4186,03:00 - 04:59
winter,2011-11-02,5,0,27,27,4186,05:00 - 06:59
winter,2011-11-02,6,1,91,92,4186,05:00 - 06:59
winter,2011-11-02,7,11,240,251,4186,07:00 - 08:59
winter,2011-11-02,8,20,452,472,4186,07:00 - 08:59
winter,2011-11-02,9,15,213,228,4186,09:00 - 10:59
winter,2011-11-02,10,25,108,133,4186,09:00 - 10:59
winter,2011-11-02,11,27,117,144,4186,11:00 - 12:59
winter,2011-11-02,12,32,157,189,4186,11:00 - 12:59
winter,2011-11-02,13,22,139,161,4186,13:00 - 14:59
winter,2011-11-02,14,40,132,172,4186,13:00 - 14:59
winter,2011-11-02,15,26,161,187,4186,15:00 - 16:59
winter,2011-11-02,16,35,231,266,4186,15:00 - 16:59
winter,2011-11-02,17,30,523,553,4186,17:00 - 18:59
winter,2011-11-02,18,31,448,479,4186,17:00 - 18:59
winter,2011-11-02,19,25,257,282,4186,19:00 - 20:59
winter,2011-11-02,20,5,177,182,4186,19:00 - 20:59
winter,2011-11-02,21,13,155,168,4186,21:00 - 22:59
winter,2011-11-02,22,7,99,106,4186,21:00 - 22:59
winter,2011-11-02,23,3,54,57,4186,23:00 - 24:59
winter,2011-11-03,0,3,28,31,3974,
winter,2011-11-03,1,3,12,15,3974,01:00 - 02:59
winter,2011-11-03,2,2,5,7,3974,01:00 - 02:59
winter,2011-11-03,3,1,4,5,3974,03:00 - 04:59
winter,2011-11-03,4,1,3,4,3974,03:00 - 04:59
winter,2011-11-03,5,1,27,28,3974,05:00 - 06:59
winter,2011-11-03,6,3,96,99,3974,05:00 - 06:59
winter,2011-11-03,7,12,280,292,3974,07:00 - 08:59
winter,2011-11-03,8,8,394,402,3974,07:00 - 08:59
winter,2011-11-03,9,9,155,164,3974,09:00 - 10:59
winter,2011-11-03,10,12,98,110,3974,09:00 - 10:59
winter,2011-11-03,11,12,108,120,3974,11:00 - 12:59
winter,2011-11-03,12,17,162,179,3974,11:00 - 12:59
winter,2011-11-03,13,19,150,169,3974,13:00 - 14:59
winter,2011-11-03,14,32,120,152,3974,13:00 - 14:59
winter,2011-11-03,15,24,138,162,3974,15:00 - 16:59
winter,2011-11-03,16,33,234,267,3974,15:00 - 16:59
winter,2011-11-03,17,33,465,498,3974,17:00 - 18:59
winter,2011-11-03,18,24,409,433,3974,17:00 - 18:59
winter,2011-11-03,19,18,234,252,3974,19:00 - 20:59
winter,2011-11-03,20,11,198,209,3974,19:00 - 20:59
winter,2011-11-03,21,4,140,144,3974,21:00 - 22:59
winter,2011-11-03,22,21,116,137,3974,21:00 - 22:59
winter,2011-11-03,23,15,80,95,3974,23:00 - 24:59
winter,2011-11-04,0,11,32,43,4046,
winter,2011-11-04,1,1,16,17,4046,01:00 - 02:59
winter,2011-11-04,2,2,8,10,4046,01:00 - 02:59
winter,2011-11-04,3,1,7,8,4046,03:00 - 04:59
winter,2011-11-04,4,1,6,7,4046,03:00 - 04:59
winter,2011-11-04,5,0,23,23,4046,05:00 - 06:59
winter,2011-11-04,6,2,64,66,4046,05:00 - 06:59
winter,2011-11-04,7,10,235,245,4046,07:00 - 08:59
winter,2011-11-04,8,8,387,395,4046,07:00 - 08:59
winter,2011-11-04,9,15,239,254,4046,09:00 - 10:59
winter,2011-11-04,10,19,115,134,4046,09:00 - 10:59
winter,2011-11-04,11,34,128,162,4046,11:00 - 12:59
winter,2011-11-04,12,44,153,197,4046,11:00 - 12:59
winter,2011-11-04,13,33,161,194,4046,13:00 - 14:59
winter,2011-11-04,14,54,147,201,4046,13:00 - 14:59
winter,2011-11-04,15,45,192,237,4046,15:00 - 16:59
winter,2011-11-04,16,53,237,290,4046,15:00 - 16:59
winter,2011-11-04,17,42,438,480,4046,17:00 - 18:59
winter,2011-11-04,18,35,339,374,4046,17:00 - 18:59
winter,2011-11-04,19,14,182,196,4046,19:00 - 20:59
winter,2011-11-04,20,15,171,186,4046,19:00 - 20:59
winter,2011-11-04,21,8,115,123,4046,21:00 - 22:59
winter,2011-11-04,22,6,109,115,4046,21:00 - 22:59
winter,2011-11-04,23,17,72,89,4046,23:00 - 24:59
winter,2011-11-05,0,4,48,52,3926,
winter,2011-11-05,1,5,57,62,3926,01:00 - 02:59
winter,2011-11-05,2,7,24,31,3926,01:00 - 02:59
winter,2011-11-05,3,0,8,8,3926,03:00 - 04:59
winter,2011-11-05,4,3,5,8,3926,03:00 - 04:59
winter,2011-11-05,5,0,2,2,3926,05:00 - 06:59
winter,2011-11-05,6,3,20,23,3926,05:00 - 06:59
winter,2011-11-05,7,3,31,34,3926,07:00 - 08:59
winter,2011-11-05,8,4,80,84,3926,07:00 - 08:59
winter,2011-11-05,9,30,111,141,3926,09:00 - 10:59
winter,2011-11-05,10,56,171,227,3926,09:00 - 10:59
winter,2011-11-05,11,69,169,238,3926,11:00 - 12:59
winter,2011-11-05,12,137,235,372,3926,11:00 - 12:59
winter,2011-11-05,13,148,207,355,3926,13:00 - 14:59
winter,2011-11-05,14,159,227,386,3926,13:00 - 14:59
winter,2011-11-05,15,141,202,343,3926,15:00 - 16:59
winter,2011-11-05,16,128,207,335,3926,15:00 - 16:59
winter,2011-11-05,17,100,234,334,3926,17:00 - 18:59
winter,2011-11-05,18,52,185,237,3926,17:00 - 18:59
winter,2011-11-05,19,45,159,204,3926,19:00 - 20:59
winter,2011-11-05,20,29,136,165,3926,19:00 - 20:59
winter,2011-11-05,21,19,99,118,3926,21:00 - 22:59
winter,2011-11-05,22,10,72,82,3926,21:00 - 22:59
winter,2011-11-05,23,4,81,85,3926,23:00 - 24:59
winter,2011-11-06,0,10,65,75,3649,
winter,2011-11-06,1,11,104,115,3649,01:00 - 02:59
winter,2011-11-06,2,6,23,29,3649,01:00 - 02:59
winter,2011-11-06,3,5,4,9,3649,03:00 - 04:59
winter,2011-11-06,4,0,6,6,3649,03:00 - 04:59
winter,2011-11-06,5,0,5,5,3649,05:00 - 06:59
winter,2011-11-06,6,5,11,16,3649,05:00 - 06:59
winter,2011-11-06,7,4,24,28,3649,07:00 - 08:59
winter,2011-11-06,8,19,71,90,3649,07:00 - 08:59
winter,2011-11-06,9,36,134,170,3649,09:00 - 10:59
winter,2011-11-06,10,76,186,262,3649,09:00 - 10:59
winter,2011-11-06,11,104,216,320,3649,11:00 - 12:59
winter,2011-11-06,12,120,226,346,3649,11:00 - 12:59
winter,2011-11-06,13,105,209,314,3649,13:00 - 14:59
winter,2011-11-06,14,101,219,320,3649,13:00 - 14:59
winter,2011-11-06,15,96,210,306,3649,15:00 - 16:59
winter,2011-11-06,16,84,263,347,3649,15:00 - 16:59
winter,2011-11-06,17,71,185,256,3649,17:00 - 18:59
winter,2011-11-06,18,39,146,185,3649,17:00 - 18:59
winter,2011-11-06,19,21,130,151,3649,19:00 - 20:59
winter,2011-11-06,20,16,100,116,3649,19:00 - 20:59
winter,2011-11-06,21,11,77,88,3649,21:00 - 22:59
winter,2011-11-06,22,5,40,45,3649,21:00 - 22:59
winter,2011-11-06,23,7,43,50,3649,23:00 - 24:59
winter,2011-11-07,0,1,14,15,4035,
winter,2011-11-07,1,2,6,8,4035,01:00 - 02:59
winter,2011-11-07,2,0,2,2,4035,01:00 - 02:59
winter,2011-11-07,3,0,3,3,4035,03:00 - 04:59
winter,2011-11-07,4,2,4,6,4035,03:00 - 04:59
winter,2011-11-07,5,1,25,26,4035,05:00 - 06:59
winter,2011-11-07,6,2,97,99,4035,05:00 - 06:59
winter,2011-11-07,7,6,305,311,4035,07:00 - 08:59
winter,2011-11-07,8,13,397,410,4035,07:00 - 08:59
winter,2011-11-07,9,18,156,174,4035,09:00 - 10:59
winter,2011-11-07,10,28,95,123,4035,09:00 - 10:59
winter,2011-11-07,11,28,100,128,4035,11:00 - 12:59
winter,2011-11-07,12,21,158,179,4035,11:00 - 12:59
winter,2011-11-07,13,32,157,189,4035,13:00 - 14:59
winter,2011-11-07,14,30,115,145,4035,13:00 - 14:59
winter,2011-11-07,15,38,132,170,4035,15:00 - 16:59
winter,2011-11-07,16,40,255,295,4035,15:00 - 16:59
winter,2011-11-07,17,39,489,528,4035,17:00 - 18:59
winter,2011-11-07,18,18,407,425,4035,17:00 - 18:59
winter,2011-11-07,19,20,280,300,4035,19:00 - 20:59
winter,2011-11-07,20,17,187,204,4035,19:00 - 20:59
winter,2011-11-07,21,10,129,139,4035,21:00 - 22:59
winter,2011-11-07,22,6,102,108,4035,21:00 - 22:59
winter,2011-11-07,23,1,47,48,4035,23:00 - 24:59
winter,2011-11-08,0,0,18,18,4205,
winter,2011-11-08,1,3,8,11,4205,01:00 - 02:59
winter,2011-11-08,2,0,1,1,4205,01:00 - 02:59
winter,2011-11-08,3,0,3,3,4205,03:00 - 04:59
winter,2011-11-08,4,0,4,4,4205,03:00 - 04:59
winter,2011-11-08,5,1,17,18,4205,05:00 - 06:59
winter,2011-11-08,6,3,96,99,4205,05:00 - 06:59
winter,2011-11-08,7,7,316,323,4205,07:00 - 08:59
winter,2011-11-08,8,11,455,466,4205,07:00 - 08:59
winter,2011-11-08,9,14,177,191,4205,09:00 - 10:59
winter,2011-11-08,10,25,104,129,4205,09:00 - 10:59
winter,2011-11-08,11,21,126,147,4205,11:00 - 12:59
winter,2011-11-08,12,28,175,203,4205,11:00 - 12:59
winter,2011-11-08,13,31,165,196,4205,13:00 - 14:59
winter,2011-11-08,14,32,129,161,4205,13:00 - 14:59
winter,2011-11-08,15,33,155,188,4205,15:00 - 16:59
winter,2011-11-08,16,39,250,289,4205,15:00 - 16:59
winter,2011-11-08,17,40,459,499,4205,17:00 - 18:59
winter,2011-11-08,18,30,432,462,4205,17:00 - 18:59
winter,2011-11-08,19,14,264,278,4205,19:00 - 20:59
winter,2011-11-08,20,12,169,181,4205,19:00 - 20:59
winter,2011-11-08,21,16,166,182,4205,21:00 - 22:59
winter,2011-11-08,22,13,95,108,4205,21:00 - 22:59
winter,2011-11-08,23,3,45,48,4205,23:00 - 24:59
winter,2011-11-09,0,0,13,13,4109,
winter,2011-11-09,1,0,10,10,4109,01:00 - 02:59
winter,2011-11-09,2,0,5,5,4109,01:00 - 02:59
winter,2011-11-09,3,0,4,4,4109,03:00 - 04:59
winter,2011-11-09,4,0,4,4,4109,03:00 - 04:59
winter,2011-11-09,5,0,28,28,4109,05:00 - 06:59
winter,2011-11-09,6,0,98,98,4109,05:00 - 06:59
winter,2011-11-09,7,0,300,300,4109,07:00 - 08:59
winter,2011-11-09,8,19,437,456,4109,07:00 - 08:59
winter,2011-11-09,9,22,197,219,4109,09:00 - 10:59
winter,2011-11-09,10,16,89,105,4109,09:00 - 10:59
winter,2011-11-09,11,21,131,152,4109,11:00 - 12:59
winter,2011-11-09,12,24,156,180,4109,11:00 - 12:59
winter,2011-11-09,13,31,136,167,4109,13:00 - 14:59
winter,2011-11-09,14,26,153,179,4109,13:00 - 14:59
winter,2011-11-09,15,21,130,151,4109,15:00 - 16:59
winter,2011-11-09,16,24,257,281,4109,15:00 - 16:59
winter,2011-11-09,17,27,458,485,4109,17:00 - 18:59
winter,2011-11-09,18,21,387,408,4109,17:00 - 18:59
winter,2011-11-09,19,12,292,304,4109,19:00 - 20:59
winter,2011-11-09,20,18,201,219,4109,19:00 - 20:59
winter,2011-11-09,21,9,152,161,4109,21:00 - 22:59
winter,2011-11-09,22,9,105,114,4109,21:00 - 22:59
winter,2011-11-09,23,5,61,66,4109,23:00 - 24:59
winter,2011-11-10,0,0,24,24,2933,
winter,2011-11-10,1,1,10,11,2933,01:00 - 02:59
winter,2011-11-10,2,0,5,5,2933,01:00 - 02:59
winter,2011-11-10,3,0,11,11,2933,03:00 - 04:59
winter,2011-11-10,4,1,2,3,2933,03:00 - 04:59
winter,2011-11-10,5,1,22,23,2933,05:00 - 06:59
winter,2011-11-10,6,4,110,114,2933,05:00 - 06:59
winter,2011-11-10,7,6,266,272,2933,07:00 - 08:59
winter,2011-11-10,8,18,418,436,2933,07:00 - 08:59
winter,2011-11-10,9,23,188,211,2933,09:00 - 10:59
winter,2011-11-10,10,17,100,117,2933,09:00 - 10:59
winter,2011-11-10,11,9,99,108,2933,11:00 - 12:59
winter,2011-11-10,12,18,149,167,2933,11:00 - 12:59
winter,2011-11-10,13,9,87,96,2933,13:00 - 14:59
winter,2011-11-10,14,6,58,64,2933,13:00 - 14:59
winter,2011-11-10,15,5,57,62,2933,15:00 - 16:59
winter,2011-11-10,16,6,67,73,2933,15:00 - 16:59
winter,2011-11-10,17,9,168,177,2933,17:00 - 18:59
winter,2011-11-10,18,10,263,273,2933,17:00 - 18:59
winter,2011-11-10,19,19,192,211,2933,19:00 - 20:59
winter,2011-11-10,20,8,160,168,2933,19:00 - 20:59
winter,2011-11-10,21,6,130,136,2933,21:00 - 22:59
winter,2011-11-10,22,5,84,89,2933,21:00 - 22:59
winter,2011-11-10,23,9,73,82,2933,23:00 - 24:59
winter,2011-11-11,0,10,56,66,3368,
winter,2011-11-11,1,3,16,19,3368,01:00 - 02:59
winter,2011-11-11,2,1,10,11,3368,01:00 - 02:59
winter,2011-11-11,3,0,6,6,3368,03:00 - 04:59
winter,2011-11-11,4,0,8,8,3368,03:00 - 04:59
winter,2011-11-11,5,0,13,13,3368,05:00 - 06:59
winter,2011-11-11,6,0,46,46,3368,05:00 - 06:59
winter,2011-11-11,7,5,116,121,3368,07:00 - 08:59
winter,2011-11-11,8,9,249,258,3368,07:00 - 08:59
winter,2011-11-11,9,15,186,201,3368,09:00 - 10:59
winter,2011-11-11,10,38,162,200,3368,09:00 - 10:59
winter,2011-11-11,11,20,150,170,3368,11:00 - 12:59
winter,2011-11-11,12,41,198,239,3368,11:00 - 12:59
winter,2011-11-11,13,57,179,236,3368,13:00 - 14:59
winter,2011-11-11,14,64,183,247,3368,13:00 - 14:59
winter,2011-11-11,15,29,187,216,3368,15:00 - 16:59
winter,2011-11-11,16,49,189,238,3368,15:00 - 16:59
winter,2011-11-11,17,24,286,310,3368,17:00 - 18:59
winter,2011-11-11,18,23,185,208,3368,17:00 - 18:59
winter,2011-11-11,19,17,182,199,3368,19:00 - 20:59
winter,2011-11-11,20,12,97,109,3368,19:00 - 20:59
winter,2011-11-11,21,4,79,83,3368,21:00 - 22:59
winter,2011-11-11,22,13,78,91,3368,21:00 - 22:59
winter,2011-11-11,23,6,67,73,3368,23:00 - 24:59
winter,2011-11-12,0,12,52,64,4067,
winter,2011-11-12,1,9,45,54,4067,01:00 - 02:59
winter,2011-11-12,2,7,39,46,4067,01:00 - 02:59
winter,2011-11-12,3,4,13,17,4067,03:00 - 04:59
winter,2011-11-12,4,0,7,7,4067,03:00 - 04:59
winter,2011-11-12,5,1,3,4,4067,05:00 - 06:59
winter,2011-11-12,6,0,7,7,4067,05:00 - 06:59
winter,2011-11-12,7,3,24,27,4067,07:00 - 08:59
winter,2011-11-12,8,14,87,101,4067,07:00 - 08:59
winter,2011-11-12,9,18,142,160,4067,09:00 - 10:59
winter,2011-11-12,10,62,170,232,4067,09:00 - 10:59
winter,2011-11-12,11,102,213,315,4067,11:00 - 12:59
winter,2011-11-12,12,142,224,366,4067,11:00 - 12:59
winter,2011-11-12,13,128,225,353,4067,13:00 - 14:59
winter,2011-11-12,14,191,244,435,4067,13:00 - 14:59
winter,2011-11-12,15,165,221,386,4067,15:00 - 16:59
winter,2011-11-12,16,137,224,361,4067,15:00 - 16:59
winter,2011-11-12,17,92,193,285,4067,17:00 - 18:59
winter,2011-11-12,18,53,150,203,4067,17:00 - 18:59
winter,2011-11-12,19,32,139,171,4067,19:00 - 20:59
winter,2011-11-12,20,31,101,132,4067,19:00 - 20:59
winter,2011-11-12,21,19,103,122,4067,21:00 - 22:59
winter,2011-11-12,22,30,88,118,4067,21:00 - 22:59
winter,2011-11-12,23,23,78,101,4067,23:00 - 24:59
winter,2011-11-13,0,12,61,73,3717,
winter,2011-11-13,1,13,58,71,3717,01:00 - 02:59
winter,2011-11-13,2,9,48,57,3717,01:00 - 02:59
winter,2011-11-13,3,8,20,28,3717,03:00 - 04:59
winter,2011-11-13,4,1,5,6,3717,03:00 - 04:59
winter,2011-11-13,5,2,3,5,3717,05:00 - 06:59
winter,2011-11-13,6,5,18,23,3717,05:00 - 06:59
winter,2011-11-13,7,13,30,43,3717,07:00 - 08:59
winter,2011-11-13,8,24,55,79,3717,07:00 - 08:59
winter,2011-11-13,9,38,97,135,3717,09:00 - 10:59
winter,2011-11-13,10,63,178,241,3717,09:00 - 10:59
winter,2011-11-13,11,108,187,295,3717,11:00 - 12:59
winter,2011-11-13,12,112,242,354,3717,11:00 - 12:59
winter,2011-11-13,13,105,234,339,3717,13:00 - 14:59
winter,2011-11-13,14,108,263,371,3717,13:00 - 14:59
winter,2011-11-13,15,89,221,310,3717,15:00 - 16:59
winter,2011-11-13,16,93,226,319,3717,15:00 - 16:59
winter,2011-11-13,17,44,187,231,3717,17:00 - 18:59
winter,2011-11-13,18,35,155,190,3717,17:00 - 18:59
winter,2011-11-13,19,36,121,157,3717,19:00 - 20:59
winter,2011-11-13,20,24,115,139,3717,19:00 - 20:59
winter,2011-11-13,21,19,76,95,3717,21:00 - 22:59
winter,2011-11-13,22,25,64,89,3717,21:00 - 22:59
winter,2011-11-13,23,18,49,67,3717,23:00 - 24:59
winter,2011-11-14,0,8,22,30,4486,
winter,2011-11-14,1,5,6,11,4486,01:00 - 02:59
winter,2011-11-14,2,7,10,17,4486,01:00 - 02:59
winter,2011-11-14,3,4,3,7,4486,03:00 - 04:59
winter,2011-11-14,4,0,5,5,4486,03:00 - 04:59
winter,2011-11-14,5,0,19,19,4486,05:00 - 06:59
winter,2011-11-14,6,10,104,114,4486,05:00 - 06:59
winter,2011-11-14,7,11,311,322,4486,07:00 - 08:59
winter,2011-11-14,8,27,425,452,4486,07:00 - 08:59
winter,2011-11-14,9,29,204,233,4486,09:00 - 10:59
winter,2011-11-14,10,26,85,111,4486,09:00 - 10:59
winter,2011-11-14,11,22,106,128,4486,11:00 - 12:59
winter,2011-11-14,12,36,166,202,4486,11:00 - 12:59
winter,2011-11-14,13,50,153,203,4486,13:00 - 14:59
winter,2011-11-14,14,47,138,185,4486,13:00 - 14:59
winter,2011-11-14,15,53,142,195,4486,15:00 - 16:59
winter,2011-11-14,16,51,264,315,4486,15:00 - 16:59
winter,2011-11-14,17,55,464,519,4486,17:00 - 18:59
winter,2011-11-14,18,29,460,489,4486,17:00 - 18:59
winter,2011-11-14,19,28,274,302,4486,19:00 - 20:59
winter,2011-11-14,20,30,210,240,4486,19:00 - 20:59
winter,2011-11-14,21,37,176,213,4486,21:00 - 22:59
winter,2011-11-14,22,17,96,113,4486,21:00 - 22:59
winter,2011-11-14,23,13,48,61,4486,23:00 - 24:59
winter,2011-11-15,0,7,15,22,4195,
winter,2011-11-15,1,5,5,10,4195,01:00 - 02:59
winter,2011-11-15,2,7,8,15,4195,01:00 - 02:59
winter,2011-11-15,3,0,4,4,4195,03:00 - 04:59
winter,2011-11-15,4,1,6,7,4195,03:00 - 04:59
winter,2011-11-15,5,2,26,28,4195,05:00 - 06:59
winter,2011-11-15,6,4,104,108,4195,05:00 - 06:59
winter,2011-11-15,7,21,298,319,4195,07:00 - 08:59
winter,2011-11-15,8,27,453,480,4195,07:00 - 08:59
winter,2011-11-15,9,26,174,200,4195,09:00 - 10:59
winter,2011-11-15,10,23,115,138,4195,09:00 - 10:59
winter,2011-11-15,11,18,116,134,4195,11:00 - 12:59
winter,2011-11-15,12,28,148,176,4195,11:00 - 12:59
winter,2011-11-15,13,21,132,153,4195,13:00 - 14:59
winter,2011-11-15,14,27,120,147,4195,13:00 - 14:59
winter,2011-11-15,15,36,155,191,4195,15:00 - 16:59
winter,2011-11-15,16,31,240,271,4195,15:00 - 16:59
winter,2011-11-15,17,29,422,451,4195,17:00 - 18:59
winter,2011-11-15,18,27,414,441,4195,17:00 - 18:59
winter,2011-11-15,19,27,259,286,4195,19:00 - 20:59
winter,2011-11-15,20,26,212,238,4195,19:00 - 20:59
winter,2011-11-15,21,23,145,168,4195,21:00 - 22:59
winter,2011-11-15,22,19,109,128,4195,21:00 - 22:59
winter,2011-11-15,23,14,66,80,4195,23:00 - 24:59
winter,2011-11-16,0,5,26,31,1817,
winter,2011-11-16,1,0,5,5,1817,01:00 - 02:59
winter,2011-11-16,2,4,6,10,1817,01:00 - 02:59
winter,2011-11-16,3,2,3,5,1817,03:00 - 04:59
winter,2011-11-16,4,1,3,4,1817,03:00 - 04:59
winter,2011-11-16,5,0,13,13,1817,05:00 - 06:59
winter,2011-11-16,6,4,52,56,1817,05:00 - 06:59
winter,2011-11-16,7,7,130,137,1817,07:00 - 08:59
winter,2011-11-16,8,9,223,232,1817,07:00 - 08:59
winter,2011-11-16,9,5,77,82,1817,09:00 - 10:59
winter,2011-11-16,10,4,32,36,1817,09:00 - 10:59
winter,2011-11-16,11,7,53,60,1817,11:00 - 12:59
winter,2011-11-16,12,5,49,54,1817,11:00 - 12:59
winter,2011-11-16,13,6,52,58,1817,13:00 - 14:59
winter,2011-11-16,14,12,49,61,1817,13:00 - 14:59
winter,2011-11-16,15,16,50,66,1817,15:00 - 16:59
winter,2011-11-16,16,13,110,123,1817,15:00 - 16:59
winter,2011-11-16,17,17,216,233,1817,17:00 - 18:59
winter,2011-11-16,18,13,176,189,1817,17:00 - 18:59
winter,2011-11-16,19,3,108,111,1817,19:00 - 20:59
winter,2011-11-16,20,5,94,99,1817,19:00 - 20:59
winter,2011-11-16,21,3,72,75,1817,21:00 - 22:59
winter,2011-11-16,22,1,45,46,1817,21:00 - 22:59
winter,2011-11-16,23,3,28,31,1817,23:00 - 24:59
winter,2011-11-17,0,2,22,24,3053,
winter,2011-11-17,1,0,5,5,3053,01:00 - 02:59
winter,2011-11-17,2,0,5,5,3053,01:00 - 02:59
winter,2011-11-17,3,0,3,3,3053,03:00 - 04:59
winter,2011-11-17,4,1,3,4,3053,03:00 - 04:59
winter,2011-11-17,5,1,21,22,3053,05:00 - 06:59
winter,2011-11-17,6,3,72,75,3053,05:00 - 06:59
winter,2011-11-17,7,4,164,168,3053,07:00 - 08:59
winter,2011-11-17,8,12,343,355,3053,07:00 - 08:59
winter,2011-11-17,9,14,184,198,3053,09:00 - 10:59
winter,2011-11-17,10,7,74,81,3053,09:00 - 10:59
winter,2011-11-17,11,4,93,97,3053,11:00 - 12:59
winter,2011-11-17,12,6,115,121,3053,11:00 - 12:59
winter,2011-11-17,13,15,109,124,3053,13:00 - 14:59
winter,2011-11-17,14,5,105,110,3053,13:00 - 14:59
winter,2011-11-17,15,10,106,116,3053,15:00 - 16:59
winter,2011-11-17,16,8,187,195,3053,15:00 - 16:59
winter,2011-11-17,17,20,379,399,3053,17:00 - 18:59
winter,2011-11-17,18,9,298,307,3053,17:00 - 18:59
winter,2011-11-17,19,7,210,217,3053,19:00 - 20:59
winter,2011-11-17,20,7,162,169,3053,19:00 - 20:59
winter,2011-11-17,21,3,113,116,3053,21:00 - 22:59
winter,2011-11-17,22,1,83,84,3053,21:00 - 22:59
winter,2011-11-17,23,0,58,58,3053,23:00 - 24:59
winter,2011-11-18,0,2,28,30,3392,
winter,2011-11-18,1,0,10,10,3392,01:00 - 02:59
winter,2011-11-18,2,2,8,10,3392,01:00 - 02:59
winter,2011-11-18,3,0,2,2,3392,03:00 - 04:59
winter,2011-11-18,4,0,5,5,3392,03:00 - 04:59
winter,2011-11-18,5,0,22,22,3392,05:00 - 06:59
winter,2011-11-18,6,1,70,71,3392,05:00 - 06:59
winter,2011-11-18,7,5,211,216,3392,07:00 - 08:59
winter,2011-11-18,8,6,369,375,3392,07:00 - 08:59
winter,2011-11-18,9,6,207,213,3392,09:00 - 10:59
winter,2011-11-18,10,10,105,115,3392,09:00 - 10:59
winter,2011-11-18,11,18,122,140,3392,11:00 - 12:59
winter,2011-11-18,12,22,143,165,3392,11:00 - 12:59
winter,2011-11-18,13,31,146,177,3392,13:00 - 14:59
winter,2011-11-18,14,31,123,154,3392,13:00 - 14:59
winter,2011-11-18,15,27,151,178,3392,15:00 - 16:59
winter,2011-11-18,16,19,190,209,3392,15:00 - 16:59
winter,2011-11-18,17,17,361,378,3392,17:00 - 18:59
winter,2011-11-18,18,16,312,328,3392,17:00 - 18:59
winter,2011-11-18,19,7,183,190,3392,19:00 - 20:59
winter,2011-11-18,20,8,129,137,3392,19:00 - 20:59
winter,2011-11-18,21,3,108,111,3392,21:00 - 22:59
winter,2011-11-18,22,9,88,97,3392,21:00 - 22:59
winter,2011-11-18,23,5,54,59,3392,23:00 - 24:59
winter,2011-11-19,0,4,49,53,3663,
winter,2011-11-19,1,1,34,35,3663,01:00 - 02:59
winter,2011-11-19,2,12,34,46,3663,01:00 - 02:59
winter,2011-11-19,3,4,11,15,3663,03:00 - 04:59
winter,2011-11-19,4,4,4,8,3663,03:00 - 04:59
winter,2011-11-19,5,0,2,2,3663,05:00 - 06:59
winter,2011-11-19,6,2,10,12,3663,05:00 - 06:59
winter,2011-11-19,7,3,38,41,3663,07:00 - 08:59
winter,2011-11-19,8,12,80,92,3663,07:00 - 08:59
winter,2011-11-19,9,12,130,142,3663,09:00 - 10:59
winter,2011-11-19,10,35,165,200,3663,09:00 - 10:59
winter,2011-11-19,11,50,183,233,3663,11:00 - 12:59
winter,2011-11-19,12,93,218,311,3663,11:00 - 12:59
winter,2011-11-19,13,118,245,363,3663,13:00 - 14:59
winter,2011-11-19,14,121,228,349,3663,13:00 - 14:59
winter,2011-11-19,15,120,262,382,3663,15:00 - 16:59
winter,2011-11-19,16,99,188,287,3663,15:00 - 16:59
winter,2011-11-19,17,61,171,232,3663,17:00 - 18:59
winter,2011-11-19,18,36,172,208,3663,17:00 - 18:59
winter,2011-11-19,19,33,149,182,3663,19:00 - 20:59
winter,2011-11-19,20,48,115,163,3663,19:00 - 20:59
winter,2011-11-19,21,29,79,108,3663,21:00 - 22:59
winter,2011-11-19,22,26,80,106,3663,21:00 - 22:59
winter,2011-11-19,23,20,73,93,3663,23:00 - 24:59
winter,2011-11-20,0,14,79,93,3520,
winter,2011-11-20,1,11,73,84,3520,01:00 - 02:59
winter,2011-11-20,2,12,44,56,3520,01:00 - 02:59
winter,2011-11-20,3,6,31,37,3520,03:00 - 04:59
winter,2011-11-20,4,2,10,12,3520,03:00 - 04:59
winter,2011-11-20,5,0,4,4,3520,05:00 - 06:59
winter,2011-11-20,6,3,6,9,3520,05:00 - 06:59
winter,2011-11-20,7,4,19,23,3520,07:00 - 08:59
winter,2011-11-20,8,13,52,65,3520,07:00 - 08:59
winter,2011-11-20,9,29,109,138,3520,09:00 - 10:59
winter,2011-11-20,10,46,183,229,3520,09:00 - 10:59
winter,2011-11-20,11,74,212,286,3520,11:00 - 12:59
winter,2011-11-20,12,70,234,304,3520,11:00 - 12:59
winter,2011-11-20,13,84,285,369,3520,13:00 - 14:59
winter,2011-11-20,14,113,250,363,3520,13:00 - 14:59
winter,2011-11-20,15,109,242,351,3520,15:00 - 16:59
winter,2011-11-20,16,81,225,306,3520,15:00 - 16:59
winter,2011-11-20,17,35,168,203,3520,17:00 - 18:59
winter,2011-11-20,18,22,123,145,3520,17:00 - 18:59
winter,2011-11-20,19,17,140,157,3520,19:00 - 20:59
winter,2011-11-20,20,23,90,113,3520,19:00 - 20:59
winter,2011-11-20,21,11,94,105,3520,21:00 - 22:59
winter,2011-11-20,22,5,35,40,3520,21:00 - 22:59
winter,2011-11-20,23,3,25,28,3520,23:00 - 24:59
winter,2011-11-21,0,4,13,17,2765,
winter,2011-11-21,1,4,8,12,2765,01:00 - 02:59
winter,2011-11-21,2,1,2,3,2765,01:00 - 02:59
winter,2011-11-21,3,0,4,4,2765,03:00 - 04:59
winter,2011-11-21,4,0,5,5,2765,03:00 - 04:59
winter,2011-11-21,5,0,20,20,2765,05:00 - 06:59
winter,2011-11-21,6,0,76,76,2765,05:00 - 06:59
winter,2011-11-21,7,17,229,246,2765,07:00 - 08:59
winter,2011-11-21,8,13,378,391,2765,07:00 - 08:59
winter,2011-11-21,9,15,222,237,2765,09:00 - 10:59
winter,2011-11-21,10,25,110,135,2765,09:00 - 10:59
winter,2011-11-21,11,16,112,128,2765,11:00 - 12:59
winter,2011-11-21,12,24,138,162,2765,11:00 - 12:59
winter,2011-11-21,13,13,121,134,2765,13:00 - 14:59
winter,2011-11-21,14,14,121,135,2765,13:00 - 14:59
winter,2011-11-21,15,15,93,108,2765,15:00 - 16:59
winter,2011-11-21,16,13,95,108,2765,15:00 - 16:59
winter,2011-11-21,17,10,200,210,2765,17:00 - 18:59
winter,2011-11-21,18,8,184,192,2765,17:00 - 18:59
winter,2011-11-21,19,2,135,137,2765,19:00 - 20:59
winter,2011-11-21,20,5,75,80,2765,19:00 - 20:59
winter,2011-11-21,21,11,103,114,2765,21:00 - 22:59
winter,2011-11-21,22,6,72,78,2765,21:00 - 22:59
winter,2011-11-21,23,4,29,33,2765,23:00 - 24:59
winter,2011-11-22,0,0,14,14,1607,
winter,2011-11-22,1,1,5,6,1607,01:00 - 02:59
winter,2011-11-22,2,2,4,6,1607,01:00 - 02:59
winter,2011-11-22,3,1,2,3,1607,03:00 - 04:59
winter,2011-11-22,4,0,7,7,1607,03:00 - 04:59
winter,2011-11-22,5,1,17,18,1607,05:00 - 06:59
winter,2011-11-22,6,1,63,64,1607,05:00 - 06:59
winter,2011-11-22,7,2,119,121,1607,07:00 - 08:59
winter,2011-11-22,8,5,185,190,1607,07:00 - 08:59
winter,2011-11-22,9,2,147,149,1607,09:00 - 10:59
winter,2011-11-22,10,6,46,52,1607,09:00 - 10:59
winter,2011-11-22,11,4,28,32,1607,11:00 - 12:59
winter,2011-11-22,12,3,18,21,1607,11:00 - 12:59
winter,2011-11-22,13,4,22,26,1607,13:00 - 14:59
winter,2011-11-22,14,4,31,35,1607,13:00 - 14:59
winter,2011-11-22,15,2,32,34,1607,15:00 - 16:59
winter,2011-11-22,16,3,59,62,1607,15:00 - 16:59
winter,2011-11-22,17,4,161,165,1607,17:00 - 18:59
winter,2011-11-22,18,0,148,148,1607,17:00 - 18:59
winter,2011-11-22,19,5,106,111,1607,19:00 - 20:59
winter,2011-11-22,20,6,121,127,1607,19:00 - 20:59
winter,2011-11-22,21,4,86,90,1607,21:00 - 22:59
winter,2011-11-22,22,6,81,87,1607,21:00 - 22:59
winter,2011-11-22,23,3,36,39,1607,23:00 - 24:59
winter,2011-11-23,0,2,14,16,2566,
winter,2011-11-23,1,0,8,8,2566,01:00 - 02:59
winter,2011-11-23,2,1,5,6,2566,01:00 - 02:59
winter,2011-11-23,3,1,2,3,2566,03:00 - 04:59
winter,2011-11-23,4,0,5,5,2566,03:00 - 04:59
winter,2011-11-23,5,1,16,17,2566,05:00 - 06:59
winter,2011-11-23,6,1,68,69,2566,05:00 - 06:59
winter,2011-11-23,7,2,154,156,2566,07:00 - 08:59
winter,2011-11-23,8,7,316,323,2566,07:00 - 08:59
winter,2011-11-23,9,3,164,167,2566,09:00 - 10:59
winter,2011-11-23,10,6,70,76,2566,09:00 - 10:59
winter,2011-11-23,11,9,107,116,2566,11:00 - 12:59
winter,2011-11-23,12,9,151,160,2566,11:00 - 12:59
winter,2011-11-23,13,12,162,174,2566,13:00 - 14:59
winter,2011-11-23,14,13,200,213,2566,13:00 - 14:59
winter,2011-11-23,15,13,194,207,2566,15:00 - 16:59
winter,2011-11-23,16,4,169,173,2566,15:00 - 16:59
winter,2011-11-23,17,7,156,163,2566,17:00 - 18:59
winter,2011-11-23,18,7,138,145,2566,17:00 - 18:59
winter,2011-11-23,19,6,116,122,2566,19:00 - 20:59
winter,2011-11-23,20,1,67,68,2566,19:00 - 20:59
winter,2011-11-23,21,0,66,66,2566,21:00 - 22:59
winter,2011-11-23,22,3,59,62,2566,21:00 - 22:59
winter,2011-11-23,23,4,47,51,2566,23:00 - 24:59
winter,2011-11-24,0,1,22,23,1495,
winter,2011-11-24,1,1,23,24,1495,01:00 - 02:59
winter,2011-11-24,2,3,19,22,1495,01:00 - 02:59
winter,2011-11-24,3,1,4,5,1495,03:00 - 04:59
winter,2011-11-24,4,1,1,2,1495,03:00 - 04:59
winter,2011-11-24,5,1,10,11,1495,05:00 - 06:59
winter,2011-11-24,6,1,5,6,1495,05:00 - 06:59
winter,2011-11-24,7,9,31,40,1495,07:00 - 08:59
winter,2011-11-24,8,4,42,46,1495,07:00 - 08:59
winter,2011-11-24,9,13,68,81,1495,09:00 - 10:59
winter,2011-11-24,10,34,64,98,1495,09:00 - 10:59
winter,2011-11-24,11,52,90,142,1495,11:00 - 12:59
winter,2011-11-24,12,62,88,150,1495,11:00 - 12:59
winter,2011-11-24,13,84,91,175,1495,13:00 - 14:59
winter,2011-11-24,14,74,94,168,1495,13:00 - 14:59
winter,2011-11-24,15,78,71,149,1495,15:00 - 16:59
winter,2011-11-24,16,48,66,114,1495,15:00 - 16:59
winter,2011-11-24,17,34,40,74,1495,17:00 - 18:59
winter,2011-11-24,18,13,24,37,1495,17:00 - 18:59
winter,2011-11-24,19,15,13,28,1495,19:00 - 20:59
winter,2011-11-24,20,14,17,31,1495,19:00 - 20:59
winter,2011-11-24,21,7,19,26,1495,21:00 - 22:59
winter,2011-11-24,22,8,14,22,1495,21:00 - 22:59
winter,2011-11-24,23,2,19,21,1495,23:00 - 24:59
winter,2011-11-25,0,7,22,29,2792,
winter,2011-11-25,1,2,12,14,2792,01:00 - 02:59
winter,2011-11-25,2,4,6,10,2792,01:00 - 02:59
winter,2011-11-25,3,0,2,2,2792,03:00 - 04:59
winter,2011-11-25,4,4,3,7,2792,03:00 - 04:59
winter,2011-11-25,5,2,3,5,2792,05:00 - 06:59
winter,2011-11-25,6,4,9,13,2792,05:00 - 06:59
winter,2011-11-25,7,4,31,35,2792,07:00 - 08:59
winter,2011-11-25,8,6,68,74,2792,07:00 - 08:59
winter,2011-11-25,9,25,70,95,2792,09:00 - 10:59
winter,2011-11-25,10,60,82,142,2792,09:00 - 10:59
winter,2011-11-25,11,99,127,226,2792,11:00 - 12:59
winter,2011-11-25,12,126,146,272,2792,11:00 - 12:59
winter,2011-11-25,13,143,140,283,2792,13:00 - 14:59
winter,2011-11-25,14,122,150,272,2792,13:00 - 14:59
winter,2011-11-25,15,165,145,310,2792,15:00 - 16:59
winter,2011-11-25,16,122,139,261,2792,15:00 - 16:59
winter,2011-11-25,17,57,127,184,2792,17:00 - 18:59
winter,2011-11-25,18,45,108,153,2792,17:00 - 18:59
winter,2011-11-25,19,38,96,134,2792,19:00 - 20:59
winter,2011-11-25,20,19,76,95,2792,19:00 - 20:59
winter,2011-11-25,21,24,61,85,2792,21:00 - 22:59
winter,2011-11-25,22,12,46,58,2792,21:00 - 22:59
winter,2011-11-25,23,5,28,33,2792,23:00 - 24:59
winter,2011-11-26,0,9,38,47,3068,
winter,2011-11-26,1,5,24,29,3068,01:00 - 02:59
winter,2011-11-26,2,3,20,23,3068,01:00 - 02:59
winter,2011-11-26,3,8,9,17,3068,03:00 - 04:59
winter,2011-11-26,4,0,4,4,3068,03:00 - 04:59
winter,2011-11-26,5,0,3,3,3068,05:00 - 06:59
winter,2011-11-26,6,2,8,10,3068,05:00 - 06:59
winter,2011-11-26,7,4,13,17,3068,07:00 - 08:59
winter,2011-11-26,8,10,50,60,3068,07:00 - 08:59
winter,2011-11-26,9,16,67,83,3068,09:00 - 10:59
winter,2011-11-26,10,57,84,141,3068,09:00 - 10:59
winter,2011-11-26,11,107,123,230,3068,11:00 - 12:59
winter,2011-11-26,12,137,172,309,3068,11:00 - 12:59
winter,2011-11-26,13,177,148,325,3068,13:00 - 14:59
winter,2011-11-26,14,141,158,299,3068,13:00 - 14:59
winter,2011-11-26,15,154,160,314,3068,15:00 - 16:59
winter,2011-11-26,16,137,138,275,3068,15:00 - 16:59
winter,2011-11-26,17,62,122,184,3068,17:00 - 18:59
winter,2011-11-26,18,67,118,185,3068,17:00 - 18:59
winter,2011-11-26,19,46,100,146,3068,19:00 - 20:59
winter,2011-11-26,20,55,86,141,3068,19:00 - 20:59
winter,2011-11-26,21,20,72,92,3068,21:00 - 22:59
winter,2011-11-26,22,14,51,65,3068,21:00 - 22:59
winter,2011-11-26,23,18,51,69,3068,23:00 - 24:59
winter,2011-11-27,0,7,39,46,3071,
winter,2011-11-27,1,9,35,44,3071,01:00 - 02:59
winter,2011-11-27,2,9,22,31,3071,01:00 - 02:59
winter,2011-11-27,3,9,8,17,3071,03:00 - 04:59
winter,2011-11-27,4,0,4,4,3071,03:00 - 04:59
winter,2011-11-27,5,0,5,5,3071,05:00 - 06:59
winter,2011-11-27,6,0,9,9,3071,05:00 - 06:59
winter,2011-11-27,7,12,11,23,3071,07:00 - 08:59
winter,2011-11-27,8,6,36,42,3071,07:00 - 08:59
winter,2011-11-27,9,21,90,111,3071,09:00 - 10:59
winter,2011-11-27,10,58,131,189,3071,09:00 - 10:59
winter,2011-11-27,11,83,157,240,3071,11:00 - 12:59
winter,2011-11-27,12,63,193,256,3071,11:00 - 12:59
winter,2011-11-27,13,97,216,313,3071,13:00 - 14:59
winter,2011-11-27,14,113,200,313,3071,13:00 - 14:59
winter,2011-11-27,15,96,221,317,3071,15:00 - 16:59
winter,2011-11-27,16,94,229,323,3071,15:00 - 16:59
winter,2011-11-27,17,37,167,204,3071,17:00 - 18:59
winter,2011-11-27,18,25,130,155,3071,17:00 - 18:59
winter,2011-11-27,19,30,109,139,3071,19:00 - 20:59
winter,2011-11-27,20,10,94,104,3071,19:00 - 20:59
winter,2011-11-27,21,13,75,88,3071,21:00 - 22:59
winter,2011-11-27,22,13,53,66,3071,21:00 - 22:59
winter,2011-11-27,23,5,27,32,3071,23:00 - 24:59
winter,2011-11-28,0,6,10,16,3867,
winter,2011-11-28,1,1,12,13,3867,01:00 - 02:59
winter,2011-11-28,3,1,4,5,3867,03:00 - 04:59
winter,2011-11-28,4,0,4,4,3867,03:00 - 04:59
winter,2011-11-28,5,0,34,34,3867,05:00 - 06:59
winter,2011-11-28,6,6,98,104,3867,05:00 - 06:59
winter,2011-11-28,7,7,270,277,3867,07:00 - 08:59
winter,2011-11-28,8,13,394,407,3867,07:00 - 08:59
winter,2011-11-28,9,17,191,208,3867,09:00 - 10:59
winter,2011-11-28,10,21,86,107,3867,09:00 - 10:59
winter,2011-11-28,11,11,107,118,3867,11:00 - 12:59
winter,2011-11-28,12,13,165,178,3867,11:00 - 12:59
winter,2011-11-28,13,25,137,162,3867,13:00 - 14:59
winter,2011-11-28,14,14,129,143,3867,13:00 - 14:59
winter,2011-11-28,15,18,132,150,3867,15:00 - 16:59
winter,2011-11-28,16,24,240,264,3867,15:00 - 16:59
winter,2011-11-28,17,24,444,468,3867,17:00 - 18:59
winter,2011-11-28,18,20,396,416,3867,17:00 - 18:59
winter,2011-11-28,19,4,260,264,3867,19:00 - 20:59
winter,2011-11-28,20,12,206,218,3867,19:00 - 20:59
winter,2011-11-28,21,4,152,156,3867,21:00 - 22:59
winter,2011-11-28,22,7,102,109,3867,21:00 - 22:59
winter,2011-11-28,23,5,41,46,3867,23:00 - 24:59
winter,2011-11-29,0,4,18,22,2914,
winter,2011-11-29,1,1,16,17,2914,01:00 - 02:59
winter,2011-11-29,2,0,5,5,2914,01:00 - 02:59
winter,2011-11-29,3,0,2,2,2914,03:00 - 04:59
winter,2011-11-29,4,1,5,6,2914,03:00 - 04:59
winter,2011-11-29,5,1,21,22,2914,05:00 - 06:59
winter,2011-11-29,6,1,88,89,2914,05:00 - 06:59
winter,2011-11-29,7,12,330,342,2914,07:00 - 08:59
winter,2011-11-29,8,9,440,449,2914,07:00 - 08:59
winter,2011-11-29,9,5,197,202,2914,09:00 - 10:59
winter,2011-11-29,10,2,34,36,2914,09:00 - 10:59
winter,2011-11-29,11,1,10,11,2914,11:00 - 12:59
winter,2011-11-29,12,1,17,18,2914,11:00 - 12:59
winter,2011-11-29,13,0,22,22,2914,13:00 - 14:59
winter,2011-11-29,14,1,35,36,2914,13:00 - 14:59
winter,2011-11-29,15,5,60,65,2914,15:00 - 16:59
winter,2011-11-29,16,5,146,151,2914,15:00 - 16:59
winter,2011-11-29,17,8,346,354,2914,17:00 - 18:59
winter,2011-11-29,18,11,347,358,2914,17:00 - 18:59
winter,2011-11-29,19,6,244,250,2914,19:00 - 20:59
winter,2011-11-29,20,8,176,184,2914,19:00 - 20:59
winter,2011-11-29,21,9,116,125,2914,21:00 - 22:59
winter,2011-11-29,22,5,90,95,2914,21:00 - 22:59
winter,2011-11-29,23,0,53,53,2914,23:00 - 24:59
winter,2011-11-30,0,1,23,24,3613,
winter,2011-11-30,1,0,8,8,3613,01:00 - 02:59
winter,2011-11-30,2,0,5,5,3613,01:00 - 02:59
winter,2011-11-30,3,0,1,1,3613,03:00 - 04:59
winter,2011-11-30,4,0,5,5,3613,03:00 - 04:59
winter,2011-11-30,5,1,21,22,3613,05:00 - 06:59
winter,2011-11-30,6,3,100,103,3613,05:00 - 06:59
winter,2011-11-30,7,9,276,285,3613,07:00 - 08:59
winter,2011-11-30,8,13,465,478,3613,07:00 - 08:59
winter,2011-11-30,9,7,186,193,3613,09:00 - 10:59
winter,2011-11-30,10,15,95,110,3613,09:00 - 10:59
winter,2011-11-30,11,10,112,122,3613,11:00 - 12:59
winter,2011-11-30,12,12,148,160,3613,11:00 - 12:59
winter,2011-11-30,13,16,131,147,3613,13:00 - 14:59
winter,2011-11-30,14,13,99,112,3613,13:00 - 14:59
winter,2011-11-30,15,11,104,115,3613,15:00 - 16:59
winter,2011-11-30,16,27,199,226,3613,15:00 - 16:59
winter,2011-11-30,17,15,365,380,3613,17:00 - 18:59
winter,2011-11-30,18,7,369,376,3613,17:00 - 18:59
winter,2011-11-30,19,6,273,279,3613,19:00 - 20:59
winter,2011-11-30,20,6,184,190,3613,19:00 - 20:59
winter,2011-11-30,21,7,128,135,3613,21:00 - 22:59
winter,2011-11-30,22,5,82,87,3613,21:00 - 22:59
winter,2011-11-30,23,4,46,50,3613,23:00 - 24:59
winter,2011-12-01,0,1,19,20,3727,
winter,2011-12-01,1,1,9,10,3727,01:00 - 02:59
winter,2011-12-01,2,1,8,9,3727,01:00 - 02:59
winter,2011-12-01,3,1,6,7,3727,03:00 - 04:59
winter,2011-12-01,4,0,1,1,3727,03:00 - 04:59
winter,2011-12-01,5,1,23,24,3727,05:00 - 06:59
winter,2011-12-01,6,5,92,97,3727,05:00 - 06:59
winter,2011-12-01,7,11,265,276,3727,07:00 - 08:59
winter,2011-12-01,8,15,462,477,3727,07:00 - 08:59
winter,2011-12-01,9,9,215,224,3727,09:00 - 10:59
winter,2011-12-01,10,7,86,93,3727,09:00 - 10:59
winter,2011-12-01,11,7,95,102,3727,11:00 - 12:59
winter,2011-12-01,12,9,139,148,3727,11:00 - 12:59
winter,2011-12-01,13,17,137,154,3727,13:00 - 14:59
winter,2011-12-01,14,20,130,150,3727,13:00 - 14:59
winter,2011-12-01,15,10,144,154,3727,15:00 - 16:59
winter,2011-12-01,16,9,192,201,3727,15:00 - 16:59
winter,2011-12-01,17,9,409,418,3727,17:00 - 18:59
winter,2011-12-01,18,12,393,405,3727,17:00 - 18:59
winter,2011-12-01,19,9,219,228,3727,19:00 - 20:59
winter,2011-12-01,20,12,178,190,3727,19:00 - 20:59
winter,2011-12-01,21,8,154,162,3727,21:00 - 22:59
winter,2011-12-01,22,5,99,104,3727,21:00 - 22:59
winter,2011-12-01,23,3,70,73,3727,23:00 - 24:59
winter,2011-12-02,0,6,32,38,3940,
winter,2011-12-02,1,1,14,15,3940,01:00 - 02:59
winter,2011-12-02,2,0,10,10,3940,01:00 - 02:59
winter,2011-12-02,3,0,1,1,3940,03:00 - 04:59
winter,2011-12-02,4,0,3,3,3940,03:00 - 04:59
winter,2011-12-02,5,0,23,23,3940,05:00 - 06:59
winter,2011-12-02,6,3,84,87,3940,05:00 - 06:59
winter,2011-12-02,7,6,199,205,3940,07:00 - 08:59
winter,2011-12-02,8,13,432,445,3940,07:00 - 08:59
winter,2011-12-02,9,12,234,246,3940,09:00 - 10:59
winter,2011-12-02,10,16,89,105,3940,09:00 - 10:59
winter,2011-12-02,11,18,142,160,3940,11:00 - 12:59
winter,2011-12-02,12,18,186,204,3940,11:00 - 12:59
winter,2011-12-02,13,19,188,207,3940,13:00 - 14:59
winter,2011-12-02,14,25,145,170,3940,13:00 - 14:59
winter,2011-12-02,15,24,175,199,3940,15:00 - 16:59
winter,2011-12-02,16,22,254,276,3940,15:00 - 16:59
winter,2011-12-02,17,20,391,411,3940,17:00 - 18:59
winter,2011-12-02,18,10,362,372,3940,17:00 - 18:59
winter,2011-12-02,19,13,252,265,3940,19:00 - 20:59
winter,2011-12-02,20,12,178,190,3940,19:00 - 20:59
winter,2011-12-02,21,9,102,111,3940,21:00 - 22:59
winter,2011-12-02,22,7,95,102,3940,21:00 - 22:59
winter,2011-12-02,23,14,81,95,3940,23:00 - 24:59
winter,2011-12-03,0,10,65,75,3614,
winter,2011-12-03,1,9,62,71,3614,01:00 - 02:59
winter,2011-12-03,2,9,41,50,3614,01:00 - 02:59
winter,2011-12-03,3,4,5,9,3614,03:00 - 04:59
winter,2011-12-03,4,1,7,8,3614,03:00 - 04:59
winter,2011-12-03,5,0,6,6,3614,05:00 - 06:59
winter,2011-12-03,6,1,10,11,3614,05:00 - 06:59
winter,2011-12-03,7,2,24,26,3614,07:00 - 08:59
winter,2011-12-03,8,1,62,63,3614,07:00 - 08:59
winter,2011-12-03,9,25,99,124,3614,09:00 - 10:59
winter,2011-12-03,10,22,173,195,3614,09:00 - 10:59
winter,2011-12-03,11,48,227,275,3614,11:00 - 12:59
winter,2011-12-03,12,78,280,358,3614,11:00 - 12:59
winter,2011-12-03,13,70,222,292,3614,13:00 - 14:59
winter,2011-12-03,14,92,251,343,3614,13:00 - 14:59
winter,2011-12-03,15,100,237,337,3614,15:00 - 16:59
winter,2011-12-03,16,75,230,305,3614,15:00 - 16:59
winter,2011-12-03,17,46,186,232,3614,17:00 - 18:59
winter,2011-12-03,18,31,193,224,3614,17:00 - 18:59
winter,2011-12-03,19,31,144,175,3614,19:00 - 20:59
winter,2011-12-03,20,17,110,127,3614,19:00 - 20:59
winter,2011-12-03,21,5,104,109,3614,21:00 - 22:59
winter,2011-12-03,22,17,97,114,3614,21:00 - 22:59
winter,2011-12-03,23,12,73,85,3614,23:00 - 24:59
winter,2011-12-04,0,19,64,83,3485,
winter,2011-12-04,1,20,54,74,3485,01:00 - 02:59
winter,2011-12-04,2,11,51,62,3485,01:00 - 02:59
winter,2011-12-04,3,7,34,41,3485,03:00 - 04:59
winter,2011-12-04,4,2,9,11,3485,03:00 - 04:59
winter,2011-12-04,5,2,2,4,3485,05:00 - 06:59
winter,2011-12-04,6,1,3,4,3485,05:00 - 06:59
winter,2011-12-04,7,3,23,26,3485,07:00 - 08:59
winter,2011-12-04,8,7,48,55,3485,07:00 - 08:59
winter,2011-12-04,9,12,114,126,3485,09:00 - 10:59
winter,2011-12-04,10,36,180,216,3485,09:00 - 10:59
winter,2011-12-04,11,48,206,254,3485,11:00 - 12:59
winter,2011-12-04,12,82,247,329,3485,11:00 - 12:59
winter,2011-12-04,13,88,269,357,3485,13:00 - 14:59
winter,2011-12-04,14,77,246,323,3485,13:00 - 14:59
winter,2011-12-04,15,69,227,296,3485,15:00 - 16:59
winter,2011-12-04,16,64,266,330,3485,15:00 - 16:59
winter,2011-12-04,17,38,207,245,3485,17:00 - 18:59
winter,2011-12-04,18,10,161,171,3485,17:00 - 18:59
winter,2011-12-04,19,15,158,173,3485,19:00 - 20:59
winter,2011-12-04,20,8,116,124,3485,19:00 - 20:59
winter,2011-12-04,21,7,65,72,3485,21:00 - 22:59
winter,2011-12-04,22,5,59,64,3485,21:00 - 22:59
winter,2011-12-04,23,3,42,45,3485,23:00 - 24:59
winter,2011-12-05,0,3,21,24,3811,
winter,2011-12-05,1,2,10,12,3811,01:00 - 02:59
winter,2011-12-05,2,0,8,8,3811,01:00 - 02:59
winter,2011-12-05,3,0,2,2,3811,03:00 - 04:59
winter,2011-12-05,4,0,7,7,3811,03:00 - 04:59
winter,2011-12-05,5,1,24,25,3811,05:00 - 06:59
winter,2011-12-05,6,1,89,90,3811,05:00 - 06:59
winter,2011-12-05,7,9,274,283,3811,07:00 - 08:59
winter,2011-12-05,8,12,392,404,3811,07:00 - 08:59
winter,2011-12-05,9,12,178,190,3811,09:00 - 10:59
winter,2011-12-05,10,9,78,87,3811,09:00 - 10:59
winter,2011-12-05,11,17,106,123,3811,11:00 - 12:59
winter,2011-12-05,12,29,125,154,3811,11:00 - 12:59
winter,2011-12-05,13,18,153,171,3811,13:00 - 14:59
winter,2011-12-05,14,7,126,133,3811,13:00 - 14:59
winter,2011-12-05,15,16,132,148,3811,15:00 - 16:59
winter,2011-12-05,16,10,238,248,3811,15:00 - 16:59
winter,2011-12-05,17,16,430,446,3811,17:00 - 18:59
winter,2011-12-05,18,13,386,399,3811,17:00 - 18:59
winter,2011-12-05,19,13,295,308,3811,19:00 - 20:59
winter,2011-12-05,20,15,190,205,3811,19:00 - 20:59
winter,2011-12-05,21,10,166,176,3811,21:00 - 22:59
winter,2011-12-05,22,12,94,106,3811,21:00 - 22:59
winter,2011-12-05,23,8,54,62,3811,23:00 - 24:59
winter,2011-12-06,0,3,25,28,2594,
winter,2011-12-06,1,2,14,16,2594,01:00 - 02:59
winter,2011-12-06,2,0,3,3,2594,01:00 - 02:59
winter,2011-12-06,3,0,3,3,2594,03:00 - 04:59
winter,2011-12-06,4,0,7,7,2594,03:00 - 04:59
winter,2011-12-06,5,0,20,20,2594,05:00 - 06:59
winter,2011-12-06,6,5,81,86,2594,05:00 - 06:59
winter,2011-12-06,7,7,227,234,2594,07:00 - 08:59
winter,2011-12-06,8,13,401,414,2594,07:00 - 08:59
winter,2011-12-06,9,4,200,204,2594,09:00 - 10:59
winter,2011-12-06,10,6,44,50,2594,09:00 - 10:59
winter,2011-12-06,11,4,28,32,2594,11:00 - 12:59
winter,2011-12-06,12,5,50,55,2594,11:00 - 12:59
winter,2011-12-06,13,6,65,71,2594,13:00 - 14:59
winter,2011-12-06,14,6,69,75,2594,13:00 - 14:59
winter,2011-12-06,15,2,43,45,2594,15:00 - 16:59
winter,2011-12-06,16,4,84,88,2594,15:00 - 16:59
winter,2011-12-06,17,13,249,262,2594,17:00 - 18:59
winter,2011-12-06,18,17,287,304,2594,17:00 - 18:59
winter,2011-12-06,19,10,223,233,2594,19:00 - 20:59
winter,2011-12-06,20,3,107,110,2594,19:00 - 20:59
winter,2011-12-06,21,6,108,114,2594,21:00 - 22:59
winter,2011-12-06,22,5,82,87,2594,21:00 - 22:59
winter,2011-12-06,23,5,48,53,2594,23:00 - 24:59
winter,2011-12-07,0,3,30,33,705,
winter,2011-12-07,1,4,9,13,705,01:00 - 02:59
winter,2011-12-07,2,2,4,6,705,01:00 - 02:59
winter,2011-12-07,3,0,3,3,705,03:00 - 04:59
winter,2011-12-07,4,0,1,1,705,03:00 - 04:59
winter,2011-12-07,5,0,3,3,705,05:00 - 06:59
winter,2011-12-07,6,0,18,18,705,05:00 - 06:59
winter,2011-12-07,7,3,43,46,705,07:00 - 08:59
winter,2011-12-07,8,6,80,86,705,07:00 - 08:59
winter,2011-12-07,9,0,64,64,705,09:00 - 10:59
winter,2011-12-07,10,1,32,33,705,09:00 - 10:59
winter,2011-12-07,11,3,47,50,705,11:00 - 12:59
winter,2011-12-07,12,4,29,33,705,11:00 - 12:59
winter,2011-12-07,13,5,28,33,705,13:00 - 14:59
winter,2011-12-07,14,1,24,25,705,13:00 - 14:59
winter,2011-12-07,15,5,25,30,705,15:00 - 16:59
winter,2011-12-07,16,3,28,31,705,15:00 - 16:59
winter,2011-12-07,17,4,48,52,705,17:00 - 18:59
winter,2011-12-07,18,3,48,51,705,17:00 - 18:59
winter,2011-12-07,19,2,31,33,705,19:00 - 20:59
winter,2011-12-07,20,1,25,26,705,19:00 - 20:59
winter,2011-12-07,21,0,6,6,705,21:00 - 22:59
winter,2011-12-07,22,0,13,13,705,21:00 - 22:59
winter,2011-12-07,23,0,16,16,705,23:00 - 24:59
winter,2011-12-08,0,0,21,21,3322,
winter,2011-12-08,1,1,6,7,3322,01:00 - 02:59
winter,2011-12-08,2,0,4,4,3322,01:00 - 02:59
winter,2011-12-08,3,0,1,1,3322,03:00 - 04:59
winter,2011-12-08,4,0,2,2,3322,03:00 - 04:59
winter,2011-12-08,5,0,12,12,3322,05:00 - 06:59
winter,2011-12-08,6,0,71,71,3322,05:00 - 06:59
winter,2011-12-08,7,11,233,244,3322,07:00 - 08:59
winter,2011-12-08,8,11,418,429,3322,07:00 - 08:59
winter,2011-12-08,9,7,218,225,3322,09:00 - 10:59
winter,2011-12-08,10,1,109,110,3322,09:00 - 10:59
winter,2011-12-08,11,6,100,106,3322,11:00 - 12:59
winter,2011-12-08,12,8,148,156,3322,11:00 - 12:59
winter,2011-12-08,13,9,115,124,3322,13:00 - 14:59
winter,2011-12-08,14,16,121,137,3322,13:00 - 14:59
winter,2011-12-08,15,19,98,117,3322,15:00 - 16:59
winter,2011-12-08,16,7,201,208,3322,15:00 - 16:59
winter,2011-12-08,17,10,321,331,3322,17:00 - 18:59
winter,2011-12-08,18,12,306,318,3322,17:00 - 18:59
winter,2011-12-08,19,12,220,232,3322,19:00 - 20:59
winter,2011-12-08,20,5,170,175,3322,19:00 - 20:59
winter,2011-12-08,21,4,135,139,3322,21:00 - 22:59
winter,2011-12-08,22,8,84,92,3322,21:00 - 22:59
winter,2011-12-08,23,3,58,61,3322,23:00 - 24:59
winter,2011-12-09,0,8,26,34,3620,
winter,2011-12-09,1,2,12,14,3620,01:00 - 02:59
winter,2011-12-09,2,2,10,12,3620,01:00 - 02:59
winter,2011-12-09,3,1,5,6,3620,03:00 - 04:59
winter,2011-12-09,4,1,1,2,3620,03:00 - 04:59
winter,2011-12-09,5,0,20,20,3620,05:00 - 06:59
winter,2011-12-09,6,1,62,63,3620,05:00 - 06:59
winter,2011-12-09,7,4,195,199,3620,07:00 - 08:59
winter,2011-12-09,8,7,378,385,3620,07:00 - 08:59
winter,2011-12-09,9,8,256,264,3620,09:00 - 10:59
winter,2011-12-09,10,11,115,126,3620,09:00 - 10:59
winter,2011-12-09,11,15,121,136,3620,11:00 - 12:59
winter,2011-12-09,12,27,146,173,3620,11:00 - 12:59
winter,2011-12-09,13,27,141,168,3620,13:00 - 14:59
winter,2011-12-09,14,24,163,187,3620,13:00 - 14:59
winter,2011-12-09,15,29,160,189,3620,15:00 - 16:59
winter,2011-12-09,16,24,226,250,3620,15:00 - 16:59
winter,2011-12-09,17,10,352,362,3620,17:00 - 18:59
winter,2011-12-09,18,10,308,318,3620,17:00 - 18:59
winter,2011-12-09,19,10,189,199,3620,19:00 - 20:59
winter,2011-12-09,20,10,140,150,3620,19:00 - 20:59
winter,2011-12-09,21,9,131,140,3620,21:00 - 22:59
winter,2011-12-09,22,15,114,129,3620,21:00 - 22:59
winter,2011-12-09,23,6,88,94,3620,23:00 - 24:59
winter,2011-12-10,0,11,66,77,3190,
winter,2011-12-10,1,11,55,66,3190,01:00 - 02:59
winter,2011-12-10,2,12,48,60,3190,01:00 - 02:59
winter,2011-12-10,3,5,20,25,3190,03:00 - 04:59
winter,2011-12-10,4,0,3,3,3190,03:00 - 04:59
winter,2011-12-10,5,0,6,6,3190,05:00 - 06:59
winter,2011-12-10,6,1,10,11,3190,05:00 - 06:59
winter,2011-12-10,7,0,11,11,3190,07:00 - 08:59
winter,2011-12-10,8,5,68,73,3190,07:00 - 08:59
winter,2011-12-10,9,15,134,149,3190,09:00 - 10:59
winter,2011-12-10,10,31,161,192,3190,09:00 - 10:59
winter,2011-12-10,11,44,192,236,3190,11:00 - 12:59
winter,2011-12-10,12,48,235,283,3190,11:00 - 12:59
winter,2011-12-10,13,47,239,286,3190,13:00 - 14:59
winter,2011-12-10,14,51,242,293,3190,13:00 - 14:59
winter,2011-12-10,15,60,239,299,3190,15:00 - 16:59
winter,2011-12-10,16,58,183,241,3190,15:00 - 16:59
winter,2011-12-10,17,34,151,185,3190,17:00 - 18:59
winter,2011-12-10,18,28,144,172,3190,17:00 - 18:59
winter,2011-12-10,19,15,139,154,3190,19:00 - 20:59
winter,2011-12-10,20,10,114,124,3190,19:00 - 20:59
winter,2011-12-10,21,4,79,83,3190,21:00 - 22:59
winter,2011-12-10,22,7,88,95,3190,21:00 - 22:59
winter,2011-12-10,23,5,61,66,3190,23:00 - 24:59
winter,2011-12-11,0,5,69,74,2743,
winter,2011-12-11,1,8,54,62,2743,01:00 - 02:59
winter,2011-12-11,2,5,47,52,2743,01:00 - 02:59
winter,2011-12-11,3,2,17,19,2743,03:00 - 04:59
winter,2011-12-11,4,0,5,5,2743,03:00 - 04:59
winter,2011-12-11,5,0,6,6,2743,05:00 - 06:59
winter,2011-12-11,6,0,10,10,2743,05:00 - 06:59
winter,2011-12-11,7,1,30,31,2743,07:00 - 08:59
winter,2011-12-11,8,4,68,72,2743,07:00 - 08:59
winter,2011-12-11,9,19,88,107,2743,09:00 - 10:59
winter,2011-12-11,10,30,164,194,2743,09:00 - 10:59
winter,2011-12-11,11,31,166,197,2743,11:00 - 12:59
winter,2011-12-11,12,42,246,288,2743,11:00 - 12:59
winter,2011-12-11,13,44,224,268,2743,13:00 - 14:59
winter,2011-12-11,14,44,198,242,2743,13:00 - 14:59
winter,2011-12-11,15,47,219,266,2743,15:00 - 16:59
winter,2011-12-11,16,32,174,206,2743,15:00 - 16:59
winter,2011-12-11,17,13,150,163,2743,17:00 - 18:59
winter,2011-12-11,18,12,151,163,2743,17:00 - 18:59
winter,2011-12-11,19,7,98,105,2743,19:00 - 20:59
winter,2011-12-11,20,10,62,72,2743,19:00 - 20:59
winter,2011-12-11,21,10,53,63,2743,21:00 - 22:59
winter,2011-12-11,22,7,36,43,2743,21:00 - 22:59
winter,2011-12-11,23,4,31,35,2743,23:00 - 24:59
winter,2011-12-12,0,4,16,20,3310,
winter,2011-12-12,1,0,9,9,3310,01:00 - 02:59
winter,2011-12-12,2,0,4,4,3310,01:00 - 02:59
winter,2011-12-12,3,0,2,2,3310,03:00 - 04:59
winter,2011-12-12,4,0,3,3,3310,03:00 - 04:59
winter,2011-12-12,5,0,21,21,3310,05:00 - 06:59
winter,2011-12-12,6,1,63,64,3310,05:00 - 06:59
winter,2011-12-12,7,4,231,235,3310,07:00 - 08:59
winter,2011-12-12,8,7,378,385,3310,07:00 - 08:59
winter,2011-12-12,9,12,208,220,3310,09:00 - 10:59
winter,2011-12-12,10,14,91,105,3310,09:00 - 10:59
winter,2011-12-12,11,15,100,115,3310,11:00 - 12:59
winter,2011-12-12,12,7,138,145,3310,11:00 - 12:59
winter,2011-12-12,13,13,153,166,3310,13:00 - 14:59
winter,2011-12-12,14,16,95,111,3310,13:00 - 14:59
winter,2011-12-12,15,8,124,132,3310,15:00 - 16:59
winter,2011-12-12,16,5,209,214,3310,15:00 - 16:59
winter,2011-12-12,17,7,352,359,3310,17:00 - 18:59
winter,2011-12-12,18,8,349,357,3310,17:00 - 18:59
winter,2011-12-12,19,9,232,241,3310,19:00 - 20:59
winter,2011-12-12,20,8,157,165,3310,19:00 - 20:59
winter,2011-12-12,21,2,119,121,3310,21:00 - 22:59
winter,2011-12-12,22,0,71,71,3310,21:00 - 22:59
winter,2011-12-12,23,3,42,45,3310,23:00 - 24:59
winter,2011-12-13,0,1,16,17,3523,
winter,2011-12-13,1,0,4,4,3523,01:00 - 02:59
winter,2011-12-13,2,1,1,2,3523,01:00 - 02:59
winter,2011-12-13,3,0,3,3,3523,03:00 - 04:59
winter,2011-12-13,4,0,4,4,3523,03:00 - 04:59
winter,2011-12-13,5,0,20,20,3523,05:00 - 06:59
winter,2011-12-13,6,0,92,92,3523,05:00 - 06:59
winter,2011-12-13,7,2,221,223,3523,07:00 - 08:59
winter,2011-12-13,8,9,391,400,3523,07:00 - 08:59
winter,2011-12-13,9,10,223,233,3523,09:00 - 10:59
winter,2011-12-13,10,3,99,102,3523,09:00 - 10:59
winter,2011-12-13,11,9,115,124,3523,11:00 - 12:59
winter,2011-12-13,12,20,147,167,3523,11:00 - 12:59
winter,2011-12-13,13,7,120,127,3523,13:00 - 14:59
winter,2011-12-13,14,18,116,134,3523,13:00 - 14:59
winter,2011-12-13,15,7,144,151,3523,15:00 - 16:59
winter,2011-12-13,16,13,194,207,3523,15:00 - 16:59
winter,2011-12-13,17,17,381,398,3523,17:00 - 18:59
winter,2011-12-13,18,12,370,382,3523,17:00 - 18:59
winter,2011-12-13,19,5,262,267,3523,19:00 - 20:59
winter,2011-12-13,20,7,154,161,3523,19:00 - 20:59
winter,2011-12-13,21,5,134,139,3523,21:00 - 22:59
winter,2011-12-13,22,5,102,107,3523,21:00 - 22:59
winter,2011-12-13,23,4,55,59,3523,23:00 - 24:59
winter,2011-12-14,0,0,22,22,3740,
winter,2011-12-14,1,0,8,8,3740,01:00 - 02:59
winter,2011-12-14,2,0,2,2,3740,01:00 - 02:59
winter,2011-12-14,3,0,3,3,3740,03:00 - 04:59
winter,2011-12-14,4,0,4,4,3740,03:00 - 04:59
winter,2011-12-14,5,0,26,26,3740,05:00 - 06:59
winter,2011-12-14,6,0,87,87,3740,05:00 - 06:59
winter,2011-12-14,7,4,243,247,3740,07:00 - 08:59
winter,2011-12-14,8,9,458,467,3740,07:00 - 08:59
winter,2011-12-14,9,9,230,239,3740,09:00 - 10:59
winter,2011-12-14,10,9,133,142,3740,09:00 - 10:59
winter,2011-12-14,11,12,103,115,3740,11:00 - 12:59
winter,2011-12-14,12,6,138,144,3740,11:00 - 12:59
winter,2011-12-14,13,14,119,133,3740,13:00 - 14:59
winter,2011-12-14,14,17,134,151,3740,13:00 - 14:59
winter,2011-12-14,15,24,143,167,3740,15:00 - 16:59
winter,2011-12-14,16,12,233,245,3740,15:00 - 16:59
winter,2011-12-14,17,19,377,396,3740,17:00 - 18:59
winter,2011-12-14,18,11,379,390,3740,17:00 - 18:59
winter,2011-12-14,19,9,259,268,3740,19:00 - 20:59
winter,2011-12-14,20,6,169,175,3740,19:00 - 20:59
winter,2011-12-14,21,9,145,154,3740,21:00 - 22:59
winter,2011-12-14,22,5,99,104,3740,21:00 - 22:59
winter,2011-12-14,23,3,48,51,3740,23:00 - 24:59
winter,2011-12-15,0,5,45,50,3709,
winter,2011-12-15,1,5,15,20,3709,01:00 - 02:59
winter,2011-12-15,2,2,5,7,3709,01:00 - 02:59
winter,2011-12-15,3,1,2,3,3709,03:00 - 04:59
winter,2011-12-15,4,0,6,6,3709,03:00 - 04:59
winter,2011-12-15,5,0,24,24,3709,05:00 - 06:59
winter,2011-12-15,6,2,90,92,3709,05:00 - 06:59
winter,2011-12-15,7,6,252,258,3709,07:00 - 08:59
winter,2011-12-15,8,8,449,457,3709,07:00 - 08:59
winter,2011-12-15,9,6,274,280,3709,09:00 - 10:59
winter,2011-12-15,10,4,105,109,3709,09:00 - 10:59
winter,2011-12-15,11,9,126,135,3709,11:00 - 12:59
winter,2011-12-15,12,17,140,157,3709,11:00 - 12:59
winter,2011-12-15,13,14,150,164,3709,13:00 - 14:59
winter,2011-12-15,14,8,124,132,3709,13:00 - 14:59
winter,2011-12-15,15,6,76,82,3709,15:00 - 16:59
winter,2011-12-15,16,7,124,131,3709,15:00 - 16:59
winter,2011-12-15,17,14,310,324,3709,17:00 - 18:59
winter,2011-12-15,18,14,363,377,3709,17:00 - 18:59
winter,2011-12-15,19,13,274,287,3709,19:00 - 20:59
winter,2011-12-15,20,12,209,221,3709,19:00 - 20:59
winter,2011-12-15,21,10,145,155,3709,21:00 - 22:59
winter,2011-12-15,22,8,116,124,3709,21:00 - 22:59
winter,2011-12-15,23,10,104,114,3709,23:00 - 24:59
winter,2011-12-16,0,12,60,72,3577,
winter,2011-12-16,1,3,28,31,3577,01:00 - 02:59
winter,2011-12-16,2,0,23,23,3577,01:00 - 02:59
winter,2011-12-16,3,2,3,5,3577,03:00 - 04:59
winter,2011-12-16,4,1,4,5,3577,03:00 - 04:59
winter,2011-12-16,5,0,26,26,3577,05:00 - 06:59
winter,2011-12-16,6,2,80,82,3577,05:00 - 06:59
winter,2011-12-16,7,5,226,231,3577,07:00 - 08:59
winter,2011-12-16,8,10,449,459,3577,07:00 - 08:59
winter,2011-12-16,9,8,235,243,3577,09:00 - 10:59
winter,2011-12-16,10,10,122,132,3577,09:00 - 10:59
winter,2011-12-16,11,9,135,144,3577,11:00 - 12:59
winter,2011-12-16,12,10,163,173,3577,11:00 - 12:59
winter,2011-12-16,13,12,125,137,3577,13:00 - 14:59
winter,2011-12-16,14,13,115,128,3577,13:00 - 14:59
winter,2011-12-16,15,12,141,153,3577,15:00 - 16:59
winter,2011-12-16,16,12,212,224,3577,15:00 - 16:59
winter,2011-12-16,17,13,352,365,3577,17:00 - 18:59
winter,2011-12-16,18,10,285,295,3577,17:00 - 18:59
winter,2011-12-16,19,11,203,214,3577,19:00 - 20:59
winter,2011-12-16,20,6,146,152,3577,19:00 - 20:59
winter,2011-12-16,21,7,95,102,3577,21:00 - 22:59
winter,2011-12-16,22,6,100,106,3577,21:00 - 22:59
winter,2011-12-16,23,4,71,75,3577,23:00 - 24:59
winter,2011-12-17,0,3,59,62,2739,
winter,2011-12-17,1,4,39,43,2739,01:00 - 02:59
winter,2011-12-17,2,11,47,58,2739,01:00 - 02:59
winter,2011-12-17,3,4,22,26,2739,03:00 - 04:59
winter,2011-12-17,4,0,9,9,2739,03:00 - 04:59
winter,2011-12-17,5,2,7,9,2739,05:00 - 06:59
winter,2011-12-17,6,0,17,17,2739,05:00 - 06:59
winter,2011-12-17,7,0,20,20,2739,07:00 - 08:59
winter,2011-12-17,8,4,55,59,2739,07:00 - 08:59
winter,2011-12-17,9,5,95,100,2739,09:00 - 10:59
winter,2011-12-17,10,10,171,181,2739,09:00 - 10:59
winter,2011-12-17,11,21,188,209,2739,11:00 - 12:59
winter,2011-12-17,12,28,216,244,2739,11:00 - 12:59
winter,2011-12-17,13,32,204,236,2739,13:00 - 14:59
winter,2011-12-17,14,30,207,237,2739,13:00 - 14:59
winter,2011-12-17,15,33,195,228,2739,15:00 - 16:59
winter,2011-12-17,16,30,192,222,2739,15:00 - 16:59
winter,2011-12-17,17,12,153,165,2739,17:00 - 18:59
winter,2011-12-17,18,7,150,157,2739,17:00 - 18:59
winter,2011-12-17,19,11,95,106,2739,19:00 - 20:59
winter,2011-12-17,20,7,99,106,2739,19:00 - 20:59
winter,2011-12-17,21,8,88,96,2739,21:00 - 22:59
winter,2011-12-17,22,7,73,80,2739,21:00 - 22:59
winter,2011-12-17,23,6,63,69,2739,23:00 - 24:59
winter,2011-12-18,0,7,64,71,2431,
winter,2011-12-18,1,3,43,46,2431,01:00 - 02:59
winter,2011-12-18,2,2,39,41,2431,01:00 - 02:59
winter,2011-12-18,3,2,16,18,2431,03:00 - 04:59
winter,2011-12-18,4,0,1,1,2431,03:00 - 04:59
winter,2011-12-18,5,1,4,5,2431,05:00 - 06:59
winter,2011-12-18,6,0,3,3,2431,05:00 - 06:59
winter,2011-12-18,7,1,11,12,2431,07:00 - 08:59
winter,2011-12-18,8,1,31,32,2431,07:00 - 08:59
winter,2011-12-18,9,6,75,81,2431,09:00 - 10:59
winter,2011-12-18,10,7,122,129,2431,09:00 - 10:59
winter,2011-12-18,11,20,168,188,2431,11:00 - 12:59
winter,2011-12-18,12,26,202,228,2431,11:00 - 12:59
winter,2011-12-18,13,18,210,228,2431,13:00 - 14:59
winter,2011-12-18,14,19,200,219,2431,13:00 - 14:59
winter,2011-12-18,15,23,184,207,2431,15:00 - 16:59
winter,2011-12-18,16,27,207,234,2431,15:00 - 16:59
winter,2011-12-18,17,10,126,136,2431,17:00 - 18:59
winter,2011-12-18,18,15,123,138,2431,17:00 - 18:59
winter,2011-12-18,19,5,130,135,2431,19:00 - 20:59
winter,2011-12-18,20,10,94,104,2431,19:00 - 20:59
winter,2011-12-18,21,9,80,89,2431,21:00 - 22:59
winter,2011-12-18,22,2,47,49,2431,21:00 - 22:59
winter,2011-12-18,23,6,31,37,2431,23:00 - 24:59
winter,2011-12-19,0,3,14,17,3403,
winter,2011-12-19,1,3,8,11,3403,01:00 - 02:59
winter,2011-12-19,2,0,3,3,3403,01:00 - 02:59
winter,2011-12-19,3,0,3,3,3403,03:00 - 04:59
winter,2011-12-19,4,0,4,4,3403,03:00 - 04:59
winter,2011-12-19,5,0,21,21,3403,05:00 - 06:59
winter,2011-12-19,6,0,68,68,3403,05:00 - 06:59
winter,2011-12-19,7,4,187,191,3403,07:00 - 08:59
winter,2011-12-19,8,8,389,397,3403,07:00 - 08:59
winter,2011-12-19,9,17,166,183,3403,09:00 - 10:59
winter,2011-12-19,10,12,96,108,3403,09:00 - 10:59
winter,2011-12-19,11,22,105,127,3403,11:00 - 12:59
winter,2011-12-19,12,13,128,141,3403,11:00 - 12:59
winter,2011-12-19,13,15,127,142,3403,13:00 - 14:59
winter,2011-12-19,14,30,107,137,3403,13:00 - 14:59
winter,2011-12-19,15,24,135,159,3403,15:00 - 16:59
winter,2011-12-19,16,19,189,208,3403,15:00 - 16:59
winter,2011-12-19,17,16,362,378,3403,17:00 - 18:59
winter,2011-12-19,18,11,343,354,3403,17:00 - 18:59
winter,2011-12-19,19,17,234,251,3403,19:00 - 20:59
winter,2011-12-19,20,9,197,206,3403,19:00 - 20:59
winter,2011-12-19,21,15,112,127,3403,21:00 - 22:59
winter,2011-12-19,22,12,95,107,3403,21:00 - 22:59
winter,2011-12-19,23,10,50,60,3403,23:00 - 24:59
winter,2011-12-20,0,0,21,21,3750,
winter,2011-12-20,1,0,6,6,3750,01:00 - 02:59
winter,2011-12-20,2,1,10,11,3750,01:00 - 02:59
winter,2011-12-20,3,1,1,2,3750,03:00 - 04:59
winter,2011-12-20,4,0,4,4,3750,03:00 - 04:59
winter,2011-12-20,5,0,15,15,3750,05:00 - 06:59
winter,2011-12-20,6,1,71,72,3750,05:00 - 06:59
winter,2011-12-20,7,7,261,268,3750,07:00 - 08:59
winter,2011-12-20,8,10,422,432,3750,07:00 - 08:59
winter,2011-12-20,9,14,245,259,3750,09:00 - 10:59
winter,2011-12-20,10,20,109,129,3750,09:00 - 10:59
winter,2011-12-20,11,13,116,129,3750,11:00 - 12:59
winter,2011-12-20,12,16,159,175,3750,11:00 - 12:59
winter,2011-12-20,13,18,163,181,3750,13:00 - 14:59
winter,2011-12-20,14,11,127,138,3750,13:00 - 14:59
winter,2011-12-20,15,15,139,154,3750,15:00 - 16:59
winter,2011-12-20,16,20,218,238,3750,15:00 - 16:59
winter,2011-12-20,17,14,417,431,3750,17:00 - 18:59
winter,2011-12-20,18,26,385,411,3750,17:00 - 18:59
winter,2011-12-20,19,6,218,224,3750,19:00 - 20:59
winter,2011-12-20,20,3,144,147,3750,19:00 - 20:59
winter,2011-12-20,21,4,139,143,3750,21:00 - 22:59
winter,2011-12-20,22,3,104,107,3750,21:00 - 22:59
winter,2011-12-20,23,13,40,53,3750,23:00 - 24:59
springer,2011-12-21,0,7,18,25,2660,
springer,2011-12-21,1,1,10,11,2660,01:00 - 02:59
springer,2011-12-21,2,0,4,4,2660,01:00 - 02:59
springer,2011-12-21,3,0,2,2,2660,03:00 - 04:59
springer,2011-12-21,4,0,2,2,2660,03:00 - 04:59
springer,2011-12-21,5,0,28,28,2660,05:00 - 06:59
springer,2011-12-21,6,1,75,76,2660,05:00 - 06:59
springer,2011-12-21,7,5,224,229,2660,07:00 - 08:59
springer,2011-12-21,8,12,393,405,2660,07:00 - 08:59
springer,2011-12-21,9,14,220,234,2660,09:00 - 10:59
springer,2011-12-21,10,6,83,89,2660,09:00 - 10:59
springer,2011-12-21,11,3,53,56,2660,11:00 - 12:59
springer,2011-12-21,12,3,58,61,2660,11:00 - 12:59
springer,2011-12-21,13,3,55,58,2660,13:00 - 14:59
springer,2011-12-21,14,11,40,51,2660,13:00 - 14:59
springer,2011-12-21,15,4,57,61,2660,15:00 - 16:59
springer,2011-12-21,16,6,95,101,2660,15:00 - 16:59
springer,2011-12-21,17,3,226,229,2660,17:00 - 18:59
springer,2011-12-21,18,2,278,280,2660,17:00 - 18:59
springer,2011-12-21,19,9,200,209,2660,19:00 - 20:59
springer,2011-12-21,20,5,162,167,2660,19:00 - 20:59
springer,2011-12-21,21,9,114,123,2660,21:00 - 22:59
springer,2011-12-21,22,3,102,105,2660,21:00 - 22:59
springer,2011-12-21,23,0,54,54,2660,23:00 - 24:59
springer,2011-12-22,0,3,24,27,3068,
springer,2011-12-22,1,0,15,15,3068,01:00 - 02:59
springer,2011-12-22,2,1,10,11,3068,01:00 - 02:59
springer,2011-12-22,3,0,6,6,3068,03:00 - 04:59
springer,2011-12-22,4,0,3,3,3068,03:00 - 04:59
springer,2011-12-22,5,1,15,16,3068,05:00 - 06:59
springer,2011-12-22,6,1,63,64,3068,05:00 - 06:59
springer,2011-12-22,7,4,182,186,3068,07:00 - 08:59
springer,2011-12-22,8,10,333,343,3068,07:00 - 08:59
springer,2011-12-22,9,10,218,228,3068,09:00 - 10:59
springer,2011-12-22,10,13,128,141,3068,09:00 - 10:59
springer,2011-12-22,11,10,135,145,3068,11:00 - 12:59
springer,2011-12-22,12,22,180,202,3068,11:00 - 12:59
springer,2011-12-22,13,21,167,188,3068,13:00 - 14:59
springer,2011-12-22,14,23,136,159,3068,13:00 - 14:59
springer,2011-12-22,15,28,186,214,3068,15:00 - 16:59
springer,2011-12-22,16,30,226,256,3068,15:00 - 16:59
springer,2011-12-22,17,24,332,356,3068,17:00 - 18:59
springer,2011-12-22,18,11,277,288,3068,17:00 - 18:59
springer,2011-12-22,19,12,130,142,3068,19:00 - 20:59
springer,2011-12-22,20,0,33,33,3068,19:00 - 20:59
springer,2011-12-22,21,2,15,17,3068,21:00 - 22:59
springer,2011-12-22,22,0,17,17,3068,21:00 - 22:59
springer,2011-12-22,23,1,10,11,3068,23:00 - 24:59
springer,2011-12-23,0,2,7,9,2209,
springer,2011-12-23,1,1,11,12,2209,01:00 - 02:59
springer,2011-12-23,2,1,12,13,2209,01:00 - 02:59
springer,2011-12-23,3,0,4,4,2209,03:00 - 04:59
springer,2011-12-23,4,0,2,2,2209,03:00 - 04:59
springer,2011-12-23,5,0,8,8,2209,05:00 - 06:59
springer,2011-12-23,6,0,40,40,2209,05:00 - 06:59
springer,2011-12-23,7,4,88,92,2209,07:00 - 08:59
springer,2011-12-23,8,9,173,182,2209,07:00 - 08:59
springer,2011-12-23,9,4,152,156,2209,09:00 - 10:59
springer,2011-12-23,10,8,96,104,2209,09:00 - 10:59
springer,2011-12-23,11,26,148,174,2209,11:00 - 12:59
springer,2011-12-23,12,14,156,170,2209,11:00 - 12:59
springer,2011-12-23,13,17,177,194,2209,13:00 - 14:59
springer,2011-12-23,14,23,177,200,2209,13:00 - 14:59
springer,2011-12-23,15,12,191,203,2209,15:00 - 16:59
springer,2011-12-23,16,15,166,181,2209,15:00 - 16:59
springer,2011-12-23,17,11,129,140,2209,17:00 - 18:59
springer,2011-12-23,18,4,91,95,2209,17:00 - 18:59
springer,2011-12-23,19,1,75,76,2209,19:00 - 20:59
springer,2011-12-23,20,3,47,50,2209,19:00 - 20:59
springer,2011-12-23,21,0,32,32,2209,21:00 - 22:59
springer,2011-12-23,22,4,43,47,2209,21:00 - 22:59
springer,2011-12-23,23,4,21,25,2209,23:00 - 24:59
springer,2011-12-24,0,3,20,23,1011,
springer,2011-12-24,1,1,15,16,1011,01:00 - 02:59
springer,2011-12-24,2,4,22,26,1011,01:00 - 02:59
springer,2011-12-24,3,0,5,5,1011,03:00 - 04:59
springer,2011-12-24,4,0,3,3,1011,03:00 - 04:59
springer,2011-12-24,5,1,3,4,1011,05:00 - 06:59
springer,2011-12-24,6,0,10,10,1011,05:00 - 06:59
springer,2011-12-24,7,0,10,10,1011,07:00 - 08:59
springer,2011-12-24,8,0,27,27,1011,07:00 - 08:59
springer,2011-12-24,9,3,53,56,1011,09:00 - 10:59
springer,2011-12-24,10,4,52,56,1011,09:00 - 10:59
springer,2011-12-24,11,9,62,71,1011,11:00 - 12:59
springer,2011-12-24,12,15,79,94,1011,11:00 - 12:59
springer,2011-12-24,13,24,97,121,1011,13:00 - 14:59
springer,2011-12-24,14,15,70,85,1011,13:00 - 14:59
springer,2011-12-24,15,15,82,97,1011,15:00 - 16:59
springer,2011-12-24,16,25,74,99,1011,15:00 - 16:59
springer,2011-12-24,17,15,53,68,1011,17:00 - 18:59
springer,2011-12-24,18,2,33,35,1011,17:00 - 18:59
springer,2011-12-24,19,1,24,25,1011,19:00 - 20:59
springer,2011-12-24,20,5,19,24,1011,19:00 - 20:59
springer,2011-12-24,21,4,15,19,1011,21:00 - 22:59
springer,2011-12-24,22,8,12,20,1011,21:00 - 22:59
springer,2011-12-24,23,1,16,17,1011,23:00 - 24:59
springer,2011-12-25,0,2,4,6,754,
springer,2011-12-25,1,2,2,4,754,01:00 - 02:59
springer,2011-12-25,2,0,2,2,754,01:00 - 02:59
springer,2011-12-25,3,1,3,4,754,03:00 - 04:59
springer,2011-12-25,5,0,1,1,754,05:00 - 06:59
springer,2011-12-25,6,0,1,1,754,05:00 - 06:59
springer,2011-12-25,7,0,4,4,754,07:00 - 08:59
springer,2011-12-25,8,1,4,5,754,07:00 - 08:59
springer,2011-12-25,9,3,20,23,754,09:00 - 10:59
springer,2011-12-25,10,31,12,43,754,09:00 - 10:59
springer,2011-12-25,11,43,42,85,754,11:00 - 12:59
springer,2011-12-25,12,25,41,66,754,11:00 - 12:59
springer,2011-12-25,13,40,39,79,754,13:00 - 14:59
springer,2011-12-25,14,41,45,86,754,13:00 - 14:59
springer,2011-12-25,15,43,48,91,754,15:00 - 16:59
springer,2011-12-25,16,35,51,86,754,15:00 - 16:59
springer,2011-12-25,17,11,33,44,754,17:00 - 18:59
springer,2011-12-25,18,7,23,30,754,17:00 - 18:59
springer,2011-12-25,19,2,14,16,754,19:00 - 20:59
springer,2011-12-25,20,8,18,26,754,19:00 - 20:59
springer,2011-12-25,21,4,15,19,754,21:00 - 22:59
springer,2011-12-25,22,2,15,17,754,21:00 - 22:59
springer,2011-12-25,23,2,14,16,754,23:00 - 24:59
springer,2011-12-26,0,5,6,11,1317,
springer,2011-12-26,1,3,7,10,1317,01:00 - 02:59
springer,2011-12-26,2,2,5,7,1317,01:00 - 02:59
springer,2011-12-26,4,0,2,2,1317,03:00 - 04:59
springer,2011-12-26,5,0,4,4,1317,05:00 - 06:59
springer,2011-12-26,6,0,4,4,1317,05:00 - 06:59
springer,2011-12-26,7,2,17,19,1317,07:00 - 08:59
springer,2011-12-26,8,5,13,18,1317,07:00 - 08:59
springer,2011-12-26,9,24,38,62,1317,09:00 - 10:59
springer,2011-12-26,10,31,39,70,1317,09:00 - 10:59
springer,2011-12-26,11,40,51,91,1317,11:00 - 12:59
springer,2011-12-26,12,34,66,100,1317,11:00 - 12:59
springer,2011-12-26,13,57,83,140,1317,13:00 - 14:59
springer,2011-12-26,14,73,80,153,1317,13:00 - 14:59
springer,2011-12-26,15,26,105,131,1317,15:00 - 16:59
springer,2011-12-26,16,28,69,97,1317,15:00 - 16:59
springer,2011-12-26,17,30,67,97,1317,17:00 - 18:59
springer,2011-12-26,18,21,54,75,1317,17:00 - 18:59
springer,2011-12-26,19,16,49,65,1317,19:00 - 20:59
springer,2011-12-26,20,14,42,56,1317,19:00 - 20:59
springer,2011-12-26,21,10,39,49,1317,21:00 - 22:59
springer,2011-12-26,22,5,22,27,1317,21:00 - 22:59
springer,2011-12-26,23,4,25,29,1317,23:00 - 24:59
springer,2011-12-27,0,3,9,12,1162,
springer,2011-12-27,1,0,6,6,1162,01:00 - 02:59
springer,2011-12-27,2,2,2,4,1162,01:00 - 02:59
springer,2011-12-27,3,0,3,3,1162,03:00 - 04:59
springer,2011-12-27,4,0,3,3,1162,03:00 - 04:59
springer,2011-12-27,5,0,8,8,1162,05:00 - 06:59
springer,2011-12-27,6,0,35,35,1162,05:00 - 06:59
springer,2011-12-27,7,1,79,80,1162,07:00 - 08:59
springer,2011-12-27,8,9,155,164,1162,07:00 - 08:59
springer,2011-12-27,9,19,85,104,1162,09:00 - 10:59
springer,2011-12-27,10,13,47,60,1162,09:00 - 10:59
springer,2011-12-27,11,6,24,30,1162,11:00 - 12:59
springer,2011-12-27,12,8,16,24,1162,11:00 - 12:59
springer,2011-12-27,13,1,19,20,1162,13:00 - 14:59
springer,2011-12-27,14,0,14,14,1162,13:00 - 14:59
springer,2011-12-27,15,2,17,19,1162,15:00 - 16:59
springer,2011-12-27,16,2,44,46,1162,15:00 - 16:59
springer,2011-12-27,17,6,109,115,1162,17:00 - 18:59
springer,2011-12-27,18,9,126,135,1162,17:00 - 18:59
springer,2011-12-27,19,3,87,90,1162,19:00 - 20:59
springer,2011-12-27,20,3,66,69,1162,19:00 - 20:59
springer,2011-12-27,21,11,52,63,1162,21:00 - 22:59
springer,2011-12-27,22,3,29,32,1162,21:00 - 22:59
springer,2011-12-27,23,2,24,26,1162,23:00 - 24:59
springer,2011-12-28,0,0,10,10,2302,
springer,2011-12-28,1,0,12,12,2302,01:00 - 02:59
springer,2011-12-28,2,0,7,7,2302,01:00 - 02:59
springer,2011-12-28,3,0,4,4,2302,03:00 - 04:59
springer,2011-12-28,5,0,9,9,2302,05:00 - 06:59
springer,2011-12-28,6,1,42,43,2302,05:00 - 06:59
springer,2011-12-28,7,4,106,110,2302,07:00 - 08:59
springer,2011-12-28,8,11,206,217,2302,07:00 - 08:59
springer,2011-12-28,9,18,171,189,2302,09:00 - 10:59
springer,2011-12-28,10,12,84,96,2302,09:00 - 10:59
springer,2011-12-28,11,18,93,111,2302,11:00 - 12:59
springer,2011-12-28,12,32,108,140,2302,11:00 - 12:59
springer,2011-12-28,13,24,135,159,2302,13:00 - 14:59
springer,2011-12-28,14,24,96,120,2302,13:00 - 14:59
springer,2011-12-28,15,16,101,117,2302,15:00 - 16:59
springer,2011-12-28,16,23,144,167,2302,15:00 - 16:59
springer,2011-12-28,17,25,225,250,2302,17:00 - 18:59
springer,2011-12-28,18,10,159,169,2302,17:00 - 18:59
springer,2011-12-28,19,16,135,151,2302,19:00 - 20:59
springer,2011-12-28,20,9,70,79,2302,19:00 - 20:59
springer,2011-12-28,21,7,63,70,2302,21:00 - 22:59
springer,2011-12-28,22,2,31,33,2302,21:00 - 22:59
springer,2011-12-28,23,3,36,39,2302,23:00 - 24:59
springer,2011-12-29,0,4,24,28,2423,
springer,2011-12-29,1,0,15,15,2423,01:00 - 02:59
springer,2011-12-29,2,0,3,3,2423,01:00 - 02:59
springer,2011-12-29,3,0,2,2,2423,03:00 - 04:59
springer,2011-12-29,4,1,2,3,2423,03:00 - 04:59
springer,2011-12-29,5,0,10,10,2423,05:00 - 06:59
springer,2011-12-29,6,2,39,41,2423,05:00 - 06:59
springer,2011-12-29,7,2,104,106,2423,07:00 - 08:59
springer,2011-12-29,8,3,207,210,2423,07:00 - 08:59
springer,2011-12-29,9,15,155,170,2423,09:00 - 10:59
springer,2011-12-29,10,13,97,110,2423,09:00 - 10:59
springer,2011-12-29,11,23,99,122,2423,11:00 - 12:59
springer,2011-12-29,12,12,118,130,2423,11:00 - 12:59
springer,2011-12-29,13,36,95,131,2423,13:00 - 14:59
springer,2011-12-29,14,30,112,142,2423,13:00 - 14:59
springer,2011-12-29,15,27,150,177,2423,15:00 - 16:59
springer,2011-12-29,16,22,155,177,2423,15:00 - 16:59
springer,2011-12-29,17,14,226,240,2423,17:00 - 18:59
springer,2011-12-29,18,15,192,207,2423,17:00 - 18:59
springer,2011-12-29,19,11,124,135,2423,19:00 - 20:59
springer,2011-12-29,20,8,88,96,2423,19:00 - 20:59
springer,2011-12-29,21,8,60,68,2423,21:00 - 22:59
springer,2011-12-29,22,7,48,55,2423,21:00 - 22:59
springer,2011-12-29,23,1,44,45,2423,23:00 - 24:59
springer,2011-12-30,0,4,26,30,2999,
springer,2011-12-30,1,9,11,20,2999,01:00 - 02:59
springer,2011-12-30,2,2,10,12,2999,01:00 - 02:59
springer,2011-12-30,3,0,6,6,2999,03:00 - 04:59
springer,2011-12-30,4,0,2,2,2999,03:00 - 04:59
springer,2011-12-30,5,0,10,10,2999,05:00 - 06:59
springer,2011-12-30,6,1,31,32,2999,05:00 - 06:59
springer,2011-12-30,7,3,92,95,2999,07:00 - 08:59
springer,2011-12-30,8,12,193,205,2999,07:00 - 08:59
springer,2011-12-30,9,19,175,194,2999,09:00 - 10:59
springer,2011-12-30,10,10,108,118,2999,09:00 - 10:59
springer,2011-12-30,11,45,126,171,2999,11:00 - 12:59
springer,2011-12-30,12,38,159,197,2999,11:00 - 12:59
springer,2011-12-30,13,53,154,207,2999,13:00 - 14:59
springer,2011-12-30,14,67,178,245,2999,13:00 - 14:59
springer,2011-12-30,15,56,236,292,2999,15:00 - 16:59
springer,2011-12-30,16,36,247,283,2999,15:00 - 16:59
springer,2011-12-30,17,54,188,242,2999,17:00 - 18:59
springer,2011-12-30,18,19,163,182,2999,17:00 - 18:59
springer,2011-12-30,19,16,96,112,2999,19:00 - 20:59
springer,2011-12-30,20,16,75,91,2999,19:00 - 20:59
springer,2011-12-30,21,11,84,95,2999,21:00 - 22:59
springer,2011-12-30,22,7,78,85,2999,21:00 - 22:59
springer,2011-12-30,23,13,60,73,2999,23:00 - 24:59
springer,2011-12-31,0,7,37,44,2485,
springer,2011-12-31,1,4,31,35,2485,01:00 - 02:59
springer,2011-12-31,2,1,27,28,2485,01:00 - 02:59
springer,2011-12-31,3,1,17,18,2485,03:00 - 04:59
springer,2011-12-31,4,1,9,10,2485,03:00 - 04:59
springer,2011-12-31,5,1,0,1,2485,05:00 - 06:59
springer,2011-12-31,6,1,5,6,2485,05:00 - 06:59
springer,2011-12-31,7,6,13,19,2485,07:00 - 08:59
springer,2011-12-31,8,7,42,49,2485,07:00 - 08:59
springer,2011-12-31,9,18,72,90,2485,09:00 - 10:59
springer,2011-12-31,10,20,108,128,2485,09:00 - 10:59
springer,2011-12-31,11,65,152,217,2485,11:00 - 12:59
springer,2011-12-31,12,93,180,273,2485,11:00 - 12:59
springer,2011-12-31,13,108,205,313,2485,13:00 - 14:59
springer,2011-12-31,14,115,185,300,2485,13:00 - 14:59
springer,2011-12-31,15,89,164,253,2485,15:00 - 16:59
springer,2011-12-31,16,52,143,195,2485,15:00 - 16:59
springer,2011-12-31,17,28,101,129,2485,17:00 - 18:59
springer,2011-12-31,18,13,80,93,2485,17:00 - 18:59
springer,2011-12-31,19,19,73,92,2485,19:00 - 20:59
springer,2011-12-31,20,8,63,71,2485,19:00 - 20:59
springer,2011-12-31,21,2,50,52,2485,21:00 - 22:59
springer,2011-12-31,22,2,36,38,2485,21:00 - 22:59
springer,2011-12-31,23,4,27,31,2485,23:00 - 24:59
springer,2012-01-01,0,5,43,48,2294,
springer,2012-01-01,1,15,78,93,2294,01:00 - 02:59
springer,2012-01-01,2,16,59,75,2294,01:00 - 02:59
springer,2012-01-01,3,11,41,52,2294,03:00 - 04:59
springer,2012-01-01,4,0,8,8,2294,03:00 - 04:59
springer,2012-01-01,5,0,5,5,2294,05:00 - 06:59
springer,2012-01-01,6,1,1,2,2294,05:00 - 06:59
springer,2012-01-01,7,1,6,7,2294,07:00 - 08:59
springer,2012-01-01,8,4,10,14,2294,07:00 - 08:59
springer,2012-01-01,9,13,27,40,2294,09:00 - 10:59
springer,2012-01-01,10,18,52,70,2294,09:00 - 10:59
springer,2012-01-01,11,40,98,138,2294,11:00 - 12:59
springer,2012-01-01,12,58,143,201,2294,11:00 - 12:59
springer,2012-01-01,13,82,141,223,2294,13:00 - 14:59
springer,2012-01-01,14,120,147,267,2294,13:00 - 14:59
springer,2012-01-01,15,101,164,265,2294,15:00 - 16:59
springer,2012-01-01,16,68,147,215,2294,15:00 - 16:59
springer,2012-01-01,17,36,75,111,2294,17:00 - 18:59
springer,2012-01-01,18,25,81,106,2294,17:00 - 18:59
springer,2012-01-01,19,20,85,105,2294,19:00 - 20:59
springer,2012-01-01,20,25,58,83,2294,19:00 - 20:59
springer,2012-01-01,21,10,61,71,2294,21:00 - 22:59
springer,2012-01-01,22,13,53,66,2294,21:00 - 22:59
springer,2012-01-01,23,4,25,29,2294,23:00 - 24:59
springer,2012-01-02,0,8,31,39,1951,
springer,2012-01-02,1,1,11,12,1951,01:00 - 02:59
springer,2012-01-02,2,1,6,7,1951,01:00 - 02:59
springer,2012-01-02,4,0,4,4,1951,03:00 - 04:59
springer,2012-01-02,5,1,3,4,1951,05:00 - 06:59
springer,2012-01-02,6,0,14,14,1951,05:00 - 06:59
springer,2012-01-02,7,0,16,16,1951,07:00 - 08:59
springer,2012-01-02,8,2,51,53,1951,07:00 - 08:59
springer,2012-01-02,9,15,53,68,1951,09:00 - 10:59
springer,2012-01-02,10,20,89,109,1951,09:00 - 10:59
springer,2012-01-02,11,33,142,175,1951,11:00 - 12:59
springer,2012-01-02,12,41,161,202,1951,11:00 - 12:59
springer,2012-01-02,13,26,150,176,1951,13:00 - 14:59
springer,2012-01-02,14,10,141,151,1951,13:00 - 14:59
springer,2012-01-02,15,29,139,168,1951,15:00 - 16:59
springer,2012-01-02,16,10,144,154,1951,15:00 - 16:59
springer,2012-01-02,17,17,136,153,1951,17:00 - 18:59
springer,2012-01-02,18,13,113,126,1951,17:00 - 18:59
springer,2012-01-02,19,4,89,93,1951,19:00 - 20:59
springer,2012-01-02,20,5,83,88,1951,19:00 - 20:59
springer,2012-01-02,21,3,63,66,1951,21:00 - 22:59
springer,2012-01-02,22,3,36,39,1951,21:00 - 22:59
springer,2012-01-02,23,2,32,34,1951,23:00 - 24:59
springer,2012-01-03,0,0,13,13,2236,
springer,2012-01-03,1,1,5,6,2236,01:00 - 02:59
springer,2012-01-03,2,0,3,3,2236,01:00 - 02:59
springer,2012-01-03,3,0,2,2,2236,03:00 - 04:59
springer,2012-01-03,4,0,5,5,2236,03:00 - 04:59
springer,2012-01-03,5,0,12,12,2236,05:00 - 06:59
springer,2012-01-03,6,4,81,85,2236,05:00 - 06:59
springer,2012-01-03,7,2,168,170,2236,07:00 - 08:59
springer,2012-01-03,8,5,349,354,2236,07:00 - 08:59
springer,2012-01-03,9,8,145,153,2236,09:00 - 10:59
springer,2012-01-03,10,5,55,60,2236,09:00 - 10:59
springer,2012-01-03,11,12,63,75,2236,11:00 - 12:59
springer,2012-01-03,12,4,70,74,2236,11:00 - 12:59
springer,2012-01-03,13,5,68,73,2236,13:00 - 14:59
springer,2012-01-03,14,7,72,79,2236,13:00 - 14:59
springer,2012-01-03,15,9,68,77,2236,15:00 - 16:59
springer,2012-01-03,16,7,129,136,2236,15:00 - 16:59
springer,2012-01-03,17,4,241,245,2236,17:00 - 18:59
springer,2012-01-03,18,10,214,224,2236,17:00 - 18:59
springer,2012-01-03,19,4,152,156,2236,19:00 - 20:59
springer,2012-01-03,20,0,115,115,2236,19:00 - 20:59
springer,2012-01-03,21,2,66,68,2236,21:00 - 22:59
springer,2012-01-03,22,0,33,33,2236,21:00 - 22:59
springer,2012-01-03,23,0,18,18,2236,23:00 - 24:59
springer,2012-01-04,0,0,9,9,2368,
springer,2012-01-04,1,0,3,3,2368,01:00 - 02:59
springer,2012-01-04,2,0,1,1,2368,01:00 - 02:59
springer,2012-01-04,3,0,1,1,2368,03:00 - 04:59
springer,2012-01-04,4,0,2,2,2368,03:00 - 04:59
springer,2012-01-04,5,0,14,14,2368,05:00 - 06:59
springer,2012-01-04,6,0,59,59,2368,05:00 - 06:59
springer,2012-01-04,7,1,151,152,2368,07:00 - 08:59
springer,2012-01-04,8,5,310,315,2368,07:00 - 08:59
springer,2012-01-04,9,7,173,180,2368,09:00 - 10:59
springer,2012-01-04,10,7,57,64,2368,09:00 - 10:59
springer,2012-01-04,11,6,40,46,2368,11:00 - 12:59
springer,2012-01-04,12,9,75,84,2368,11:00 - 12:59
springer,2012-01-04,13,9,82,91,2368,13:00 - 14:59
springer,2012-01-04,14,6,69,75,2368,13:00 - 14:59
springer,2012-01-04,15,9,81,90,2368,15:00 - 16:59
springer,2012-01-04,16,8,123,131,2368,15:00 - 16:59
springer,2012-01-04,17,9,272,281,2368,17:00 - 18:59
springer,2012-01-04,18,9,280,289,2368,17:00 - 18:59
springer,2012-01-04,19,2,182,184,2368,19:00 - 20:59
springer,2012-01-04,20,2,121,123,2368,19:00 - 20:59
springer,2012-01-04,21,2,88,90,2368,21:00 - 22:59
springer,2012-01-04,22,4,48,52,2368,21:00 - 22:59
springer,2012-01-04,23,0,32,32,2368,23:00 - 24:59
springer,2012-01-05,0,1,13,14,3272,
springer,2012-01-05,1,0,5,5,3272,01:00 - 02:59
springer,2012-01-05,2,0,4,4,3272,01:00 - 02:59
springer,2012-01-05,3,0,4,4,3272,03:00 - 04:59
springer,2012-01-05,4,0,5,5,3272,03:00 - 04:59
springer,2012-01-05,5,0,26,26,3272,05:00 - 06:59
springer,2012-01-05,6,0,78,78,3272,05:00 - 06:59
springer,2012-01-05,7,3,212,215,3272,07:00 - 08:59
springer,2012-01-05,8,11,377,388,3272,07:00 - 08:59
springer,2012-01-05,9,7,220,227,3272,09:00 - 10:59
springer,2012-01-05,10,5,81,86,3272,09:00 - 10:59
springer,2012-01-05,11,6,78,84,3272,11:00 - 12:59
springer,2012-01-05,12,6,114,120,3272,11:00 - 12:59
springer,2012-01-05,13,6,112,118,3272,13:00 - 14:59
springer,2012-01-05,14,13,104,117,3272,13:00 - 14:59
springer,2012-01-05,15,6,113,119,3272,15:00 - 16:59
springer,2012-01-05,16,19,178,197,3272,15:00 - 16:59
springer,2012-01-05,17,19,393,412,3272,17:00 - 18:59
springer,2012-01-05,18,9,374,383,3272,17:00 - 18:59
springer,2012-01-05,19,10,255,265,3272,19:00 - 20:59
springer,2012-01-05,20,5,172,177,3272,19:00 - 20:59
springer,2012-01-05,21,9,88,97,3272,21:00 - 22:59
springer,2012-01-05,22,1,70,71,3272,21:00 - 22:59
springer,2012-01-05,23,4,56,60,3272,23:00 - 24:59
springer,2012-01-06,0,1,24,25,4098,
springer,2012-01-06,1,2,6,8,4098,01:00 - 02:59
springer,2012-01-06,2,2,3,5,4098,01:00 - 02:59
springer,2012-01-06,3,1,3,4,4098,03:00 - 04:59
springer,2012-01-06,4,0,3,3,4098,03:00 - 04:59
springer,2012-01-06,5,0,13,13,4098,05:00 - 06:59
springer,2012-01-06,6,1,69,70,4098,05:00 - 06:59
springer,2012-01-06,7,4,201,205,4098,07:00 - 08:59
springer,2012-01-06,8,11,436,447,4098,07:00 - 08:59
springer,2012-01-06,9,4,237,241,4098,09:00 - 10:59
springer,2012-01-06,10,14,102,116,4098,09:00 - 10:59
springer,2012-01-06,11,8,130,138,4098,11:00 - 12:59
springer,2012-01-06,12,23,168,191,4098,11:00 - 12:59
springer,2012-01-06,13,16,188,204,4098,13:00 - 14:59
springer,2012-01-06,14,26,152,178,4098,13:00 - 14:59
springer,2012-01-06,15,44,178,222,4098,15:00 - 16:59
springer,2012-01-06,16,35,259,294,4098,15:00 - 16:59
springer,2012-01-06,17,20,456,476,4098,17:00 - 18:59
springer,2012-01-06,18,28,391,419,4098,17:00 - 18:59
springer,2012-01-06,19,11,261,272,4098,19:00 - 20:59
springer,2012-01-06,20,14,163,177,4098,19:00 - 20:59
springer,2012-01-06,21,17,137,154,4098,21:00 - 22:59
springer,2012-01-06,22,12,123,135,4098,21:00 - 22:59
springer,2012-01-06,23,13,88,101,4098,23:00 - 24:59
springer,2012-01-07,0,2,77,79,4521,
springer,2012-01-07,1,6,56,62,4521,01:00 - 02:59
springer,2012-01-07,2,2,36,38,4521,01:00 - 02:59
springer,2012-01-07,3,1,19,20,4521,03:00 - 04:59
springer,2012-01-07,4,1,9,10,4521,03:00 - 04:59
springer,2012-01-07,5,2,7,9,4521,05:00 - 06:59
springer,2012-01-07,6,0,7,7,4521,05:00 - 06:59
springer,2012-01-07,7,0,20,20,4521,07:00 - 08:59
springer,2012-01-07,8,0,64,64,4521,07:00 - 08:59
springer,2012-01-07,9,14,116,130,4521,09:00 - 10:59
springer,2012-01-07,10,43,160,203,4521,09:00 - 10:59
springer,2012-01-07,11,74,250,324,4521,11:00 - 12:59
springer,2012-01-07,12,100,276,376,4521,11:00 - 12:59
springer,2012-01-07,13,149,296,445,4521,13:00 - 14:59
springer,2012-01-07,14,156,356,512,4521,13:00 - 14:59
springer,2012-01-07,15,132,317,449,4521,15:00 - 16:59
springer,2012-01-07,16,133,268,401,4521,15:00 - 16:59
springer,2012-01-07,17,87,235,322,4521,17:00 - 18:59
springer,2012-01-07,18,49,248,297,4521,17:00 - 18:59
springer,2012-01-07,19,44,171,215,4521,19:00 - 20:59
springer,2012-01-07,20,21,149,170,4521,19:00 - 20:59
springer,2012-01-07,21,22,118,140,4521,21:00 - 22:59
springer,2012-01-07,22,16,93,109,4521,21:00 - 22:59
springer,2012-01-07,23,16,103,119,4521,23:00 - 24:59
springer,2012-01-08,0,14,77,91,3425,
springer,2012-01-08,1,10,62,72,3425,01:00 - 02:59
springer,2012-01-08,2,10,57,67,3425,01:00 - 02:59
springer,2012-01-08,3,6,26,32,3425,03:00 - 04:59
springer,2012-01-08,4,2,4,6,3425,03:00 - 04:59
springer,2012-01-08,5,0,2,2,3425,05:00 - 06:59
springer,2012-01-08,6,0,2,2,3425,05:00 - 06:59
springer,2012-01-08,7,1,23,24,3425,07:00 - 08:59
springer,2012-01-08,8,4,53,57,3425,07:00 - 08:59
springer,2012-01-08,9,23,102,125,3425,09:00 - 10:59
springer,2012-01-08,10,27,181,208,3425,09:00 - 10:59
springer,2012-01-08,11,55,201,256,3425,11:00 - 12:59
springer,2012-01-08,12,78,273,351,3425,11:00 - 12:59
springer,2012-01-08,13,77,266,343,3425,13:00 - 14:59
springer,2012-01-08,14,75,253,328,3425,13:00 - 14:59
springer,2012-01-08,15,89,241,330,3425,15:00 - 16:59
springer,2012-01-08,16,58,256,314,3425,15:00 - 16:59
springer,2012-01-08,17,22,197,219,3425,17:00 - 18:59
springer,2012-01-08,18,19,162,181,3425,17:00 - 18:59
springer,2012-01-08,19,8,104,112,3425,19:00 - 20:59
springer,2012-01-08,20,7,119,126,3425,19:00 - 20:59
springer,2012-01-08,21,10,81,91,3425,21:00 - 22:59
springer,2012-01-08,22,4,54,58,3425,21:00 - 22:59
springer,2012-01-08,23,0,30,30,3425,23:00 - 24:59
springer,2012-01-09,0,3,12,15,2376,
springer,2012-01-09,1,1,4,5,2376,01:00 - 02:59
springer,2012-01-09,2,2,3,5,2376,01:00 - 02:59
springer,2012-01-09,3,0,3,3,2376,03:00 - 04:59
springer,2012-01-09,4,0,4,4,2376,03:00 - 04:59
springer,2012-01-09,5,0,21,21,2376,05:00 - 06:59
springer,2012-01-09,6,3,85,88,2376,05:00 - 06:59
springer,2012-01-09,7,1,239,240,2376,07:00 - 08:59
springer,2012-01-09,8,13,407,420,2376,07:00 - 08:59
springer,2012-01-09,9,9,188,197,2376,09:00 - 10:59
springer,2012-01-09,10,13,95,108,2376,09:00 - 10:59
springer,2012-01-09,11,6,82,88,2376,11:00 - 12:59
springer,2012-01-09,12,10,93,103,2376,11:00 - 12:59
springer,2012-01-09,13,3,77,80,2376,13:00 - 14:59
springer,2012-01-09,14,5,45,50,2376,13:00 - 14:59
springer,2012-01-09,15,5,64,69,2376,15:00 - 16:59
springer,2012-01-09,16,3,46,49,2376,15:00 - 16:59
springer,2012-01-09,17,5,147,152,2376,17:00 - 18:59
springer,2012-01-09,18,6,158,164,2376,17:00 - 18:59
springer,2012-01-09,19,3,187,190,2376,19:00 - 20:59
springer,2012-01-09,20,5,127,132,2376,19:00 - 20:59
springer,2012-01-09,21,1,78,79,2376,21:00 - 22:59
springer,2012-01-09,22,8,54,62,2376,21:00 - 22:59
springer,2012-01-09,23,1,51,52,2376,23:00 - 24:59
springer,2012-01-10,0,0,14,14,3598,
springer,2012-01-10,1,2,3,5,3598,01:00 - 02:59
springer,2012-01-10,2,2,2,4,3598,01:00 - 02:59
springer,2012-01-10,4,0,4,4,3598,03:00 - 04:59
springer,2012-01-10,5,0,23,23,3598,05:00 - 06:59
springer,2012-01-10,6,0,79,79,3598,05:00 - 06:59
springer,2012-01-10,7,3,219,222,3598,07:00 - 08:59
springer,2012-01-10,8,6,465,471,3598,07:00 - 08:59
springer,2012-01-10,9,11,184,195,3598,09:00 - 10:59
springer,2012-01-10,10,3,80,83,3598,09:00 - 10:59
springer,2012-01-10,11,8,93,101,3598,11:00 - 12:59
springer,2012-01-10,12,13,127,140,3598,11:00 - 12:59
springer,2012-01-10,13,15,163,178,3598,13:00 - 14:59
springer,2012-01-10,14,10,96,106,3598,13:00 - 14:59
springer,2012-01-10,15,17,119,136,3598,15:00 - 16:59
springer,2012-01-10,16,15,225,240,3598,15:00 - 16:59
springer,2012-01-10,17,14,446,460,3598,17:00 - 18:59
springer,2012-01-10,18,13,372,385,3598,17:00 - 18:59
springer,2012-01-10,19,11,270,281,3598,19:00 - 20:59
springer,2012-01-10,20,10,190,200,3598,19:00 - 20:59
springer,2012-01-10,21,7,109,116,3598,21:00 - 22:59
springer,2012-01-10,22,10,104,114,3598,21:00 - 22:59
springer,2012-01-10,23,3,38,41,3598,23:00 - 24:59
springer,2012-01-11,0,2,26,28,2177,
springer,2012-01-11,1,1,6,7,2177,01:00 - 02:59
springer,2012-01-11,2,0,5,5,2177,01:00 - 02:59
springer,2012-01-11,3,0,4,4,2177,03:00 - 04:59
springer,2012-01-11,4,0,2,2,2177,03:00 - 04:59
springer,2012-01-11,5,0,22,22,2177,05:00 - 06:59
springer,2012-01-11,6,2,72,74,2177,05:00 - 06:59
springer,2012-01-11,7,9,247,256,2177,07:00 - 08:59
springer,2012-01-11,8,11,488,499,2177,07:00 - 08:59
springer,2012-01-11,9,7,218,225,2177,09:00 - 10:59
springer,2012-01-11,10,13,84,97,2177,09:00 - 10:59
springer,2012-01-11,11,9,90,99,2177,11:00 - 12:59
springer,2012-01-11,12,4,51,55,2177,11:00 - 12:59
springer,2012-01-11,13,8,57,65,2177,13:00 - 14:59
springer,2012-01-11,14,3,70,73,2177,13:00 - 14:59
springer,2012-01-11,15,6,73,79,2177,15:00 - 16:59
springer,2012-01-11,16,6,112,118,2177,15:00 - 16:59
springer,2012-01-11,17,6,128,134,2177,17:00 - 18:59
springer,2012-01-11,18,2,96,98,2177,17:00 - 18:59
springer,2012-01-11,19,1,92,93,2177,19:00 - 20:59
springer,2012-01-11,20,2,55,57,2177,19:00 - 20:59
springer,2012-01-11,21,0,29,29,2177,21:00 - 22:59
springer,2012-01-11,22,0,49,49,2177,21:00 - 22:59
springer,2012-01-11,23,0,9,9,2177,23:00 - 24:59
springer,2012-01-12,0,0,3,3,4097,
springer,2012-01-12,1,0,3,3,4097,01:00 - 02:59
springer,2012-01-12,2,1,1,2,4097,01:00 - 02:59
springer,2012-01-12,3,0,3,3,4097,03:00 - 04:59
springer,2012-01-12,4,0,2,2,4097,03:00 - 04:59
springer,2012-01-12,5,0,16,16,4097,05:00 - 06:59
springer,2012-01-12,6,1,88,89,4097,05:00 - 06:59
springer,2012-01-12,7,2,218,220,4097,07:00 - 08:59
springer,2012-01-12,8,11,497,508,4097,07:00 - 08:59
springer,2012-01-12,9,10,220,230,4097,09:00 - 10:59
springer,2012-01-12,10,6,84,90,4097,09:00 - 10:59
springer,2012-01-12,11,18,101,119,4097,11:00 - 12:59
springer,2012-01-12,12,14,130,144,4097,11:00 - 12:59
springer,2012-01-12,13,13,170,183,4097,13:00 - 14:59
springer,2012-01-12,14,24,132,156,4097,13:00 - 14:59
springer,2012-01-12,15,32,156,188,4097,15:00 - 16:59
springer,2012-01-12,16,33,248,281,4097,15:00 - 16:59
springer,2012-01-12,17,23,472,495,4097,17:00 - 18:59
springer,2012-01-12,18,22,399,421,4097,17:00 - 18:59
springer,2012-01-12,19,17,313,330,4097,19:00 - 20:59
springer,2012-01-12,20,11,229,240,4097,19:00 - 20:59
springer,2012-01-12,21,12,162,174,4097,21:00 - 22:59
springer,2012-01-12,22,12,121,133,4097,21:00 - 22:59
springer,2012-01-12,23,7,60,67,4097,23:00 - 24:59
springer,2012-01-13,0,4,38,42,3214,
springer,2012-01-13,1,0,12,12,3214,01:00 - 02:59
springer,2012-01-13,2,1,13,14,3214,01:00 - 02:59
springer,2012-01-13,3,3,4,7,3214,03:00 - 04:59
springer,2012-01-13,4,1,2,3,3214,03:00 - 04:59
springer,2012-01-13,5,0,21,21,3214,05:00 - 06:59
springer,2012-01-13,6,2,71,73,3214,05:00 - 06:59
springer,2012-01-13,7,3,174,177,3214,07:00 - 08:59
springer,2012-01-13,8,11,408,419,3214,07:00 - 08:59
springer,2012-01-13,9,10,204,214,3214,09:00 - 10:59
springer,2012-01-13,10,2,101,103,3214,09:00 - 10:59
springer,2012-01-13,11,12,102,114,3214,11:00 - 12:59
springer,2012-01-13,12,14,140,154,3214,11:00 - 12:59
springer,2012-01-13,13,14,140,154,3214,13:00 - 14:59
springer,2012-01-13,14,10,119,129,3214,13:00 - 14:59
springer,2012-01-13,15,15,123,138,3214,15:00 - 16:59
springer,2012-01-13,16,18,215,233,3214,15:00 - 16:59
springer,2012-01-13,17,15,317,332,3214,17:00 - 18:59
springer,2012-01-13,18,7,294,301,3214,17:00 - 18:59
springer,2012-01-13,19,7,199,206,3214,19:00 - 20:59
springer,2012-01-13,20,6,130,136,3214,19:00 - 20:59
springer,2012-01-13,21,7,95,102,3214,21:00 - 22:59
springer,2012-01-13,22,7,58,65,3214,21:00 - 22:59
springer,2012-01-13,23,5,60,65,3214,23:00 - 24:59
springer,2012-01-14,0,2,42,44,2493,
springer,2012-01-14,1,6,44,50,2493,01:00 - 02:59
springer,2012-01-14,2,6,32,38,2493,01:00 - 02:59
springer,2012-01-14,3,6,14,20,2493,03:00 - 04:59
springer,2012-01-14,4,0,3,3,2493,03:00 - 04:59
springer,2012-01-14,5,0,4,4,2493,05:00 - 06:59
springer,2012-01-14,6,0,5,5,2493,05:00 - 06:59
springer,2012-01-14,7,0,24,24,2493,07:00 - 08:59
springer,2012-01-14,8,3,89,92,2493,07:00 - 08:59
springer,2012-01-14,9,3,78,81,2493,09:00 - 10:59
springer,2012-01-14,10,14,135,149,2493,09:00 - 10:59
springer,2012-01-14,11,28,150,178,2493,11:00 - 12:59
springer,2012-01-14,12,30,189,219,2493,11:00 - 12:59
springer,2012-01-14,13,38,182,220,2493,13:00 - 14:59
springer,2012-01-14,14,52,179,231,2493,13:00 - 14:59
springer,2012-01-14,15,49,177,226,2493,15:00 - 16:59
springer,2012-01-14,16,28,178,206,2493,15:00 - 16:59
springer,2012-01-14,17,15,129,144,2493,17:00 - 18:59
springer,2012-01-14,18,21,122,143,2493,17:00 - 18:59
springer,2012-01-14,19,12,90,102,2493,19:00 - 20:59
springer,2012-01-14,20,8,95,103,2493,19:00 - 20:59
springer,2012-01-14,21,3,66,69,2493,21:00 - 22:59
springer,2012-01-14,22,4,62,66,2493,21:00 - 22:59
springer,2012-01-14,23,5,71,76,2493,23:00 - 24:59
springer,2012-01-15,0,9,50,59,2311,
springer,2012-01-15,1,2,40,42,2311,01:00 - 02:59
springer,2012-01-15,2,5,38,43,2311,01:00 - 02:59
springer,2012-01-15,3,1,24,25,2311,03:00 - 04:59
springer,2012-01-15,4,1,5,6,2311,03:00 - 04:59
springer,2012-01-15,5,0,5,5,2311,05:00 - 06:59
springer,2012-01-15,6,1,7,8,2311,05:00 - 06:59
springer,2012-01-15,7,3,14,17,2311,07:00 - 08:59
springer,2012-01-15,8,2,34,36,2311,07:00 - 08:59
springer,2012-01-15,9,10,80,90,2311,09:00 - 10:59
springer,2012-01-15,10,11,115,126,2311,09:00 - 10:59
springer,2012-01-15,11,21,144,165,2311,11:00 - 12:59
springer,2012-01-15,12,42,192,234,2311,11:00 - 12:59
springer,2012-01-15,13,40,184,224,2311,13:00 - 14:59
springer,2012-01-15,14,25,163,188,2311,13:00 - 14:59
springer,2012-01-15,15,33,173,206,2311,15:00 - 16:59
springer,2012-01-15,16,31,174,205,2311,15:00 - 16:59
springer,2012-01-15,17,15,131,146,2311,17:00 - 18:59
springer,2012-01-15,18,7,113,120,2311,17:00 - 18:59
springer,2012-01-15,19,9,101,110,2311,19:00 - 20:59
springer,2012-01-15,20,10,85,95,2311,19:00 - 20:59
springer,2012-01-15,21,1,71,72,2311,21:00 - 22:59
springer,2012-01-15,22,2,58,60,2311,21:00 - 22:59
springer,2012-01-15,23,3,26,29,2311,23:00 - 24:59
springer,2012-01-16,0,2,23,25,2298,
springer,2012-01-16,1,2,18,20,2298,01:00 - 02:59
springer,2012-01-16,2,3,14,17,2298,01:00 - 02:59
springer,2012-01-16,3,0,3,3,2298,03:00 - 04:59
springer,2012-01-16,4,2,6,8,2298,03:00 - 04:59
springer,2012-01-16,5,1,5,6,2298,05:00 - 06:59
springer,2012-01-16,6,0,13,13,2298,05:00 - 06:59
springer,2012-01-16,7,5,28,33,2298,07:00 - 08:59
springer,2012-01-16,8,3,75,78,2298,07:00 - 08:59
springer,2012-01-16,9,7,89,96,2298,09:00 - 10:59
springer,2012-01-16,10,19,107,126,2298,09:00 - 10:59
springer,2012-01-16,11,21,158,179,2298,11:00 - 12:59
springer,2012-01-16,12,20,165,185,2298,11:00 - 12:59
springer,2012-01-16,13,26,202,228,2298,13:00 - 14:59
springer,2012-01-16,14,23,158,181,2298,13:00 - 14:59
springer,2012-01-16,15,17,175,192,2298,15:00 - 16:59
springer,2012-01-16,16,22,158,180,2298,15:00 - 16:59
springer,2012-01-16,17,19,174,193,2298,17:00 - 18:59
springer,2012-01-16,18,6,175,181,2298,17:00 - 18:59
springer,2012-01-16,19,10,134,144,2298,19:00 - 20:59
springer,2012-01-16,20,2,88,90,2298,19:00 - 20:59
springer,2012-01-16,21,3,46,49,2298,21:00 - 22:59
springer,2012-01-16,22,4,39,43,2298,21:00 - 22:59
springer,2012-01-16,23,0,28,28,2298,23:00 - 24:59
springer,2012-01-17,0,0,12,12,2935,
springer,2012-01-17,1,0,2,2,2935,01:00 - 02:59
springer,2012-01-17,2,0,12,12,2935,01:00 - 02:59
springer,2012-01-17,4,0,2,2,2935,03:00 - 04:59
springer,2012-01-17,5,0,13,13,2935,05:00 - 06:59
springer,2012-01-17,6,0,57,57,2935,05:00 - 06:59
springer,2012-01-17,7,5,121,126,2935,07:00 - 08:59
springer,2012-01-17,8,3,90,93,2935,07:00 - 08:59
springer,2012-01-17,9,7,61,68,2935,09:00 - 10:59
springer,2012-01-17,10,1,61,62,2935,09:00 - 10:59
springer,2012-01-17,11,2,73,75,2935,11:00 - 12:59
springer,2012-01-17,12,3,83,86,2935,11:00 - 12:59
springer,2012-01-17,13,8,95,103,2935,13:00 - 14:59
springer,2012-01-17,14,12,120,132,2935,13:00 - 14:59
springer,2012-01-17,15,6,123,129,2935,15:00 - 16:59
springer,2012-01-17,16,14,205,219,2935,15:00 - 16:59
springer,2012-01-17,17,20,442,462,2935,17:00 - 18:59
springer,2012-01-17,18,12,451,463,2935,17:00 - 18:59
springer,2012-01-17,19,11,297,308,2935,19:00 - 20:59
springer,2012-01-17,20,11,169,180,2935,19:00 - 20:59
springer,2012-01-17,21,6,174,180,2935,21:00 - 22:59
springer,2012-01-17,22,5,85,90,2935,21:00 - 22:59
springer,2012-01-17,23,1,60,61,2935,23:00 - 24:59
springer,2012-01-18,0,3,14,17,3376,
springer,2012-01-18,1,0,10,10,3376,01:00 - 02:59
springer,2012-01-18,2,1,1,2,3376,01:00 - 02:59
springer,2012-01-18,3,1,3,4,3376,03:00 - 04:59
springer,2012-01-18,4,0,1,1,3376,03:00 - 04:59
springer,2012-01-18,5,0,29,29,3376,05:00 - 06:59
springer,2012-01-18,6,0,88,88,3376,05:00 - 06:59
springer,2012-01-18,7,1,262,263,3376,07:00 - 08:59
springer,2012-01-18,8,15,474,489,3376,07:00 - 08:59
springer,2012-01-18,9,6,196,202,3376,09:00 - 10:59
springer,2012-01-18,10,5,88,93,3376,09:00 - 10:59
springer,2012-01-18,11,4,110,114,3376,11:00 - 12:59
springer,2012-01-18,12,6,155,161,3376,11:00 - 12:59
springer,2012-01-18,13,6,124,130,3376,13:00 - 14:59
springer,2012-01-18,14,7,98,105,3376,13:00 - 14:59
springer,2012-01-18,15,8,122,130,3376,15:00 - 16:59
springer,2012-01-18,16,13,163,176,3376,15:00 - 16:59
springer,2012-01-18,17,8,338,346,3376,17:00 - 18:59
springer,2012-01-18,18,8,347,355,3376,17:00 - 18:59
springer,2012-01-18,19,5,251,256,3376,19:00 - 20:59
springer,2012-01-18,20,1,164,165,3376,19:00 - 20:59
springer,2012-01-18,21,5,119,124,3376,21:00 - 22:59
springer,2012-01-18,22,4,74,78,3376,21:00 - 22:59
springer,2012-01-18,23,2,36,38,3376,23:00 - 24:59
springer,2012-01-19,0,0,16,16,3292,
springer,2012-01-19,1,0,5,5,3292,01:00 - 02:59
springer,2012-01-19,2,0,3,3,3292,01:00 - 02:59
springer,2012-01-19,3,0,4,4,3292,03:00 - 04:59
springer,2012-01-19,4,0,1,1,3292,03:00 - 04:59
springer,2012-01-19,5,0,19,19,3292,05:00 - 06:59
springer,2012-01-19,6,0,86,86,3292,05:00 - 06:59
springer,2012-01-19,7,2,204,206,3292,07:00 - 08:59
springer,2012-01-19,8,9,414,423,3292,07:00 - 08:59
springer,2012-01-19,9,6,204,210,3292,09:00 - 10:59
springer,2012-01-19,10,10,98,108,3292,09:00 - 10:59
springer,2012-01-19,11,6,93,99,3292,11:00 - 12:59
springer,2012-01-19,12,5,106,111,3292,11:00 - 12:59
springer,2012-01-19,13,6,118,124,3292,13:00 - 14:59
springer,2012-01-19,14,15,104,119,3292,13:00 - 14:59
springer,2012-01-19,15,9,118,127,3292,15:00 - 16:59
springer,2012-01-19,16,8,185,193,3292,15:00 - 16:59
springer,2012-01-19,17,21,364,385,3292,17:00 - 18:59
springer,2012-01-19,18,16,345,361,3292,17:00 - 18:59
springer,2012-01-19,19,5,229,234,3292,19:00 - 20:59
springer,2012-01-19,20,7,184,191,3292,19:00 - 20:59
springer,2012-01-19,21,4,117,121,3292,21:00 - 22:59
springer,2012-01-19,22,0,90,90,3292,21:00 - 22:59
springer,2012-01-19,23,1,55,56,3292,23:00 - 24:59
springer,2012-01-20,0,3,24,27,3163,
springer,2012-01-20,1,0,15,15,3163,01:00 - 02:59
springer,2012-01-20,2,0,11,11,3163,01:00 - 02:59
springer,2012-01-20,3,0,4,4,3163,03:00 - 04:59
springer,2012-01-20,4,0,3,3,3163,03:00 - 04:59
springer,2012-01-20,5,0,19,19,3163,05:00 - 06:59
springer,2012-01-20,6,0,68,68,3163,05:00 - 06:59
springer,2012-01-20,7,2,183,185,3163,07:00 - 08:59
springer,2012-01-20,8,4,421,425,3163,07:00 - 08:59
springer,2012-01-20,9,21,242,263,3163,09:00 - 10:59
springer,2012-01-20,10,1,96,97,3163,09:00 - 10:59
springer,2012-01-20,11,6,117,123,3163,11:00 - 12:59
springer,2012-01-20,12,5,119,124,3163,11:00 - 12:59
springer,2012-01-20,13,12,144,156,3163,13:00 - 14:59
springer,2012-01-20,14,8,107,115,3163,13:00 - 14:59
springer,2012-01-20,15,12,144,156,3163,15:00 - 16:59
springer,2012-01-20,16,11,163,174,3163,15:00 - 16:59
springer,2012-01-20,17,9,340,349,3163,17:00 - 18:59
springer,2012-01-20,18,5,296,301,3163,17:00 - 18:59
springer,2012-01-20,19,6,186,192,3163,19:00 - 20:59
springer,2012-01-20,20,1,141,142,3163,19:00 - 20:59
springer,2012-01-20,21,5,99,104,3163,21:00 - 22:59
springer,2012-01-20,22,1,71,72,3163,21:00 - 22:59
springer,2012-01-20,23,3,35,38,3163,23:00 - 24:59
springer,2012-01-21,0,0,24,24,1301,
springer,2012-01-21,1,1,22,23,1301,01:00 - 02:59
springer,2012-01-21,2,1,25,26,1301,01:00 - 02:59
springer,2012-01-21,3,0,13,13,1301,03:00 - 04:59
springer,2012-01-21,4,0,1,1,1301,03:00 - 04:59
springer,2012-01-21,5,0,2,2,1301,05:00 - 06:59
springer,2012-01-21,6,0,1,1,1301,05:00 - 06:59
springer,2012-01-21,7,3,10,13,1301,07:00 - 08:59
springer,2012-01-21,8,3,22,25,1301,07:00 - 08:59
springer,2012-01-21,9,2,40,42,1301,09:00 - 10:59
springer,2012-01-21,10,0,45,45,1301,09:00 - 10:59
springer,2012-01-21,11,1,62,63,1301,11:00 - 12:59
springer,2012-01-21,12,5,62,67,1301,11:00 - 12:59
springer,2012-01-21,13,10,66,76,1301,13:00 - 14:59
springer,2012-01-21,14,6,89,95,1301,13:00 - 14:59
springer,2012-01-21,15,6,113,119,1301,15:00 - 16:59
springer,2012-01-21,16,5,113,118,1301,15:00 - 16:59
springer,2012-01-21,17,7,99,106,1301,17:00 - 18:59
springer,2012-01-21,18,3,107,110,1301,17:00 - 18:59
springer,2012-01-21,19,0,85,85,1301,19:00 - 20:59
springer,2012-01-21,20,5,62,67,1301,19:00 - 20:59
springer,2012-01-21,21,5,64,69,1301,21:00 - 22:59
springer,2012-01-21,22,3,56,59,1301,21:00 - 22:59
springer,2012-01-21,23,1,51,52,1301,23:00 - 24:59
springer,2012-01-22,0,1,51,52,1977,
springer,2012-01-22,1,1,49,50,1977,01:00 - 02:59
springer,2012-01-22,2,1,46,47,1977,01:00 - 02:59
springer,2012-01-22,3,1,20,21,1977,03:00 - 04:59
springer,2012-01-22,4,1,1,2,1977,03:00 - 04:59
springer,2012-01-22,5,1,2,3,1977,05:00 - 06:59
springer,2012-01-22,6,0,4,4,1977,05:00 - 06:59
springer,2012-01-22,7,2,11,13,1977,07:00 - 08:59
springer,2012-01-22,8,3,29,32,1977,07:00 - 08:59
springer,2012-01-22,9,9,54,63,1977,09:00 - 10:59
springer,2012-01-22,10,9,120,129,1977,09:00 - 10:59
springer,2012-01-22,11,18,115,133,1977,11:00 - 12:59
springer,2012-01-22,12,24,161,185,1977,11:00 - 12:59
springer,2012-01-22,13,24,175,199,1977,13:00 - 14:59
springer,2012-01-22,14,19,163,182,1977,13:00 - 14:59
springer,2012-01-22,15,27,149,176,1977,15:00 - 16:59
springer,2012-01-22,16,12,143,155,1977,15:00 - 16:59
springer,2012-01-22,17,8,100,108,1977,17:00 - 18:59
springer,2012-01-22,18,11,110,121,1977,17:00 - 18:59
springer,2012-01-22,19,9,80,89,1977,19:00 - 20:59
springer,2012-01-22,20,5,69,74,1977,19:00 - 20:59
springer,2012-01-22,21,8,36,44,1977,21:00 - 22:59
springer,2012-01-22,22,0,58,58,1977,21:00 - 22:59
springer,2012-01-22,23,2,35,37,1977,23:00 - 24:59
springer,2012-01-23,0,2,17,19,2432,
springer,2012-01-23,1,0,4,4,2432,01:00 - 02:59
springer,2012-01-23,2,0,2,2,2432,01:00 - 02:59
springer,2012-01-23,3,0,1,1,2432,03:00 - 04:59
springer,2012-01-23,4,0,1,1,2432,03:00 - 04:59
springer,2012-01-23,5,0,19,19,2432,05:00 - 06:59
springer,2012-01-23,6,6,36,42,2432,05:00 - 06:59
springer,2012-01-23,7,8,114,122,2432,07:00 - 08:59
springer,2012-01-23,8,5,267,272,2432,07:00 - 08:59
springer,2012-01-23,9,13,198,211,2432,09:00 - 10:59
springer,2012-01-23,10,10,139,149,2432,09:00 - 10:59
springer,2012-01-23,11,5,57,62,2432,11:00 - 12:59
springer,2012-01-23,12,10,52,62,2432,11:00 - 12:59
springer,2012-01-23,13,5,32,37,2432,13:00 - 14:59
springer,2012-01-23,14,13,48,61,2432,13:00 - 14:59
springer,2012-01-23,15,10,64,74,2432,15:00 - 16:59
springer,2012-01-23,16,14,108,122,2432,15:00 - 16:59
springer,2012-01-23,17,6,270,276,2432,17:00 - 18:59
springer,2012-01-23,18,7,275,282,2432,17:00 - 18:59
springer,2012-01-23,19,9,211,220,2432,19:00 - 20:59
springer,2012-01-23,20,8,161,169,2432,19:00 - 20:59
springer,2012-01-23,21,8,112,120,2432,21:00 - 22:59
springer,2012-01-23,22,4,64,68,2432,21:00 - 22:59
springer,2012-01-23,23,2,35,37,2432,23:00 - 24:59
springer,2012-01-24,0,6,19,25,4339,
springer,2012-01-24,1,2,7,9,4339,01:00 - 02:59
springer,2012-01-24,2,2,6,8,4339,01:00 - 02:59
springer,2012-01-24,3,0,3,3,4339,03:00 - 04:59
springer,2012-01-24,4,0,2,2,4339,03:00 - 04:59
springer,2012-01-24,5,0,26,26,4339,05:00 - 06:59
springer,2012-01-24,6,1,88,89,4339,05:00 - 06:59
springer,2012-01-24,7,11,221,232,4339,07:00 - 08:59
springer,2012-01-24,8,11,479,490,4339,07:00 - 08:59
springer,2012-01-24,9,11,244,255,4339,09:00 - 10:59
springer,2012-01-24,10,23,93,116,4339,09:00 - 10:59
springer,2012-01-24,11,30,123,153,4339,11:00 - 12:59
springer,2012-01-24,12,25,150,175,4339,11:00 - 12:59
springer,2012-01-24,13,33,170,203,4339,13:00 - 14:59
springer,2012-01-24,14,35,138,173,4339,13:00 - 14:59
springer,2012-01-24,15,52,156,208,4339,15:00 - 16:59
springer,2012-01-24,16,35,243,278,4339,15:00 - 16:59
springer,2012-01-24,17,41,474,515,4339,17:00 - 18:59
springer,2012-01-24,18,32,391,423,4339,17:00 - 18:59
springer,2012-01-24,19,20,311,331,4339,19:00 - 20:59
springer,2012-01-24,20,18,211,229,4339,19:00 - 20:59
springer,2012-01-24,21,18,154,172,4339,21:00 - 22:59
springer,2012-01-24,22,14,111,125,4339,21:00 - 22:59
springer,2012-01-24,23,19,80,99,4339,23:00 - 24:59
springer,2012-01-25,0,6,25,31,4270,
springer,2012-01-25,1,4,9,13,4270,01:00 - 02:59
springer,2012-01-25,2,3,3,6,4270,01:00 - 02:59
springer,2012-01-25,3,0,1,1,4270,03:00 - 04:59
springer,2012-01-25,4,0,4,4,4270,03:00 - 04:59
springer,2012-01-25,5,0,33,33,4270,05:00 - 06:59
springer,2012-01-25,6,1,87,88,4270,05:00 - 06:59
springer,2012-01-25,7,14,243,257,4270,07:00 - 08:59
springer,2012-01-25,8,18,495,513,4270,07:00 - 08:59
springer,2012-01-25,9,18,218,236,4270,09:00 - 10:59
springer,2012-01-25,10,30,111,141,4270,09:00 - 10:59
springer,2012-01-25,11,52,105,157,4270,11:00 - 12:59
springer,2012-01-25,12,46,147,193,4270,11:00 - 12:59
springer,2012-01-25,13,63,149,212,4270,13:00 - 14:59
springer,2012-01-25,14,53,107,160,4270,13:00 - 14:59
springer,2012-01-25,15,30,125,155,4270,15:00 - 16:59
springer,2012-01-25,16,29,217,246,4270,15:00 - 16:59
springer,2012-01-25,17,27,443,470,4270,17:00 - 18:59
springer,2012-01-25,18,24,415,439,4270,17:00 - 18:59
springer,2012-01-25,19,5,311,316,4270,19:00 - 20:59
springer,2012-01-25,20,10,225,235,4270,19:00 - 20:59
springer,2012-01-25,21,19,166,185,4270,21:00 - 22:59
springer,2012-01-25,22,12,101,113,4270,21:00 - 22:59
springer,2012-01-25,23,3,63,66,4270,23:00 - 24:59
springer,2012-01-26,0,3,22,25,4075,
springer,2012-01-26,1,5,16,21,4075,01:00 - 02:59
springer,2012-01-26,2,1,6,7,4075,01:00 - 02:59
springer,2012-01-26,3,1,5,6,4075,03:00 - 04:59
springer,2012-01-26,4,0,3,3,4075,03:00 - 04:59
springer,2012-01-26,5,0,28,28,4075,05:00 - 06:59
springer,2012-01-26,6,0,88,88,4075,05:00 - 06:59
springer,2012-01-26,7,11,228,239,4075,07:00 - 08:59
springer,2012-01-26,8,16,514,530,4075,07:00 - 08:59
springer,2012-01-26,9,18,256,274,4075,09:00 - 10:59
springer,2012-01-26,10,16,92,108,4075,09:00 - 10:59
springer,2012-01-26,11,11,100,111,4075,11:00 - 12:59
springer,2012-01-26,12,29,136,165,4075,11:00 - 12:59
springer,2012-01-26,13,17,156,173,4075,13:00 - 14:59
springer,2012-01-26,14,16,112,128,4075,13:00 - 14:59
springer,2012-01-26,15,22,142,164,4075,15:00 - 16:59
springer,2012-01-26,16,15,209,224,4075,15:00 - 16:59
springer,2012-01-26,17,16,397,413,4075,17:00 - 18:59
springer,2012-01-26,18,12,394,406,4075,17:00 - 18:59
springer,2012-01-26,19,11,302,313,4075,19:00 - 20:59
springer,2012-01-26,20,8,216,224,4075,19:00 - 20:59
springer,2012-01-26,21,8,184,192,4075,21:00 - 22:59
springer,2012-01-26,22,3,139,142,4075,21:00 - 22:59
springer,2012-01-26,23,5,86,91,4075,23:00 - 24:59
springer,2012-01-27,0,6,32,38,3456,
springer,2012-01-27,1,6,23,29,3456,01:00 - 02:59
springer,2012-01-27,2,2,11,13,3456,01:00 - 02:59
springer,2012-01-27,3,3,5,8,3456,03:00 - 04:59
springer,2012-01-27,4,1,3,4,3456,03:00 - 04:59
springer,2012-01-27,5,0,24,24,3456,05:00 - 06:59
springer,2012-01-27,6,0,72,72,3456,05:00 - 06:59
springer,2012-01-27,7,6,128,134,3456,07:00 - 08:59
springer,2012-01-27,8,14,206,220,3456,07:00 - 08:59
springer,2012-01-27,9,6,101,107,3456,09:00 - 10:59
springer,2012-01-27,10,9,117,126,3456,09:00 - 10:59
springer,2012-01-27,11,10,95,105,3456,11:00 - 12:59
springer,2012-01-27,12,25,155,180,3456,11:00 - 12:59
springer,2012-01-27,13,26,175,201,3456,13:00 - 14:59
springer,2012-01-27,14,23,153,176,3456,13:00 - 14:59
springer,2012-01-27,15,27,170,197,3456,15:00 - 16:59
springer,2012-01-27,16,26,241,267,3456,15:00 - 16:59
springer,2012-01-27,17,16,406,422,3456,17:00 - 18:59
springer,2012-01-27,18,20,363,383,3456,17:00 - 18:59
springer,2012-01-27,19,10,241,251,3456,19:00 - 20:59
springer,2012-01-27,20,6,153,159,3456,19:00 - 20:59
springer,2012-01-27,21,8,127,135,3456,21:00 - 22:59
springer,2012-01-27,22,11,108,119,3456,21:00 - 22:59
springer,2012-01-27,23,8,78,86,3456,23:00 - 24:59
springer,2012-01-28,0,1,68,69,4023,
springer,2012-01-28,1,1,57,58,4023,01:00 - 02:59
springer,2012-01-28,2,3,38,41,4023,01:00 - 02:59
springer,2012-01-28,3,1,16,17,4023,03:00 - 04:59
springer,2012-01-28,4,0,8,8,4023,03:00 - 04:59
springer,2012-01-28,5,0,10,10,4023,05:00 - 06:59
springer,2012-01-28,6,3,12,15,4023,05:00 - 06:59
springer,2012-01-28,7,3,28,31,4023,07:00 - 08:59
springer,2012-01-28,8,9,82,91,4023,07:00 - 08:59
springer,2012-01-28,9,13,145,158,4023,09:00 - 10:59
springer,2012-01-28,10,27,164,191,4023,09:00 - 10:59
springer,2012-01-28,11,55,241,296,4023,11:00 - 12:59
springer,2012-01-28,12,70,244,314,4023,11:00 - 12:59
springer,2012-01-28,13,80,293,373,4023,13:00 - 14:59
springer,2012-01-28,14,123,239,362,4023,13:00 - 14:59
springer,2012-01-28,15,90,320,410,4023,15:00 - 16:59
springer,2012-01-28,16,131,276,407,4023,15:00 - 16:59
springer,2012-01-28,17,57,233,290,4023,17:00 - 18:59
springer,2012-01-28,18,40,201,241,4023,17:00 - 18:59
springer,2012-01-28,19,33,173,206,4023,19:00 - 20:59
springer,2012-01-28,20,5,115,120,4023,19:00 - 20:59
springer,2012-01-28,21,18,109,127,4023,21:00 - 22:59
springer,2012-01-28,22,6,97,103,4023,21:00 - 22:59
springer,2012-01-28,23,6,79,85,4023,23:00 - 24:59
springer,2012-01-29,0,15,81,96,3243,
springer,2012-01-29,1,5,68,73,3243,01:00 - 02:59
springer,2012-01-29,2,3,48,51,3243,01:00 - 02:59
springer,2012-01-29,3,4,17,21,3243,03:00 - 04:59
springer,2012-01-29,4,0,5,5,3243,03:00 - 04:59
springer,2012-01-29,5,1,6,7,3243,05:00 - 06:59
springer,2012-01-29,6,1,4,5,3243,05:00 - 06:59
springer,2012-01-29,7,0,12,12,3243,07:00 - 08:59
springer,2012-01-29,8,9,61,70,3243,07:00 - 08:59
springer,2012-01-29,9,13,98,111,3243,09:00 - 10:59
springer,2012-01-29,10,38,153,191,3243,09:00 - 10:59
springer,2012-01-29,11,57,198,255,3243,11:00 - 12:59
springer,2012-01-29,12,73,215,288,3243,11:00 - 12:59
springer,2012-01-29,13,78,238,316,3243,13:00 - 14:59
springer,2012-01-29,14,51,229,280,3243,13:00 - 14:59
springer,2012-01-29,15,68,242,310,3243,15:00 - 16:59
springer,2012-01-29,16,54,268,322,3243,15:00 - 16:59
springer,2012-01-29,17,33,201,234,3243,17:00 - 18:59
springer,2012-01-29,18,17,151,168,3243,17:00 - 18:59
springer,2012-01-29,19,14,145,159,3243,19:00 - 20:59
springer,2012-01-29,20,13,98,111,3243,19:00 - 20:59
springer,2012-01-29,21,0,69,69,3243,21:00 - 22:59
springer,2012-01-29,22,7,57,64,3243,21:00 - 22:59
springer,2012-01-29,23,4,21,25,3243,23:00 - 24:59
springer,2012-01-30,0,0,10,10,3624,
springer,2012-01-30,1,0,9,9,3624,01:00 - 02:59
springer,2012-01-30,2,1,6,7,3624,01:00 - 02:59
springer,2012-01-30,3,0,4,4,3624,03:00 - 04:59
springer,2012-01-30,4,0,5,5,3624,03:00 - 04:59
springer,2012-01-30,5,0,26,26,3624,05:00 - 06:59
springer,2012-01-30,6,0,80,80,3624,05:00 - 06:59
springer,2012-01-30,7,4,221,225,3624,07:00 - 08:59
springer,2012-01-30,8,12,481,493,3624,07:00 - 08:59
springer,2012-01-30,9,5,193,198,3624,09:00 - 10:59
springer,2012-01-30,10,3,82,85,3624,09:00 - 10:59
springer,2012-01-30,11,6,93,99,3624,11:00 - 12:59
springer,2012-01-30,12,5,129,134,3624,11:00 - 12:59
springer,2012-01-30,13,15,117,132,3624,13:00 - 14:59
springer,2012-01-30,14,15,100,115,3624,13:00 - 14:59
springer,2012-01-30,15,7,131,138,3624,15:00 - 16:59
springer,2012-01-30,16,11,210,221,3624,15:00 - 16:59
springer,2012-01-30,17,16,422,438,3624,17:00 - 18:59
springer,2012-01-30,18,11,399,410,3624,17:00 - 18:59
springer,2012-01-30,19,8,298,306,3624,19:00 - 20:59
springer,2012-01-30,20,2,179,181,3624,19:00 - 20:59
springer,2012-01-30,21,3,159,162,3624,21:00 - 22:59
springer,2012-01-30,22,2,92,94,3624,21:00 - 22:59
springer,2012-01-30,23,0,52,52,3624,23:00 - 24:59
springer,2012-01-31,0,0,15,15,4509,
springer,2012-01-31,1,1,7,8,4509,01:00 - 02:59
springer,2012-01-31,2,0,2,2,4509,01:00 - 02:59
springer,2012-01-31,3,0,2,2,4509,03:00 - 04:59
springer,2012-01-31,4,0,1,1,4509,03:00 - 04:59
springer,2012-01-31,5,0,22,22,4509,05:00 - 06:59
springer,2012-01-31,6,0,104,104,4509,05:00 - 06:59
springer,2012-01-31,7,6,273,279,4509,07:00 - 08:59
springer,2012-01-31,8,14,498,512,4509,07:00 - 08:59
springer,2012-01-31,9,30,231,261,4509,09:00 - 10:59
springer,2012-01-31,10,34,110,144,4509,09:00 - 10:59
springer,2012-01-31,11,14,125,139,4509,11:00 - 12:59
springer,2012-01-31,12,13,181,194,4509,11:00 - 12:59
springer,2012-01-31,13,27,171,198,4509,13:00 - 14:59
springer,2012-01-31,14,18,142,160,4509,13:00 - 14:59
springer,2012-01-31,15,27,150,177,4509,15:00 - 16:59
springer,2012-01-31,16,30,277,307,4509,15:00 - 16:59
springer,2012-01-31,17,41,518,559,4509,17:00 - 18:59
springer,2012-01-31,18,16,486,502,4509,17:00 - 18:59
springer,2012-01-31,19,22,306,328,4509,19:00 - 20:59
springer,2012-01-31,20,15,223,238,4509,19:00 - 20:59
springer,2012-01-31,21,3,162,165,4509,21:00 - 22:59
springer,2012-01-31,22,11,118,129,4509,21:00 - 22:59
springer,2012-01-31,23,2,61,63,4509,23:00 - 24:59
springer,2012-02-01,0,0,31,31,4579,
springer,2012-02-01,1,0,4,4,4579,01:00 - 02:59
springer,2012-02-01,2,1,6,7,4579,01:00 - 02:59
springer,2012-02-01,3,0,3,3,4579,03:00 - 04:59
springer,2012-02-01,4,0,1,1,4579,03:00 - 04:59
springer,2012-02-01,5,0,18,18,4579,05:00 - 06:59
springer,2012-02-01,6,0,67,67,4579,05:00 - 06:59
springer,2012-02-01,7,7,201,208,4579,07:00 - 08:59
springer,2012-02-01,8,15,505,520,4579,07:00 - 08:59
springer,2012-02-01,9,9,267,276,4579,09:00 - 10:59
springer,2012-02-01,10,9,124,133,4579,09:00 - 10:59
springer,2012-02-01,11,27,116,143,4579,11:00 - 12:59
springer,2012-02-01,12,26,153,179,4579,11:00 - 12:59
springer,2012-02-01,13,12,174,186,4579,13:00 - 14:59
springer,2012-02-01,14,33,159,192,4579,13:00 - 14:59
springer,2012-02-01,15,25,169,194,4579,15:00 - 16:59
springer,2012-02-01,16,22,261,283,4579,15:00 - 16:59
springer,2012-02-01,17,31,508,539,4579,17:00 - 18:59
springer,2012-02-01,18,12,514,526,4579,17:00 - 18:59
springer,2012-02-01,19,20,315,335,4579,19:00 - 20:59
springer,2012-02-01,20,10,254,264,4579,19:00 - 20:59
springer,2012-02-01,21,16,217,233,4579,21:00 - 22:59
springer,2012-02-01,22,7,133,140,4579,21:00 - 22:59
springer,2012-02-01,23,22,75,97,4579,23:00 - 24:59
springer,2012-02-02,0,7,24,31,3761,
springer,2012-02-02,1,3,14,17,3761,01:00 - 02:59
springer,2012-02-02,2,2,7,9,3761,01:00 - 02:59
springer,2012-02-02,3,0,2,2,3761,03:00 - 04:59
springer,2012-02-02,4,0,1,1,3761,03:00 - 04:59
springer,2012-02-02,5,0,19,19,3761,05:00 - 06:59
springer,2012-02-02,6,1,73,74,3761,05:00 - 06:59
springer,2012-02-02,7,4,201,205,3761,07:00 - 08:59
springer,2012-02-02,8,9,436,445,3761,07:00 - 08:59
springer,2012-02-02,9,15,213,228,3761,09:00 - 10:59
springer,2012-02-02,10,6,72,78,3761,09:00 - 10:59
springer,2012-02-02,11,6,99,105,3761,11:00 - 12:59
springer,2012-02-02,12,8,140,148,3761,11:00 - 12:59
springer,2012-02-02,13,13,124,137,3761,13:00 - 14:59
springer,2012-02-02,14,12,129,141,3761,13:00 - 14:59
springer,2012-02-02,15,24,150,174,3761,15:00 - 16:59
springer,2012-02-02,16,18,211,229,3761,15:00 - 16:59
springer,2012-02-02,17,13,437,450,3761,17:00 - 18:59
springer,2012-02-02,18,17,393,410,3761,17:00 - 18:59
springer,2012-02-02,19,16,311,327,3761,19:00 - 20:59
springer,2012-02-02,20,9,204,213,3761,19:00 - 20:59
springer,2012-02-02,21,4,144,148,3761,21:00 - 22:59
springer,2012-02-02,22,3,106,109,3761,21:00 - 22:59
springer,2012-02-02,23,0,61,61,3761,23:00 - 24:59
springer,2012-02-03,0,1,37,38,4151,
springer,2012-02-03,1,3,19,22,4151,01:00 - 02:59
springer,2012-02-03,2,0,6,6,4151,01:00 - 02:59
springer,2012-02-03,3,0,4,4,4151,03:00 - 04:59
springer,2012-02-03,4,0,2,2,4151,03:00 - 04:59
springer,2012-02-03,5,0,17,17,4151,05:00 - 06:59
springer,2012-02-03,6,0,88,88,4151,05:00 - 06:59
springer,2012-02-03,7,10,216,226,4151,07:00 - 08:59
springer,2012-02-03,8,12,429,441,4151,07:00 - 08:59
springer,2012-02-03,9,18,252,270,4151,09:00 - 10:59
springer,2012-02-03,10,15,114,129,4151,09:00 - 10:59
springer,2012-02-03,11,15,149,164,4151,11:00 - 12:59
springer,2012-02-03,12,25,191,216,4151,11:00 - 12:59
springer,2012-02-03,13,25,173,198,4151,13:00 - 14:59
springer,2012-02-03,14,22,148,170,4151,13:00 - 14:59
springer,2012-02-03,15,48,168,216,4151,15:00 - 16:59
springer,2012-02-03,16,36,275,311,4151,15:00 - 16:59
springer,2012-02-03,17,30,458,488,4151,17:00 - 18:59
springer,2012-02-03,18,17,368,385,4151,17:00 - 18:59
springer,2012-02-03,19,11,256,267,4151,19:00 - 20:59
springer,2012-02-03,20,8,155,163,4151,19:00 - 20:59
springer,2012-02-03,21,8,126,134,4151,21:00 - 22:59
springer,2012-02-03,22,3,116,119,4151,21:00 - 22:59
springer,2012-02-03,23,3,74,77,4151,23:00 - 24:59
springer,2012-02-04,0,10,76,86,2832,
springer,2012-02-04,1,0,43,43,2832,01:00 - 02:59
springer,2012-02-04,2,6,38,44,2832,01:00 - 02:59
springer,2012-02-04,3,1,17,18,2832,03:00 - 04:59
springer,2012-02-04,4,1,5,6,2832,03:00 - 04:59
springer,2012-02-04,5,1,3,4,2832,05:00 - 06:59
springer,2012-02-04,6,1,4,5,2832,05:00 - 06:59
springer,2012-02-04,7,1,27,28,2832,07:00 - 08:59
springer,2012-02-04,8,4,86,90,2832,07:00 - 08:59
springer,2012-02-04,9,16,141,157,2832,09:00 - 10:59
springer,2012-02-04,10,31,193,224,2832,09:00 - 10:59
springer,2012-02-04,11,46,224,270,2832,11:00 - 12:59
springer,2012-02-04,12,40,260,300,2832,11:00 - 12:59
springer,2012-02-04,13,58,244,302,2832,13:00 - 14:59
springer,2012-02-04,14,47,229,276,2832,13:00 - 14:59
springer,2012-02-04,15,61,244,305,2832,15:00 - 16:59
springer,2012-02-04,16,20,123,143,2832,15:00 - 16:59
springer,2012-02-04,17,13,54,67,2832,17:00 - 18:59
springer,2012-02-04,18,6,58,64,2832,17:00 - 18:59
springer,2012-02-04,19,5,75,80,2832,19:00 - 20:59
springer,2012-02-04,20,4,73,77,2832,19:00 - 20:59
springer,2012-02-04,21,4,74,78,2832,21:00 - 22:59
springer,2012-02-04,22,4,91,95,2832,21:00 - 22:59
springer,2012-02-04,23,4,66,70,2832,23:00 - 24:59
springer,2012-02-05,0,3,58,61,2947,
springer,2012-02-05,1,5,46,51,2947,01:00 - 02:59
springer,2012-02-05,2,4,59,63,2947,01:00 - 02:59
springer,2012-02-05,3,4,13,17,2947,03:00 - 04:59
springer,2012-02-05,4,0,9,9,2947,03:00 - 04:59
springer,2012-02-05,5,0,4,4,2947,05:00 - 06:59
springer,2012-02-05,6,0,4,4,2947,05:00 - 06:59
springer,2012-02-05,7,0,16,16,2947,07:00 - 08:59
springer,2012-02-05,8,4,58,62,2947,07:00 - 08:59
springer,2012-02-05,9,9,83,92,2947,09:00 - 10:59
springer,2012-02-05,10,10,138,148,2947,09:00 - 10:59
springer,2012-02-05,11,22,160,182,2947,11:00 - 12:59
springer,2012-02-05,12,25,223,248,2947,11:00 - 12:59
springer,2012-02-05,13,33,241,274,2947,13:00 - 14:59
springer,2012-02-05,14,40,203,243,2947,13:00 - 14:59
springer,2012-02-05,15,55,217,272,2947,15:00 - 16:59
springer,2012-02-05,16,35,261,296,2947,15:00 - 16:59
springer,2012-02-05,17,31,275,306,2947,17:00 - 18:59
springer,2012-02-05,18,10,171,181,2947,17:00 - 18:59
springer,2012-02-05,19,6,63,69,2947,19:00 - 20:59
springer,2012-02-05,20,3,47,50,2947,19:00 - 20:59
springer,2012-02-05,21,6,60,66,2947,21:00 - 22:59
springer,2012-02-05,22,9,182,191,2947,21:00 - 22:59
springer,2012-02-05,23,4,38,42,2947,23:00 - 24:59
springer,2012-02-06,0,7,14,21,3784,
springer,2012-02-06,1,0,6,6,3784,01:00 - 02:59
springer,2012-02-06,2,0,3,3,3784,01:00 - 02:59
springer,2012-02-06,4,0,2,2,3784,03:00 - 04:59
springer,2012-02-06,5,0,17,17,3784,05:00 - 06:59
springer,2012-02-06,6,0,72,72,3784,05:00 - 06:59
springer,2012-02-06,7,5,229,234,3784,07:00 - 08:59
springer,2012-02-06,8,10,434,444,3784,07:00 - 08:59
springer,2012-02-06,9,8,269,277,3784,09:00 - 10:59
springer,2012-02-06,10,20,96,116,3784,09:00 - 10:59
springer,2012-02-06,11,12,104,116,3784,11:00 - 12:59
springer,2012-02-06,12,19,131,150,3784,11:00 - 12:59
springer,2012-02-06,13,17,124,141,3784,13:00 - 14:59
springer,2012-02-06,14,14,126,140,3784,13:00 - 14:59
springer,2012-02-06,15,25,146,171,3784,15:00 - 16:59
springer,2012-02-06,16,13,215,228,3784,15:00 - 16:59
springer,2012-02-06,17,13,417,430,3784,17:00 - 18:59
springer,2012-02-06,18,11,426,437,3784,17:00 - 18:59
springer,2012-02-06,19,7,284,291,3784,19:00 - 20:59
springer,2012-02-06,20,7,194,201,3784,19:00 - 20:59
springer,2012-02-06,21,11,143,154,3784,21:00 - 22:59
springer,2012-02-06,22,4,83,87,3784,21:00 - 22:59
springer,2012-02-06,23,3,43,46,3784,23:00 - 24:59
springer,2012-02-07,0,1,22,23,4375,
springer,2012-02-07,1,8,6,14,4375,01:00 - 02:59
springer,2012-02-07,2,0,4,4,4375,01:00 - 02:59
springer,2012-02-07,3,1,1,2,4375,03:00 - 04:59
springer,2012-02-07,4,0,3,3,4375,03:00 - 04:59
springer,2012-02-07,5,0,15,15,4375,05:00 - 06:59
springer,2012-02-07,6,2,98,100,4375,05:00 - 06:59
springer,2012-02-07,7,6,293,299,4375,07:00 - 08:59
springer,2012-02-07,8,7,522,529,4375,07:00 - 08:59
springer,2012-02-07,9,11,278,289,4375,09:00 - 10:59
springer,2012-02-07,10,12,104,116,4375,09:00 - 10:59
springer,2012-02-07,11,9,120,129,4375,11:00 - 12:59
springer,2012-02-07,12,9,163,172,4375,11:00 - 12:59
springer,2012-02-07,13,15,169,184,4375,13:00 - 14:59
springer,2012-02-07,14,11,127,138,4375,13:00 - 14:59
springer,2012-02-07,15,13,133,146,4375,15:00 - 16:59
springer,2012-02-07,16,19,257,276,4375,15:00 - 16:59
springer,2012-02-07,17,15,494,509,4375,17:00 - 18:59
springer,2012-02-07,18,10,508,518,4375,17:00 - 18:59
springer,2012-02-07,19,11,327,338,4375,19:00 - 20:59
springer,2012-02-07,20,6,206,212,4375,19:00 - 20:59
springer,2012-02-07,21,20,170,190,4375,21:00 - 22:59
springer,2012-02-07,22,11,107,118,4375,21:00 - 22:59
springer,2012-02-07,23,2,49,51,4375,23:00 - 24:59
springer,2012-02-08,0,2,21,23,2802,
springer,2012-02-08,1,1,9,10,2802,01:00 - 02:59
springer,2012-02-08,2,0,1,1,2802,01:00 - 02:59
springer,2012-02-08,3,0,1,1,2802,03:00 - 04:59
springer,2012-02-08,4,0,1,1,2802,03:00 - 04:59
springer,2012-02-08,5,0,20,20,2802,05:00 - 06:59
springer,2012-02-08,6,3,95,98,2802,05:00 - 06:59
springer,2012-02-08,7,5,276,281,2802,07:00 - 08:59
springer,2012-02-08,8,13,495,508,2802,07:00 - 08:59
springer,2012-02-08,9,8,245,253,2802,09:00 - 10:59
springer,2012-02-08,10,1,107,108,2802,09:00 - 10:59
springer,2012-02-08,11,5,97,102,2802,11:00 - 12:59
springer,2012-02-08,12,14,124,138,2802,11:00 - 12:59
springer,2012-02-08,13,15,111,126,2802,13:00 - 14:59
springer,2012-02-08,14,8,100,108,2802,13:00 - 14:59
springer,2012-02-08,15,5,49,54,2802,15:00 - 16:59
springer,2012-02-08,16,2,73,75,2802,15:00 - 16:59
springer,2012-02-08,17,8,147,155,2802,17:00 - 18:59
springer,2012-02-08,18,4,163,167,2802,17:00 - 18:59
springer,2012-02-08,19,3,158,161,2802,19:00 - 20:59
springer,2012-02-08,20,3,122,125,2802,19:00 - 20:59
springer,2012-02-08,21,3,126,129,2802,21:00 - 22:59
springer,2012-02-08,22,3,95,98,2802,21:00 - 22:59
springer,2012-02-08,23,3,57,60,2802,23:00 - 24:59
springer,2012-02-09,0,3,23,26,3830,
springer,2012-02-09,1,2,10,12,3830,01:00 - 02:59
springer,2012-02-09,2,0,2,2,3830,01:00 - 02:59
springer,2012-02-09,3,0,4,4,3830,03:00 - 04:59
springer,2012-02-09,4,0,1,1,3830,03:00 - 04:59
springer,2012-02-09,5,0,18,18,3830,05:00 - 06:59
springer,2012-02-09,6,1,75,76,3830,05:00 - 06:59
springer,2012-02-09,7,4,263,267,3830,07:00 - 08:59
springer,2012-02-09,8,11,473,484,3830,07:00 - 08:59
springer,2012-02-09,9,9,229,238,3830,09:00 - 10:59
springer,2012-02-09,10,7,90,97,3830,09:00 - 10:59
springer,2012-02-09,11,4,95,99,3830,11:00 - 12:59
springer,2012-02-09,12,10,148,158,3830,11:00 - 12:59
springer,2012-02-09,13,10,144,154,3830,13:00 - 14:59
springer,2012-02-09,14,18,126,144,3830,13:00 - 14:59
springer,2012-02-09,15,14,120,134,3830,15:00 - 16:59
springer,2012-02-09,16,15,223,238,3830,15:00 - 16:59
springer,2012-02-09,17,12,387,399,3830,17:00 - 18:59
springer,2012-02-09,18,13,404,417,3830,17:00 - 18:59
springer,2012-02-09,19,8,287,295,3830,19:00 - 20:59
springer,2012-02-09,20,2,197,199,3830,19:00 - 20:59
springer,2012-02-09,21,8,169,177,3830,21:00 - 22:59
springer,2012-02-09,22,3,104,107,3830,21:00 - 22:59
springer,2012-02-09,23,9,75,84,3830,23:00 - 24:59
springer,2012-02-10,0,4,39,43,3831,
springer,2012-02-10,1,2,11,13,3831,01:00 - 02:59
springer,2012-02-10,2,7,9,16,3831,01:00 - 02:59
springer,2012-02-10,3,0,5,5,3831,03:00 - 04:59
springer,2012-02-10,4,0,2,2,3831,03:00 - 04:59
springer,2012-02-10,5,0,17,17,3831,05:00 - 06:59
springer,2012-02-10,6,3,61,64,3831,05:00 - 06:59
springer,2012-02-10,7,5,225,230,3831,07:00 - 08:59
springer,2012-02-10,8,1,447,448,3831,07:00 - 08:59
springer,2012-02-10,9,10,265,275,3831,09:00 - 10:59
springer,2012-02-10,10,5,119,124,3831,09:00 - 10:59
springer,2012-02-10,11,19,134,153,3831,11:00 - 12:59
springer,2012-02-10,12,8,168,176,3831,11:00 - 12:59
springer,2012-02-10,13,22,170,192,3831,13:00 - 14:59
springer,2012-02-10,14,8,138,146,3831,13:00 - 14:59
springer,2012-02-10,15,27,164,191,3831,15:00 - 16:59
springer,2012-02-10,16,28,240,268,3831,15:00 - 16:59
springer,2012-02-10,17,15,381,396,3831,17:00 - 18:59
springer,2012-02-10,18,14,345,359,3831,17:00 - 18:59
springer,2012-02-10,19,16,246,262,3831,19:00 - 20:59
springer,2012-02-10,20,7,144,151,3831,19:00 - 20:59
springer,2012-02-10,21,14,108,122,3831,21:00 - 22:59
springer,2012-02-10,22,11,102,113,3831,21:00 - 22:59
springer,2012-02-10,23,1,64,65,3831,23:00 - 24:59
springer,2012-02-11,0,3,50,53,2169,
springer,2012-02-11,1,2,43,45,2169,01:00 - 02:59
springer,2012-02-11,2,2,24,26,2169,01:00 - 02:59
springer,2012-02-11,3,0,9,9,2169,03:00 - 04:59
springer,2012-02-11,4,0,4,4,2169,03:00 - 04:59
springer,2012-02-11,5,0,2,2,2169,05:00 - 06:59
springer,2012-02-11,6,1,8,9,2169,05:00 - 06:59
springer,2012-02-11,7,0,19,19,2169,07:00 - 08:59
springer,2012-02-11,8,1,77,78,2169,07:00 - 08:59
springer,2012-02-11,9,5,85,90,2169,09:00 - 10:59
springer,2012-02-11,10,23,143,166,2169,09:00 - 10:59
springer,2012-02-11,11,26,157,183,2169,11:00 - 12:59
springer,2012-02-11,12,25,196,221,2169,11:00 - 12:59
springer,2012-02-11,13,18,217,235,2169,13:00 - 14:59
springer,2012-02-11,14,38,205,243,2169,13:00 - 14:59
springer,2012-02-11,15,12,112,124,2169,15:00 - 16:59
springer,2012-02-11,16,12,134,146,2169,15:00 - 16:59
springer,2012-02-11,17,13,131,144,2169,17:00 - 18:59
springer,2012-02-11,18,3,105,108,2169,17:00 - 18:59
springer,2012-02-11,19,2,85,87,2169,19:00 - 20:59
springer,2012-02-11,20,1,62,63,2169,19:00 - 20:59
springer,2012-02-11,21,5,43,48,2169,21:00 - 22:59
springer,2012-02-11,22,0,46,46,2169,21:00 - 22:59
springer,2012-02-11,23,0,20,20,2169,23:00 - 24:59
springer,2012-02-12,0,0,21,21,1529,
springer,2012-02-12,1,0,24,24,1529,01:00 - 02:59
springer,2012-02-12,2,1,26,27,1529,01:00 - 02:59
springer,2012-02-12,3,0,14,14,1529,03:00 - 04:59
springer,2012-02-12,4,0,1,1,1529,03:00 - 04:59
springer,2012-02-12,5,0,3,3,1529,05:00 - 06:59
springer,2012-02-12,6,0,2,2,1529,05:00 - 06:59
springer,2012-02-12,7,0,18,18,1529,07:00 - 08:59
springer,2012-02-12,8,0,26,26,1529,07:00 - 08:59
springer,2012-02-12,9,3,60,63,1529,09:00 - 10:59
springer,2012-02-12,10,8,83,91,1529,09:00 - 10:59
springer,2012-02-12,11,3,121,124,1529,11:00 - 12:59
springer,2012-02-12,12,7,133,140,1529,11:00 - 12:59
springer,2012-02-12,13,10,128,138,1529,13:00 - 14:59
springer,2012-02-12,14,9,102,111,1529,13:00 - 14:59
springer,2012-02-12,15,5,150,155,1529,15:00 - 16:59
springer,2012-02-12,16,16,148,164,1529,15:00 - 16:59
springer,2012-02-12,17,4,83,87,1529,17:00 - 18:59
springer,2012-02-12,18,4,92,96,1529,17:00 - 18:59
springer,2012-02-12,19,2,78,80,1529,19:00 - 20:59
springer,2012-02-12,20,1,56,57,1529,19:00 - 20:59
springer,2012-02-12,21,0,36,36,1529,21:00 - 22:59
springer,2012-02-12,22,0,28,28,1529,21:00 - 22:59
springer,2012-02-12,23,0,23,23,1529,23:00 - 24:59
springer,2012-02-13,0,0,9,9,3422,
springer,2012-02-13,1,0,6,6,3422,01:00 - 02:59
springer,2012-02-13,2,0,4,4,3422,01:00 - 02:59
springer,2012-02-13,3,0,1,1,3422,03:00 - 04:59
springer,2012-02-13,4,0,2,2,3422,03:00 - 04:59
springer,2012-02-13,5,0,17,17,3422,05:00 - 06:59
springer,2012-02-13,6,1,71,72,3422,05:00 - 06:59
springer,2012-02-13,7,1,194,195,3422,07:00 - 08:59
springer,2012-02-13,8,4,413,417,3422,07:00 - 08:59
springer,2012-02-13,9,7,198,205,3422,09:00 - 10:59
springer,2012-02-13,10,1,70,71,3422,09:00 - 10:59
springer,2012-02-13,11,5,85,90,3422,11:00 - 12:59
springer,2012-02-13,12,7,111,118,3422,11:00 - 12:59
springer,2012-02-13,13,11,129,140,3422,13:00 - 14:59
springer,2012-02-13,14,10,125,135,3422,13:00 - 14:59
springer,2012-02-13,15,10,145,155,3422,15:00 - 16:59
springer,2012-02-13,16,5,206,211,3422,15:00 - 16:59
springer,2012-02-13,17,8,399,407,3422,17:00 - 18:59
springer,2012-02-13,18,6,399,405,3422,17:00 - 18:59
springer,2012-02-13,19,7,256,263,3422,19:00 - 20:59
springer,2012-02-13,20,4,210,214,3422,19:00 - 20:59
springer,2012-02-13,21,2,145,147,3422,21:00 - 22:59
springer,2012-02-13,22,3,99,102,3422,21:00 - 22:59
springer,2012-02-13,23,2,34,36,3422,23:00 - 24:59
springer,2012-02-14,0,0,14,14,3922,
springer,2012-02-14,1,0,6,6,3922,01:00 - 02:59
springer,2012-02-14,2,0,3,3,3922,01:00 - 02:59
springer,2012-02-14,3,0,3,3,3922,03:00 - 04:59
springer,2012-02-14,4,0,2,2,3922,03:00 - 04:59
springer,2012-02-14,5,2,20,22,3922,05:00 - 06:59
springer,2012-02-14,6,1,89,90,3922,05:00 - 06:59
springer,2012-02-14,7,4,276,280,3922,07:00 - 08:59
springer,2012-02-14,8,3,510,513,3922,07:00 - 08:59
springer,2012-02-14,9,6,256,262,3922,09:00 - 10:59
springer,2012-02-14,10,8,90,98,3922,09:00 - 10:59
springer,2012-02-14,11,5,107,112,3922,11:00 - 12:59
springer,2012-02-14,12,10,162,172,3922,11:00 - 12:59
springer,2012-02-14,13,6,167,173,3922,13:00 - 14:59
springer,2012-02-14,14,13,111,124,3922,13:00 - 14:59
springer,2012-02-14,15,7,138,145,3922,15:00 - 16:59
springer,2012-02-14,16,15,251,266,3922,15:00 - 16:59
springer,2012-02-14,17,19,504,523,3922,17:00 - 18:59
springer,2012-02-14,18,8,398,406,3922,17:00 - 18:59
springer,2012-02-14,19,11,270,281,3922,19:00 - 20:59
springer,2012-02-14,20,6,178,184,3922,19:00 - 20:59
springer,2012-02-14,21,4,105,109,3922,21:00 - 22:59
springer,2012-02-14,22,5,72,77,3922,21:00 - 22:59
springer,2012-02-14,23,2,55,57,3922,23:00 - 24:59
springer,2012-02-15,0,0,22,22,4169,
springer,2012-02-15,1,0,5,5,4169,01:00 - 02:59
springer,2012-02-15,2,0,4,4,4169,01:00 - 02:59
springer,2012-02-15,3,0,3,3,4169,03:00 - 04:59
springer,2012-02-15,4,0,1,1,4169,03:00 - 04:59
springer,2012-02-15,5,0,25,25,4169,05:00 - 06:59
springer,2012-02-15,6,3,92,95,4169,05:00 - 06:59
springer,2012-02-15,7,3,318,321,4169,07:00 - 08:59
springer,2012-02-15,8,7,508,515,4169,07:00 - 08:59
springer,2012-02-15,9,5,226,231,4169,09:00 - 10:59
springer,2012-02-15,10,12,108,120,4169,09:00 - 10:59
springer,2012-02-15,11,13,125,138,4169,11:00 - 12:59
springer,2012-02-15,12,11,152,163,4169,11:00 - 12:59
springer,2012-02-15,13,11,159,170,4169,13:00 - 14:59
springer,2012-02-15,14,6,128,134,4169,13:00 - 14:59
springer,2012-02-15,15,7,164,171,4169,15:00 - 16:59
springer,2012-02-15,16,9,222,231,4169,15:00 - 16:59
springer,2012-02-15,17,17,470,487,4169,17:00 - 18:59
springer,2012-02-15,18,9,459,468,4169,17:00 - 18:59
springer,2012-02-15,19,9,302,311,4169,19:00 - 20:59
springer,2012-02-15,20,4,207,211,4169,19:00 - 20:59
springer,2012-02-15,21,8,170,178,4169,21:00 - 22:59
springer,2012-02-15,22,3,104,107,4169,21:00 - 22:59
springer,2012-02-15,23,4,54,58,4169,23:00 - 24:59
springer,2012-02-16,0,1,22,23,3005,
springer,2012-02-16,1,0,5,5,3005,01:00 - 02:59
springer,2012-02-16,2,1,6,7,3005,01:00 - 02:59
springer,2012-02-16,3,0,1,1,3005,03:00 - 04:59
springer,2012-02-16,4,0,3,3,3005,03:00 - 04:59
springer,2012-02-16,5,0,20,20,3005,05:00 - 06:59
springer,2012-02-16,6,4,83,87,3005,05:00 - 06:59
springer,2012-02-16,7,3,285,288,3005,07:00 - 08:59
springer,2012-02-16,8,9,489,498,3005,07:00 - 08:59
springer,2012-02-16,9,3,199,202,3005,09:00 - 10:59
springer,2012-02-16,10,2,42,44,3005,09:00 - 10:59
springer,2012-02-16,11,2,69,71,3005,11:00 - 12:59
springer,2012-02-16,12,1,44,45,3005,11:00 - 12:59
springer,2012-02-16,13,2,62,64,3005,13:00 - 14:59
springer,2012-02-16,14,1,30,31,3005,13:00 - 14:59
springer,2012-02-16,15,3,50,53,3005,15:00 - 16:59
springer,2012-02-16,16,8,110,118,3005,15:00 - 16:59
springer,2012-02-16,17,8,281,289,3005,17:00 - 18:59
springer,2012-02-16,18,8,345,353,3005,17:00 - 18:59
springer,2012-02-16,19,4,254,258,3005,19:00 - 20:59
springer,2012-02-16,20,5,211,216,3005,19:00 - 20:59
springer,2012-02-16,21,3,142,145,3005,21:00 - 22:59
springer,2012-02-16,22,3,108,111,3005,21:00 - 22:59
springer,2012-02-16,23,3,70,73,3005,23:00 - 24:59
springer,2012-02-17,0,2,32,34,4154,
springer,2012-02-17,1,2,16,18,4154,01:00 - 02:59
springer,2012-02-17,2,1,11,12,4154,01:00 - 02:59
springer,2012-02-17,3,0,1,1,4154,03:00 - 04:59
springer,2012-02-17,4,0,1,1,4154,03:00 - 04:59
springer,2012-02-17,5,0,16,16,4154,05:00 - 06:59
springer,2012-02-17,6,1,70,71,4154,05:00 - 06:59
springer,2012-02-17,7,4,222,226,4154,07:00 - 08:59
springer,2012-02-17,8,4,516,520,4154,07:00 - 08:59
springer,2012-02-17,9,8,275,283,4154,09:00 - 10:59
springer,2012-02-17,10,13,103,116,4154,09:00 - 10:59
springer,2012-02-17,11,9,133,142,4154,11:00 - 12:59
springer,2012-02-17,12,21,177,198,4154,11:00 - 12:59
springer,2012-02-17,13,34,171,205,4154,13:00 - 14:59
springer,2012-02-17,14,33,137,170,4154,13:00 - 14:59
springer,2012-02-17,15,41,180,221,4154,15:00 - 16:59
springer,2012-02-17,16,56,251,307,4154,15:00 - 16:59
springer,2012-02-17,17,36,429,465,4154,17:00 - 18:59
springer,2012-02-17,18,15,362,377,4154,17:00 - 18:59
springer,2012-02-17,19,16,266,282,4154,19:00 - 20:59
springer,2012-02-17,20,13,158,171,4154,19:00 - 20:59
springer,2012-02-17,21,15,114,129,4154,21:00 - 22:59
springer,2012-02-17,22,15,92,107,4154,21:00 - 22:59
springer,2012-02-17,23,10,72,82,4154,23:00 - 24:59
springer,2012-02-18,0,5,81,86,4318,
springer,2012-02-18,1,7,38,45,4318,01:00 - 02:59
springer,2012-02-18,2,6,39,45,4318,01:00 - 02:59
springer,2012-02-18,3,3,15,18,4318,03:00 - 04:59
springer,2012-02-18,4,3,4,7,4318,03:00 - 04:59
springer,2012-02-18,5,0,1,1,4318,05:00 - 06:59
springer,2012-02-18,6,1,8,9,4318,05:00 - 06:59
springer,2012-02-18,7,8,33,41,4318,07:00 - 08:59
springer,2012-02-18,8,10,92,102,4318,07:00 - 08:59
springer,2012-02-18,9,22,116,138,4318,09:00 - 10:59
springer,2012-02-18,10,48,157,205,4318,09:00 - 10:59
springer,2012-02-18,11,102,184,286,4318,11:00 - 12:59
springer,2012-02-18,12,128,241,369,4318,11:00 - 12:59
springer,2012-02-18,13,165,219,384,4318,13:00 - 14:59
springer,2012-02-18,14,183,244,427,4318,13:00 - 14:59
springer,2012-02-18,15,229,270,499,4318,15:00 - 16:59
springer,2012-02-18,16,186,218,404,4318,15:00 - 16:59
springer,2012-02-18,17,142,222,364,4318,17:00 - 18:59
springer,2012-02-18,18,70,176,246,4318,17:00 - 18:59
springer,2012-02-18,19,38,150,188,4318,19:00 - 20:59
springer,2012-02-18,20,25,123,148,4318,19:00 - 20:59
springer,2012-02-18,21,25,89,114,4318,21:00 - 22:59
springer,2012-02-18,22,17,101,118,4318,21:00 - 22:59
springer,2012-02-18,23,12,62,74,4318,23:00 - 24:59
springer,2012-02-19,0,9,65,74,2689,
springer,2012-02-19,1,10,62,72,2689,01:00 - 02:59
springer,2012-02-19,2,3,45,48,2689,01:00 - 02:59
springer,2012-02-19,3,3,12,15,2689,03:00 - 04:59
springer,2012-02-19,4,0,3,3,2689,03:00 - 04:59
springer,2012-02-19,5,1,1,2,2689,05:00 - 06:59
springer,2012-02-19,6,0,5,5,2689,05:00 - 06:59
springer,2012-02-19,7,2,12,14,2689,07:00 - 08:59
springer,2012-02-19,8,8,48,56,2689,07:00 - 08:59
springer,2012-02-19,9,20,73,93,2689,09:00 - 10:59
springer,2012-02-19,10,49,142,191,2689,09:00 - 10:59
springer,2012-02-19,11,82,144,226,2689,11:00 - 12:59
springer,2012-02-19,12,71,184,255,2689,11:00 - 12:59
springer,2012-02-19,13,64,197,261,2689,13:00 - 14:59
springer,2012-02-19,14,48,189,237,2689,13:00 - 14:59
springer,2012-02-19,15,85,168,253,2689,15:00 - 16:59
springer,2012-02-19,16,62,150,212,2689,15:00 - 16:59
springer,2012-02-19,17,22,135,157,2689,17:00 - 18:59
springer,2012-02-19,18,23,144,167,2689,17:00 - 18:59
springer,2012-02-19,19,18,101,119,2689,19:00 - 20:59
springer,2012-02-19,20,22,81,103,2689,19:00 - 20:59
springer,2012-02-19,21,3,33,36,2689,21:00 - 22:59
springer,2012-02-19,22,8,47,55,2689,21:00 - 22:59
springer,2012-02-19,23,5,30,35,2689,23:00 - 24:59
springer,2012-02-20,0,5,36,41,3129,
springer,2012-02-20,1,3,12,15,3129,01:00 - 02:59
springer,2012-02-20,2,1,19,20,3129,01:00 - 02:59
springer,2012-02-20,3,0,8,8,3129,03:00 - 04:59
springer,2012-02-20,5,0,6,6,3129,05:00 - 06:59
springer,2012-02-20,6,1,9,10,3129,05:00 - 06:59
springer,2012-02-20,7,2,42,44,3129,07:00 - 08:59
springer,2012-02-20,8,9,111,120,3129,07:00 - 08:59
springer,2012-02-20,9,12,98,110,3129,09:00 - 10:59
springer,2012-02-20,10,30,113,143,3129,09:00 - 10:59
springer,2012-02-20,11,45,163,208,3129,11:00 - 12:59
springer,2012-02-20,12,65,216,281,3129,11:00 - 12:59
springer,2012-02-20,13,66,246,312,3129,13:00 - 14:59
springer,2012-02-20,14,57,206,263,3129,13:00 - 14:59
springer,2012-02-20,15,54,235,289,3129,15:00 - 16:59
springer,2012-02-20,16,64,216,280,3129,15:00 - 16:59
springer,2012-02-20,17,27,226,253,3129,17:00 - 18:59
springer,2012-02-20,18,27,215,242,3129,17:00 - 18:59
springer,2012-02-20,19,8,164,172,3129,19:00 - 20:59
springer,2012-02-20,20,9,117,126,3129,19:00 - 20:59
springer,2012-02-20,21,8,90,98,3129,21:00 - 22:59
springer,2012-02-20,22,9,53,62,3129,21:00 - 22:59
springer,2012-02-20,23,0,26,26,3129,23:00 - 24:59
springer,2012-02-21,0,1,11,12,3777,
springer,2012-02-21,1,0,7,7,3777,01:00 - 02:59
springer,2012-02-21,2,0,3,3,3777,01:00 - 02:59
springer,2012-02-21,4,0,2,2,3777,03:00 - 04:59
springer,2012-02-21,5,0,15,15,3777,05:00 - 06:59
springer,2012-02-21,6,3,83,86,3777,05:00 - 06:59
springer,2012-02-21,7,6,273,279,3777,07:00 - 08:59
springer,2012-02-21,8,5,459,464,3777,07:00 - 08:59
springer,2012-02-21,9,6,211,217,3777,09:00 - 10:59
springer,2012-02-21,10,8,77,85,3777,09:00 - 10:59
springer,2012-02-21,11,5,81,86,3777,11:00 - 12:59
springer,2012-02-21,12,16,147,163,3777,11:00 - 12:59
springer,2012-02-21,13,8,123,131,3777,13:00 - 14:59
springer,2012-02-21,14,16,108,124,3777,13:00 - 14:59
springer,2012-02-21,15,23,137,160,3777,15:00 - 16:59
springer,2012-02-21,16,14,240,254,3777,15:00 - 16:59
springer,2012-02-21,17,21,411,432,3777,17:00 - 18:59
springer,2012-02-21,18,11,414,425,3777,17:00 - 18:59
springer,2012-02-21,19,5,299,304,3777,19:00 - 20:59
springer,2012-02-21,20,4,223,227,3777,19:00 - 20:59
springer,2012-02-21,21,7,147,154,3777,21:00 - 22:59
springer,2012-02-21,22,3,97,100,3777,21:00 - 22:59
springer,2012-02-21,23,1,46,47,3777,23:00 - 24:59
springer,2012-02-22,0,5,19,24,4773,
springer,2012-02-22,1,3,4,7,4773,01:00 - 02:59
springer,2012-02-22,2,1,5,6,4773,01:00 - 02:59
springer,2012-02-22,3,1,3,4,4773,03:00 - 04:59
springer,2012-02-22,4,0,2,2,4773,03:00 - 04:59
springer,2012-02-22,5,1,29,30,4773,05:00 - 06:59
springer,2012-02-22,6,5,85,90,4773,05:00 - 06:59
springer,2012-02-22,7,10,292,302,4773,07:00 - 08:59
springer,2012-02-22,8,9,567,576,4773,07:00 - 08:59
springer,2012-02-22,9,11,241,252,4773,09:00 - 10:59
springer,2012-02-22,10,17,122,139,4773,09:00 - 10:59
springer,2012-02-22,11,22,149,171,4773,11:00 - 12:59
springer,2012-02-22,12,21,186,207,4773,11:00 - 12:59
springer,2012-02-22,13,15,175,190,4773,13:00 - 14:59
springer,2012-02-22,14,35,142,177,4773,13:00 - 14:59
springer,2012-02-22,15,34,161,195,4773,15:00 - 16:59
springer,2012-02-22,16,30,268,298,4773,15:00 - 16:59
springer,2012-02-22,17,43,486,529,4773,17:00 - 18:59
springer,2012-02-22,18,42,483,525,4773,17:00 - 18:59
springer,2012-02-22,19,22,305,327,4773,19:00 - 20:59
springer,2012-02-22,20,25,249,274,4773,19:00 - 20:59
springer,2012-02-22,21,19,220,239,4773,21:00 - 22:59
springer,2012-02-22,22,18,129,147,4773,21:00 - 22:59
springer,2012-02-22,23,5,57,62,4773,23:00 - 24:59
springer,2012-02-23,0,12,30,42,5062,
springer,2012-02-23,1,3,12,15,5062,01:00 - 02:59
springer,2012-02-23,2,5,4,9,5062,01:00 - 02:59
springer,2012-02-23,3,2,4,6,5062,03:00 - 04:59
springer,2012-02-23,4,0,1,1,5062,03:00 - 04:59
springer,2012-02-23,5,2,30,32,5062,05:00 - 06:59
springer,2012-02-23,6,3,88,91,5062,05:00 - 06:59
springer,2012-02-23,7,9,317,326,5062,07:00 - 08:59
springer,2012-02-23,8,11,549,560,5062,07:00 - 08:59
springer,2012-02-23,9,14,228,242,5062,09:00 - 10:59
springer,2012-02-23,10,41,107,148,5062,09:00 - 10:59
springer,2012-02-23,11,54,128,182,5062,11:00 - 12:59
springer,2012-02-23,12,25,199,224,5062,11:00 - 12:59
springer,2012-02-23,13,30,188,218,5062,13:00 - 14:59
springer,2012-02-23,14,36,156,192,5062,13:00 - 14:59
springer,2012-02-23,15,46,171,217,5062,15:00 - 16:59
springer,2012-02-23,16,45,298,343,5062,15:00 - 16:59
springer,2012-02-23,17,49,561,610,5062,17:00 - 18:59
springer,2012-02-23,18,36,486,522,5062,17:00 - 18:59
springer,2012-02-23,19,20,349,369,5062,19:00 - 20:59
springer,2012-02-23,20,23,246,269,5062,19:00 - 20:59
springer,2012-02-23,21,17,205,222,5062,21:00 - 22:59
springer,2012-02-23,22,19,118,137,5062,21:00 - 22:59
springer,2012-02-23,23,14,71,85,5062,23:00 - 24:59
springer,2012-02-24,0,12,34,46,3487,
springer,2012-02-24,1,3,15,18,3487,01:00 - 02:59
springer,2012-02-24,2,1,4,5,3487,01:00 - 02:59
springer,2012-02-24,3,0,5,5,3487,03:00 - 04:59
springer,2012-02-24,4,0,2,2,3487,03:00 - 04:59
springer,2012-02-24,5,1,25,26,3487,05:00 - 06:59
springer,2012-02-24,6,2,80,82,3487,05:00 - 06:59
springer,2012-02-24,7,7,265,272,3487,07:00 - 08:59
springer,2012-02-24,8,17,452,469,3487,07:00 - 08:59
springer,2012-02-24,9,15,229,244,3487,09:00 - 10:59
springer,2012-02-24,10,22,119,141,3487,09:00 - 10:59
springer,2012-02-24,11,27,136,163,3487,11:00 - 12:59
springer,2012-02-24,12,27,201,228,3487,11:00 - 12:59
springer,2012-02-24,13,30,153,183,3487,13:00 - 14:59
springer,2012-02-24,14,5,26,31,3487,13:00 - 14:59
springer,2012-02-24,15,11,83,94,3487,15:00 - 16:59
springer,2012-02-24,16,12,166,178,3487,15:00 - 16:59
springer,2012-02-24,17,14,242,256,3487,17:00 - 18:59
springer,2012-02-24,18,11,289,300,3487,17:00 - 18:59
springer,2012-02-24,19,6,227,233,3487,19:00 - 20:59
springer,2012-02-24,20,8,159,167,3487,19:00 - 20:59
springer,2012-02-24,21,1,151,152,3487,21:00 - 22:59
springer,2012-02-24,22,4,102,106,3487,21:00 - 22:59
springer,2012-02-24,23,10,76,86,3487,23:00 - 24:59
springer,2012-02-25,0,5,56,61,2732,
springer,2012-02-25,1,4,42,46,2732,01:00 - 02:59
springer,2012-02-25,2,1,37,38,2732,01:00 - 02:59
springer,2012-02-25,3,0,7,7,2732,03:00 - 04:59
springer,2012-02-25,4,0,2,2,2732,03:00 - 04:59
springer,2012-02-25,5,0,3,3,2732,05:00 - 06:59
springer,2012-02-25,6,1,12,13,2732,05:00 - 06:59
springer,2012-02-25,7,3,20,23,2732,07:00 - 08:59
springer,2012-02-25,8,3,90,93,2732,07:00 - 08:59
springer,2012-02-25,9,15,107,122,2732,09:00 - 10:59
springer,2012-02-25,10,24,159,183,2732,09:00 - 10:59
springer,2012-02-25,11,23,187,210,2732,11:00 - 12:59
springer,2012-02-25,12,41,217,258,2732,11:00 - 12:59
springer,2012-02-25,13,48,178,226,2732,13:00 - 14:59
springer,2012-02-25,14,35,181,216,2732,13:00 - 14:59
springer,2012-02-25,15,21,211,232,2732,15:00 - 16:59
springer,2012-02-25,16,32,163,195,2732,15:00 - 16:59
springer,2012-02-25,17,16,143,159,2732,17:00 - 18:59
springer,2012-02-25,18,7,126,133,2732,17:00 - 18:59
springer,2012-02-25,19,12,137,149,2732,19:00 - 20:59
springer,2012-02-25,20,10,95,105,2732,19:00 - 20:59
springer,2012-02-25,21,5,80,85,2732,21:00 - 22:59
springer,2012-02-25,22,4,78,82,2732,21:00 - 22:59
springer,2012-02-25,23,7,84,91,2732,23:00 - 24:59
springer,2012-02-26,0,7,63,70,3389,
springer,2012-02-26,1,5,50,55,3389,01:00 - 02:59
springer,2012-02-26,2,5,37,42,3389,01:00 - 02:59
springer,2012-02-26,3,0,21,21,3389,03:00 - 04:59
springer,2012-02-26,4,1,5,6,3389,03:00 - 04:59
springer,2012-02-26,5,0,5,5,3389,05:00 - 06:59
springer,2012-02-26,6,0,2,2,3389,05:00 - 06:59
springer,2012-02-26,7,2,20,22,3389,07:00 - 08:59
springer,2012-02-26,8,2,57,59,3389,07:00 - 08:59
springer,2012-02-26,9,11,76,87,3389,09:00 - 10:59
springer,2012-02-26,10,27,161,188,3389,09:00 - 10:59
springer,2012-02-26,11,43,184,227,3389,11:00 - 12:59
springer,2012-02-26,12,49,256,305,3389,11:00 - 12:59
springer,2012-02-26,13,58,267,325,3389,13:00 - 14:59
springer,2012-02-26,14,68,263,331,3389,13:00 - 14:59
springer,2012-02-26,15,72,281,353,3389,15:00 - 16:59
springer,2012-02-26,16,64,275,339,3389,15:00 - 16:59
springer,2012-02-26,17,46,241,287,3389,17:00 - 18:59
springer,2012-02-26,18,17,199,216,3389,17:00 - 18:59
springer,2012-02-26,19,13,130,143,3389,19:00 - 20:59
springer,2012-02-26,20,9,79,88,3389,19:00 - 20:59
springer,2012-02-26,21,8,75,83,3389,21:00 - 22:59
springer,2012-02-26,22,3,68,71,3389,21:00 - 22:59
springer,2012-02-26,23,5,59,64,3389,23:00 - 24:59
springer,2012-02-27,0,2,27,29,4322,
springer,2012-02-27,1,0,6,6,4322,01:00 - 02:59
springer,2012-02-27,2,0,4,4,4322,01:00 - 02:59
springer,2012-02-27,3,0,2,2,4322,03:00 - 04:59
springer,2012-02-27,4,0,1,1,4322,03:00 - 04:59
springer,2012-02-27,5,0,16,16,4322,05:00 - 06:59
springer,2012-02-27,6,1,89,90,4322,05:00 - 06:59
springer,2012-02-27,7,2,278,280,4322,07:00 - 08:59
springer,2012-02-27,8,14,514,528,4322,07:00 - 08:59
springer,2012-02-27,9,11,219,230,4322,09:00 - 10:59
springer,2012-02-27,10,16,88,104,4322,09:00 - 10:59
springer,2012-02-27,11,11,92,103,4322,11:00 - 12:59
springer,2012-02-27,12,13,164,177,4322,11:00 - 12:59
springer,2012-02-27,13,23,159,182,4322,13:00 - 14:59
springer,2012-02-27,14,24,134,158,4322,13:00 - 14:59
springer,2012-02-27,15,24,150,174,4322,15:00 - 16:59
springer,2012-02-27,16,20,266,286,4322,15:00 - 16:59
springer,2012-02-27,17,26,503,529,4322,17:00 - 18:59
springer,2012-02-27,18,10,517,527,4322,17:00 - 18:59
springer,2012-02-27,19,16,318,334,4322,19:00 - 20:59
springer,2012-02-27,20,11,208,219,4322,19:00 - 20:59
springer,2012-02-27,21,14,181,195,4322,21:00 - 22:59
springer,2012-02-27,22,9,83,92,4322,21:00 - 22:59
springer,2012-02-27,23,6,50,56,4322,23:00 - 24:59
springer,2012-02-28,0,0,10,10,4363,
springer,2012-02-28,1,0,6,6,4363,01:00 - 02:59
springer,2012-02-28,2,1,2,3,4363,01:00 - 02:59
springer,2012-02-28,3,0,6,6,4363,03:00 - 04:59
springer,2012-02-28,4,0,2,2,4363,03:00 - 04:59
springer,2012-02-28,5,1,20,21,4363,05:00 - 06:59
springer,2012-02-28,6,1,100,101,4363,05:00 - 06:59
springer,2012-02-28,7,12,313,325,4363,07:00 - 08:59
springer,2012-02-28,8,16,543,559,4363,07:00 - 08:59
springer,2012-02-28,9,7,225,232,4363,09:00 - 10:59
springer,2012-02-28,10,14,118,132,4363,09:00 - 10:59
springer,2012-02-28,11,8,155,163,4363,11:00 - 12:59
springer,2012-02-28,12,19,164,183,4363,11:00 - 12:59
springer,2012-02-28,13,16,174,190,4363,13:00 - 14:59
springer,2012-02-28,14,13,121,134,4363,13:00 - 14:59
springer,2012-02-28,15,17,149,166,4363,15:00 - 16:59
springer,2012-02-28,16,17,270,287,4363,15:00 - 16:59
springer,2012-02-28,17,33,497,530,4363,17:00 - 18:59
springer,2012-02-28,18,17,432,449,4363,17:00 - 18:59
springer,2012-02-28,19,15,291,306,4363,19:00 - 20:59
springer,2012-02-28,20,2,202,204,4363,19:00 - 20:59
springer,2012-02-28,21,10,178,188,4363,21:00 - 22:59
springer,2012-02-28,22,6,95,101,4363,21:00 - 22:59
springer,2012-02-28,23,4,61,65,4363,23:00 - 24:59
springer,2012-02-29,0,2,30,32,1834,
springer,2012-02-29,1,0,6,6,1834,01:00 - 02:59
springer,2012-02-29,2,0,4,4,1834,01:00 - 02:59
springer,2012-02-29,3,0,2,2,1834,03:00 - 04:59
springer,2012-02-29,5,0,29,29,1834,05:00 - 06:59
springer,2012-02-29,6,4,100,104,1834,05:00 - 06:59
springer,2012-02-29,7,11,242,253,1834,07:00 - 08:59
springer,2012-02-29,8,2,114,116,1834,07:00 - 08:59
springer,2012-02-29,9,5,33,38,1834,09:00 - 10:59
springer,2012-02-29,10,0,10,10,1834,09:00 - 10:59
springer,2012-02-29,11,1,9,10,1834,11:00 - 12:59
springer,2012-02-29,12,1,69,70,1834,11:00 - 12:59
springer,2012-02-29,13,4,72,76,1834,13:00 - 14:59
springer,2012-02-29,14,2,54,56,1834,13:00 - 14:59
springer,2012-02-29,15,3,87,90,1834,15:00 - 16:59
springer,2012-02-29,16,5,162,167,1834,15:00 - 16:59
springer,2012-02-29,17,7,246,253,1834,17:00 - 18:59
springer,2012-02-29,18,11,181,192,1834,17:00 - 18:59
springer,2012-02-29,19,0,102,102,1834,19:00 - 20:59
springer,2012-02-29,20,2,95,97,1834,19:00 - 20:59
springer,2012-02-29,21,0,39,39,1834,21:00 - 22:59
springer,2012-02-29,22,2,53,55,1834,21:00 - 22:59
springer,2012-02-29,23,3,30,33,1834,23:00 - 24:59
springer,2012-03-01,0,1,10,11,4990,
springer,2012-03-01,1,0,12,12,4990,01:00 - 02:59
springer,2012-03-01,2,0,6,6,4990,01:00 - 02:59
springer,2012-03-01,3,0,3,3,4990,03:00 - 04:59
springer,2012-03-01,4,0,5,5,4990,03:00 - 04:59
springer,2012-03-01,5,0,18,18,4990,05:00 - 06:59
springer,2012-03-01,6,2,107,109,4990,05:00 - 06:59
springer,2012-03-01,7,8,296,304,4990,07:00 - 08:59
springer,2012-03-01,8,15,579,594,4990,07:00 - 08:59
springer,2012-03-01,9,5,281,286,4990,09:00 - 10:59
springer,2012-03-01,10,11,122,133,4990,09:00 - 10:59
springer,2012-03-01,11,19,149,168,4990,11:00 - 12:59
springer,2012-03-01,12,16,204,220,4990,11:00 - 12:59
springer,2012-03-01,13,24,187,211,4990,13:00 - 14:59
springer,2012-03-01,14,37,174,211,4990,13:00 - 14:59
springer,2012-03-01,15,31,192,223,4990,15:00 - 16:59
springer,2012-03-01,16,38,323,361,4990,15:00 - 16:59
springer,2012-03-01,17,49,551,600,4990,17:00 - 18:59
springer,2012-03-01,18,27,498,525,4990,17:00 - 18:59
springer,2012-03-01,19,11,317,328,4990,19:00 - 20:59
springer,2012-03-01,20,12,242,254,4990,19:00 - 20:59
springer,2012-03-01,21,7,190,197,4990,21:00 - 22:59
springer,2012-03-01,22,3,123,126,4990,21:00 - 22:59
springer,2012-03-01,23,9,76,85,4990,23:00 - 24:59
springer,2012-03-02,0,1,45,46,3194,
springer,2012-03-02,1,2,18,20,3194,01:00 - 02:59
springer,2012-03-02,2,2,4,6,3194,01:00 - 02:59
springer,2012-03-02,3,0,3,3,3194,03:00 - 04:59
springer,2012-03-02,4,0,2,2,3194,03:00 - 04:59
springer,2012-03-02,5,0,24,24,3194,05:00 - 06:59
springer,2012-03-02,6,4,88,92,3194,05:00 - 06:59
springer,2012-03-02,7,4,258,262,3194,07:00 - 08:59
springer,2012-03-02,8,16,533,549,3194,07:00 - 08:59
springer,2012-03-02,9,15,299,314,3194,09:00 - 10:59
springer,2012-03-02,10,14,118,132,3194,09:00 - 10:59
springer,2012-03-02,11,40,154,194,3194,11:00 - 12:59
springer,2012-03-02,12,40,194,234,3194,11:00 - 12:59
springer,2012-03-02,13,31,191,222,3194,13:00 - 14:59
springer,2012-03-02,14,29,176,205,3194,13:00 - 14:59
springer,2012-03-02,15,5,73,78,3194,15:00 - 16:59
springer,2012-03-02,16,1,49,50,3194,15:00 - 16:59
springer,2012-03-02,17,5,123,128,3194,17:00 - 18:59
springer,2012-03-02,18,6,154,160,3194,17:00 - 18:59
springer,2012-03-02,19,12,162,174,3194,19:00 - 20:59
springer,2012-03-02,20,7,93,100,3194,19:00 - 20:59
springer,2012-03-02,21,2,99,101,3194,21:00 - 22:59
springer,2012-03-02,22,6,69,75,3194,21:00 - 22:59
springer,2012-03-02,23,4,19,23,3194,23:00 - 24:59
springer,2012-03-03,0,1,21,22,4066,
springer,2012-03-03,1,0,44,44,4066,01:00 - 02:59
springer,2012-03-03,2,4,34,38,4066,01:00 - 02:59
springer,2012-03-03,3,1,20,21,4066,03:00 - 04:59
springer,2012-03-03,4,0,2,2,4066,03:00 - 04:59
springer,2012-03-03,5,1,1,2,4066,05:00 - 06:59
springer,2012-03-03,6,1,6,7,4066,05:00 - 06:59
springer,2012-03-03,7,2,14,16,4066,07:00 - 08:59
springer,2012-03-03,8,2,46,48,4066,07:00 - 08:59
springer,2012-03-03,9,7,87,94,4066,09:00 - 10:59
springer,2012-03-03,10,31,137,168,4066,09:00 - 10:59
springer,2012-03-03,11,33,181,214,4066,11:00 - 12:59
springer,2012-03-03,12,47,252,299,4066,11:00 - 12:59
springer,2012-03-03,13,87,252,339,4066,13:00 - 14:59
springer,2012-03-03,14,151,279,430,4066,13:00 - 14:59
springer,2012-03-03,15,145,254,399,4066,15:00 - 16:59
springer,2012-03-03,16,167,300,467,4066,15:00 - 16:59
springer,2012-03-03,17,106,279,385,4066,17:00 - 18:59
springer,2012-03-03,18,53,250,303,4066,17:00 - 18:59
springer,2012-03-03,19,34,191,225,4066,19:00 - 20:59
springer,2012-03-03,20,28,121,149,4066,19:00 - 20:59
springer,2012-03-03,21,24,130,154,4066,21:00 - 22:59
springer,2012-03-03,22,19,115,134,4066,21:00 - 22:59
springer,2012-03-03,23,12,94,106,4066,23:00 - 24:59
springer,2012-03-04,0,5,67,72,3423,
springer,2012-03-04,1,16,60,76,3423,01:00 - 02:59
springer,2012-03-04,2,14,66,80,3423,01:00 - 02:59
springer,2012-03-04,3,5,21,26,3423,03:00 - 04:59
springer,2012-03-04,4,3,11,14,3423,03:00 - 04:59
springer,2012-03-04,5,0,5,5,3423,05:00 - 06:59
springer,2012-03-04,6,0,5,5,3423,05:00 - 06:59
springer,2012-03-04,7,2,21,23,3423,07:00 - 08:59
springer,2012-03-04,8,12,54,66,3423,07:00 - 08:59
springer,2012-03-04,9,14,104,118,3423,09:00 - 10:59
springer,2012-03-04,10,31,161,192,3423,09:00 - 10:59
springer,2012-03-04,11,64,192,256,3423,11:00 - 12:59
springer,2012-03-04,12,71,256,327,3423,11:00 - 12:59
springer,2012-03-04,13,108,256,364,3423,13:00 - 14:59
springer,2012-03-04,14,106,226,332,3423,13:00 - 14:59
springer,2012-03-04,15,82,252,334,3423,15:00 - 16:59
springer,2012-03-04,16,68,231,299,3423,15:00 - 16:59
springer,2012-03-04,17,49,214,263,3423,17:00 - 18:59
springer,2012-03-04,18,20,164,184,3423,17:00 - 18:59
springer,2012-03-04,19,12,120,132,3423,19:00 - 20:59
springer,2012-03-04,20,8,80,88,3423,19:00 - 20:59
springer,2012-03-04,21,9,70,79,3423,21:00 - 22:59
springer,2012-03-04,22,9,53,62,3423,21:00 - 22:59
springer,2012-03-04,23,2,24,26,3423,23:00 - 24:59
springer,2012-03-05,0,2,15,17,3333,
springer,2012-03-05,1,3,3,6,3333,01:00 - 02:59
springer,2012-03-05,2,1,3,4,3333,01:00 - 02:59
springer,2012-03-05,3,0,1,1,3333,03:00 - 04:59
springer,2012-03-05,4,0,1,1,3333,03:00 - 04:59
springer,2012-03-05,5,1,17,18,3333,05:00 - 06:59
springer,2012-03-05,6,2,89,91,3333,05:00 - 06:59
springer,2012-03-05,7,7,253,260,3333,07:00 - 08:59
springer,2012-03-05,8,13,415,428,3333,07:00 - 08:59
springer,2012-03-05,9,11,186,197,3333,09:00 - 10:59
springer,2012-03-05,10,12,74,86,3333,09:00 - 10:59
springer,2012-03-05,11,17,86,103,3333,11:00 - 12:59
springer,2012-03-05,12,15,122,137,3333,11:00 - 12:59
springer,2012-03-05,13,11,109,120,3333,13:00 - 14:59
springer,2012-03-05,14,13,115,128,3333,13:00 - 14:59
springer,2012-03-05,15,20,110,130,3333,15:00 - 16:59
springer,2012-03-05,16,30,180,210,3333,15:00 - 16:59
springer,2012-03-05,17,11,376,387,3333,17:00 - 18:59
springer,2012-03-05,18,12,363,375,3333,17:00 - 18:59
springer,2012-03-05,19,6,220,226,3333,19:00 - 20:59
springer,2012-03-05,20,8,171,179,3333,19:00 - 20:59
springer,2012-03-05,21,4,116,120,3333,21:00 - 22:59
springer,2012-03-05,22,2,76,78,3333,21:00 - 22:59
springer,2012-03-05,23,2,29,31,3333,23:00 - 24:59
springer,2012-03-06,0,0,8,8,3956,
springer,2012-03-06,1,0,6,6,3956,01:00 - 02:59
springer,2012-03-06,2,0,4,4,3956,01:00 - 02:59
springer,2012-03-06,3,0,1,1,3956,03:00 - 04:59
springer,2012-03-06,4,0,3,3,3956,03:00 - 04:59
springer,2012-03-06,5,0,25,25,3956,05:00 - 06:59
springer,2012-03-06,6,3,99,102,3956,05:00 - 06:59
springer,2012-03-06,7,5,270,275,3956,07:00 - 08:59
springer,2012-03-06,8,14,487,501,3956,07:00 - 08:59
springer,2012-03-06,9,11,222,233,3956,09:00 - 10:59
springer,2012-03-06,10,16,113,129,3956,09:00 - 10:59
springer,2012-03-06,11,20,110,130,3956,11:00 - 12:59
springer,2012-03-06,12,9,129,138,3956,11:00 - 12:59
springer,2012-03-06,13,16,148,164,3956,13:00 - 14:59
springer,2012-03-06,14,20,116,136,3956,13:00 - 14:59
springer,2012-03-06,15,24,142,166,3956,15:00 - 16:59
springer,2012-03-06,16,22,228,250,3956,15:00 - 16:59
springer,2012-03-06,17,21,425,446,3956,17:00 - 18:59
springer,2012-03-06,18,15,442,457,3956,17:00 - 18:59
springer,2012-03-06,19,9,278,287,3956,19:00 - 20:59
springer,2012-03-06,20,3,184,187,3956,19:00 - 20:59
springer,2012-03-06,21,5,143,148,3956,21:00 - 22:59
springer,2012-03-06,22,5,101,106,3956,21:00 - 22:59
springer,2012-03-06,23,3,51,54,3956,23:00 - 24:59
springer,2012-03-07,0,3,12,15,4916,
springer,2012-03-07,1,1,4,5,4916,01:00 - 02:59
springer,2012-03-07,2,0,4,4,4916,01:00 - 02:59
springer,2012-03-07,3,1,2,3,4916,03:00 - 04:59
springer,2012-03-07,4,0,3,3,4916,03:00 - 04:59
springer,2012-03-07,5,0,18,18,4916,05:00 - 06:59
springer,2012-03-07,6,4,104,108,4916,05:00 - 06:59
springer,2012-03-07,7,12,332,344,4916,07:00 - 08:59
springer,2012-03-07,8,12,554,566,4916,07:00 - 08:59
springer,2012-03-07,9,12,252,264,4916,09:00 - 10:59
springer,2012-03-07,10,20,127,147,4916,09:00 - 10:59
springer,2012-03-07,11,33,128,161,4916,11:00 - 12:59
springer,2012-03-07,12,40,175,215,4916,11:00 - 12:59
springer,2012-03-07,13,26,179,205,4916,13:00 - 14:59
springer,2012-03-07,14,38,137,175,4916,13:00 - 14:59
springer,2012-03-07,15,44,165,209,4916,15:00 - 16:59
springer,2012-03-07,16,34,254,288,4916,15:00 - 16:59
springer,2012-03-07,17,58,554,612,4916,17:00 - 18:59
springer,2012-03-07,18,35,509,544,4916,17:00 - 18:59
springer,2012-03-07,19,16,345,361,4916,19:00 - 20:59
springer,2012-03-07,20,18,242,260,4916,19:00 - 20:59
springer,2012-03-07,21,11,177,188,4916,21:00 - 22:59
springer,2012-03-07,22,10,149,159,4916,21:00 - 22:59
springer,2012-03-07,23,4,58,62,4916,23:00 - 24:59
springer,2012-03-08,0,11,35,46,5382,
springer,2012-03-08,1,4,17,21,5382,01:00 - 02:59
springer,2012-03-08,2,6,5,11,5382,01:00 - 02:59
springer,2012-03-08,3,0,3,3,5382,03:00 - 04:59
springer,2012-03-08,4,0,2,2,5382,03:00 - 04:59
springer,2012-03-08,5,1,28,29,5382,05:00 - 06:59
springer,2012-03-08,6,4,105,109,5382,05:00 - 06:59
springer,2012-03-08,7,8,326,334,5382,07:00 - 08:59
springer,2012-03-08,8,12,573,585,5382,07:00 - 08:59
springer,2012-03-08,9,19,282,301,5382,09:00 - 10:59
springer,2012-03-08,10,19,119,138,5382,09:00 - 10:59
springer,2012-03-08,11,48,156,204,5382,11:00 - 12:59
springer,2012-03-08,12,27,224,251,5382,11:00 - 12:59
springer,2012-03-08,13,35,198,233,5382,13:00 - 14:59
springer,2012-03-08,14,48,155,203,5382,13:00 - 14:59
springer,2012-03-08,15,24,161,185,5382,15:00 - 16:59
springer,2012-03-08,16,37,305,342,5382,15:00 - 16:59
springer,2012-03-08,17,52,545,597,5382,17:00 - 18:59
springer,2012-03-08,18,45,545,590,5382,17:00 - 18:59
springer,2012-03-08,19,21,395,416,5382,19:00 - 20:59
springer,2012-03-08,20,20,282,302,5382,19:00 - 20:59
springer,2012-03-08,21,27,206,233,5382,21:00 - 22:59
springer,2012-03-08,22,12,141,153,5382,21:00 - 22:59
springer,2012-03-08,23,6,88,94,5382,23:00 - 24:59
springer,2012-03-09,0,3,51,54,4569,
springer,2012-03-09,1,4,22,26,4569,01:00 - 02:59
springer,2012-03-09,2,2,9,11,4569,01:00 - 02:59
springer,2012-03-09,3,0,7,7,4569,03:00 - 04:59
springer,2012-03-09,4,0,1,1,4569,03:00 - 04:59
springer,2012-03-09,5,2,27,29,4569,05:00 - 06:59
springer,2012-03-09,6,2,83,85,4569,05:00 - 06:59
springer,2012-03-09,7,6,262,268,4569,07:00 - 08:59
springer,2012-03-09,8,17,484,501,4569,07:00 - 08:59
springer,2012-03-09,9,17,267,284,4569,09:00 - 10:59
springer,2012-03-09,10,14,145,159,4569,09:00 - 10:59
springer,2012-03-09,11,17,170,187,4569,11:00 - 12:59
springer,2012-03-09,12,27,174,201,4569,11:00 - 12:59
springer,2012-03-09,13,49,175,224,4569,13:00 - 14:59
springer,2012-03-09,14,49,129,178,4569,13:00 - 14:59
springer,2012-03-09,15,50,188,238,4569,15:00 - 16:59
springer,2012-03-09,16,51,292,343,4569,15:00 - 16:59
springer,2012-03-09,17,68,498,566,4569,17:00 - 18:59
springer,2012-03-09,18,30,440,470,4569,17:00 - 18:59
springer,2012-03-09,19,12,232,244,4569,19:00 - 20:59
springer,2012-03-09,20,3,156,159,4569,19:00 - 20:59
springer,2012-03-09,21,8,133,141,4569,21:00 - 22:59
springer,2012-03-09,22,7,100,107,4569,21:00 - 22:59
springer,2012-03-09,23,9,77,86,4569,23:00 - 24:59
springer,2012-03-10,0,9,68,77,4118,
springer,2012-03-10,1,1,50,51,4118,01:00 - 02:59
springer,2012-03-10,2,12,30,42,4118,01:00 - 02:59
springer,2012-03-10,3,0,16,16,4118,03:00 - 04:59
springer,2012-03-10,4,1,3,4,4118,03:00 - 04:59
springer,2012-03-10,5,3,7,10,4118,05:00 - 06:59
springer,2012-03-10,6,1,11,12,4118,05:00 - 06:59
springer,2012-03-10,7,4,36,40,4118,07:00 - 08:59
springer,2012-03-10,8,15,96,111,4118,07:00 - 08:59
springer,2012-03-10,9,21,127,148,4118,09:00 - 10:59
springer,2012-03-10,10,47,176,223,4118,09:00 - 10:59
springer,2012-03-10,11,56,218,274,4118,11:00 - 12:59
springer,2012-03-10,12,88,241,329,4118,11:00 - 12:59
springer,2012-03-10,13,89,268,357,4118,13:00 - 14:59
springer,2012-03-10,14,117,262,379,4118,13:00 - 14:59
springer,2012-03-10,15,132,274,406,4118,15:00 - 16:59
springer,2012-03-10,16,115,275,390,4118,15:00 - 16:59
springer,2012-03-10,17,104,250,354,4118,17:00 - 18:59
springer,2012-03-10,18,67,230,297,4118,17:00 - 18:59
springer,2012-03-10,19,25,159,184,4118,19:00 - 20:59
springer,2012-03-10,20,20,101,121,4118,19:00 - 20:59
springer,2012-03-10,21,16,94,110,4118,21:00 - 22:59
springer,2012-03-10,22,19,81,100,4118,21:00 - 22:59
springer,2012-03-10,23,6,77,83,4118,23:00 - 24:59
springer,2012-03-11,0,7,62,69,4911,
springer,2012-03-11,1,4,57,61,4911,01:00 - 02:59
springer,2012-03-11,3,15,51,66,4911,03:00 - 04:59
springer,2012-03-11,4,7,15,22,4911,03:00 - 04:59
springer,2012-03-11,5,2,5,7,4911,05:00 - 06:59
springer,2012-03-11,6,2,8,10,4911,05:00 - 06:59
springer,2012-03-11,7,2,15,17,4911,07:00 - 08:59
springer,2012-03-11,8,4,68,72,4911,07:00 - 08:59
springer,2012-03-11,9,20,70,90,4911,09:00 - 10:59
springer,2012-03-11,10,71,147,218,4911,09:00 - 10:59
springer,2012-03-11,11,90,209,299,4911,11:00 - 12:59
springer,2012-03-11,12,146,264,410,4911,11:00 - 12:59
springer,2012-03-11,13,176,288,464,4911,13:00 - 14:59
springer,2012-03-11,14,212,289,501,4911,13:00 - 14:59
springer,2012-03-11,15,201,286,487,4911,15:00 - 16:59
springer,2012-03-11,16,208,301,509,4911,15:00 - 16:59
springer,2012-03-11,17,199,299,498,4911,17:00 - 18:59
springer,2012-03-11,18,133,256,389,4911,17:00 - 18:59
springer,2012-03-11,19,55,203,258,4911,19:00 - 20:59
springer,2012-03-11,20,42,129,171,4911,19:00 - 20:59
springer,2012-03-11,21,37,110,147,4911,21:00 - 22:59
springer,2012-03-11,22,13,81,94,4911,21:00 - 22:59
springer,2012-03-11,23,12,40,52,4911,23:00 - 24:59
springer,2012-03-12,0,4,20,24,5298,
springer,2012-03-12,1,1,9,10,5298,01:00 - 02:59
springer,2012-03-12,2,4,5,9,5298,01:00 - 02:59
springer,2012-03-12,3,0,2,2,5298,03:00 - 04:59
springer,2012-03-12,4,0,3,3,5298,03:00 - 04:59
springer,2012-03-12,5,1,15,16,5298,05:00 - 06:59
springer,2012-03-12,6,2,86,88,5298,05:00 - 06:59
springer,2012-03-12,7,9,259,268,5298,07:00 - 08:59
springer,2012-03-12,8,17,547,564,5298,07:00 - 08:59
springer,2012-03-12,9,21,260,281,5298,09:00 - 10:59
springer,2012-03-12,10,39,98,137,5298,09:00 - 10:59
springer,2012-03-12,11,39,111,150,5298,11:00 - 12:59
springer,2012-03-12,12,59,162,221,5298,11:00 - 12:59
springer,2012-03-12,13,74,176,250,5298,13:00 - 14:59
springer,2012-03-12,14,76,145,221,5298,13:00 - 14:59
springer,2012-03-12,15,74,159,233,5298,15:00 - 16:59
springer,2012-03-12,16,77,255,332,5298,15:00 - 16:59
springer,2012-03-12,17,87,557,644,5298,17:00 - 18:59
springer,2012-03-12,18,89,623,712,5298,17:00 - 18:59
springer,2012-03-12,19,67,379,446,5298,19:00 - 20:59
springer,2012-03-12,20,49,237,286,5298,19:00 - 20:59
springer,2012-03-12,21,22,183,205,5298,21:00 - 22:59
springer,2012-03-12,22,17,116,133,5298,21:00 - 22:59
springer,2012-03-12,23,10,53,63,5298,23:00 - 24:59
springer,2012-03-13,0,5,21,26,5847,
springer,2012-03-13,1,2,14,16,5847,01:00 - 02:59
springer,2012-03-13,2,0,1,1,5847,01:00 - 02:59
springer,2012-03-13,3,0,2,2,5847,03:00 - 04:59
springer,2012-03-13,4,0,1,1,5847,03:00 - 04:59
springer,2012-03-13,5,0,24,24,5847,05:00 - 06:59
springer,2012-03-13,6,5,108,113,5847,05:00 - 06:59
springer,2012-03-13,7,16,292,308,5847,07:00 - 08:59
springer,2012-03-13,8,22,571,593,5847,07:00 - 08:59
springer,2012-03-13,9,18,324,342,5847,09:00 - 10:59
springer,2012-03-13,10,28,115,143,5847,09:00 - 10:59
springer,2012-03-13,11,64,155,219,5847,11:00 - 12:59
springer,2012-03-13,12,47,197,244,5847,11:00 - 12:59
springer,2012-03-13,13,53,180,233,5847,13:00 - 14:59
springer,2012-03-13,14,52,160,212,5847,13:00 - 14:59
springer,2012-03-13,15,68,196,264,5847,15:00 - 16:59
springer,2012-03-13,16,53,312,365,5847,15:00 - 16:59
springer,2012-03-13,17,62,614,676,5847,17:00 - 18:59
springer,2012-03-13,18,96,638,734,5847,17:00 - 18:59
springer,2012-03-13,19,50,429,479,5847,19:00 - 20:59
springer,2012-03-13,20,45,306,351,5847,19:00 - 20:59
springer,2012-03-13,21,44,200,244,5847,21:00 - 22:59
springer,2012-03-13,22,24,146,170,5847,21:00 - 22:59
springer,2012-03-13,23,8,79,87,5847,23:00 - 24:59
springer,2012-03-14,0,5,34,39,6312,
springer,2012-03-14,1,2,25,27,6312,01:00 - 02:59
springer,2012-03-14,2,0,2,2,6312,01:00 - 02:59
springer,2012-03-14,3,1,3,4,6312,03:00 - 04:59
springer,2012-03-14,4,1,4,5,6312,03:00 - 04:59
springer,2012-03-14,5,2,25,27,6312,05:00 - 06:59
springer,2012-03-14,6,1,120,121,6312,05:00 - 06:59
springer,2012-03-14,7,20,348,368,6312,07:00 - 08:59
springer,2012-03-14,8,34,628,662,6312,07:00 - 08:59
springer,2012-03-14,9,26,325,351,6312,09:00 - 10:59
springer,2012-03-14,10,38,150,188,6312,09:00 - 10:59
springer,2012-03-14,11,65,155,220,6312,11:00 - 12:59
springer,2012-03-14,12,55,212,267,6312,11:00 - 12:59
springer,2012-03-14,13,57,197,254,6312,13:00 - 14:59
springer,2012-03-14,14,61,163,224,6312,13:00 - 14:59
springer,2012-03-14,15,86,197,283,6312,15:00 - 16:59
springer,2012-03-14,16,78,278,356,6312,15:00 - 16:59
springer,2012-03-14,17,140,642,782,6312,17:00 - 18:59
springer,2012-03-14,18,102,647,749,6312,17:00 - 18:59
springer,2012-03-14,19,70,402,472,6312,19:00 - 20:59
springer,2012-03-14,20,44,286,330,6312,19:00 - 20:59
springer,2012-03-14,21,47,241,288,6312,21:00 - 22:59
springer,2012-03-14,22,43,159,202,6312,21:00 - 22:59
springer,2012-03-14,23,19,72,91,6312,23:00 - 24:59
springer,2012-03-15,0,14,46,60,6192,
springer,2012-03-15,1,15,8,23,6192,01:00 - 02:59
springer,2012-03-15,2,14,5,19,6192,01:00 - 02:59
springer,2012-03-15,3,0,7,7,6192,03:00 - 04:59
springer,2012-03-15,4,11,3,14,6192,03:00 - 04:59
springer,2012-03-15,5,2,24,26,6192,05:00 - 06:59
springer,2012-03-15,6,4,113,117,6192,05:00 - 06:59
springer,2012-03-15,7,14,367,381,6192,07:00 - 08:59
springer,2012-03-15,8,21,602,623,6192,07:00 - 08:59
springer,2012-03-15,9,30,285,315,6192,09:00 - 10:59
springer,2012-03-15,10,34,130,164,6192,09:00 - 10:59
springer,2012-03-15,11,60,151,211,6192,11:00 - 12:59
springer,2012-03-15,12,59,206,265,6192,11:00 - 12:59
springer,2012-03-15,13,62,211,273,6192,13:00 - 14:59
springer,2012-03-15,14,81,177,258,6192,13:00 - 14:59
springer,2012-03-15,15,100,187,287,6192,15:00 - 16:59
springer,2012-03-15,16,95,331,426,6192,15:00 - 16:59
springer,2012-03-15,17,79,634,713,6192,17:00 - 18:59
springer,2012-03-15,18,98,648,746,6192,17:00 - 18:59
springer,2012-03-15,19,72,353,425,6192,19:00 - 20:59
springer,2012-03-15,20,60,270,330,6192,19:00 - 20:59
springer,2012-03-15,21,36,207,243,6192,21:00 - 22:59
springer,2012-03-15,22,32,137,169,6192,21:00 - 22:59
springer,2012-03-15,23,12,85,97,6192,23:00 - 24:59
springer,2012-03-16,0,8,49,57,4378,
springer,2012-03-16,1,4,22,26,4378,01:00 - 02:59
springer,2012-03-16,2,0,4,4,4378,01:00 - 02:59
springer,2012-03-16,3,0,3,3,4378,03:00 - 04:59
springer,2012-03-16,4,0,3,3,4378,03:00 - 04:59
springer,2012-03-16,5,2,30,32,4378,05:00 - 06:59
springer,2012-03-16,6,3,96,99,4378,05:00 - 06:59
springer,2012-03-16,7,13,265,278,4378,07:00 - 08:59
springer,2012-03-16,8,28,534,562,4378,07:00 - 08:59
springer,2012-03-16,9,35,277,312,4378,09:00 - 10:59
springer,2012-03-16,10,44,136,180,4378,09:00 - 10:59
springer,2012-03-16,11,40,167,207,4378,11:00 - 12:59
springer,2012-03-16,12,72,222,294,4378,11:00 - 12:59
springer,2012-03-16,13,52,208,260,4378,13:00 - 14:59
springer,2012-03-16,14,56,146,202,4378,13:00 - 14:59
springer,2012-03-16,15,19,88,107,4378,15:00 - 16:59
springer,2012-03-16,16,18,111,129,4378,15:00 - 16:59
springer,2012-03-16,17,23,235,258,4378,17:00 - 18:59
springer,2012-03-16,18,31,377,408,4378,17:00 - 18:59
springer,2012-03-16,19,23,273,296,4378,19:00 - 20:59
springer,2012-03-16,20,31,204,235,4378,19:00 - 20:59
springer,2012-03-16,21,8,144,152,4378,21:00 - 22:59
springer,2012-03-16,22,16,132,148,4378,21:00 - 22:59
springer,2012-03-16,23,22,104,126,4378,23:00 - 24:59
springer,2012-03-17,0,13,87,100,7836,
springer,2012-03-17,1,12,57,69,7836,01:00 - 02:59
springer,2012-03-17,2,10,32,42,7836,01:00 - 02:59
springer,2012-03-17,3,2,24,26,7836,03:00 - 04:59
springer,2012-03-17,4,0,2,2,7836,03:00 - 04:59
springer,2012-03-17,5,5,3,8,7836,05:00 - 06:59
springer,2012-03-17,6,1,29,30,7836,05:00 - 06:59
springer,2012-03-17,7,29,57,86,7836,07:00 - 08:59
springer,2012-03-17,8,63,155,218,7836,07:00 - 08:59
springer,2012-03-17,9,104,217,321,7836,09:00 - 10:59
springer,2012-03-17,10,140,303,443,7836,09:00 - 10:59
springer,2012-03-17,11,226,359,585,7836,11:00 - 12:59
springer,2012-03-17,12,286,365,651,7836,11:00 - 12:59
springer,2012-03-17,13,286,400,686,7836,13:00 - 14:59
springer,2012-03-17,14,352,338,690,7836,13:00 - 14:59
springer,2012-03-17,15,357,322,679,7836,15:00 - 16:59
springer,2012-03-17,16,367,318,685,7836,15:00 - 16:59
springer,2012-03-17,17,291,357,648,7836,17:00 - 18:59
springer,2012-03-17,18,221,339,560,7836,17:00 - 18:59
springer,2012-03-17,19,155,262,417,7836,19:00 - 20:59
springer,2012-03-17,20,89,182,271,7836,19:00 - 20:59
springer,2012-03-17,21,54,169,223,7836,21:00 - 22:59
springer,2012-03-17,22,58,153,211,7836,21:00 - 22:59
springer,2012-03-17,23,34,151,185,7836,23:00 - 24:59
springer,2012-03-18,0,27,80,107,5892,
springer,2012-03-18,1,25,88,113,5892,01:00 - 02:59
springer,2012-03-18,2,15,41,56,5892,01:00 - 02:59
springer,2012-03-18,3,3,15,18,5892,03:00 - 04:59
springer,2012-03-18,4,6,8,14,5892,03:00 - 04:59
springer,2012-03-18,5,0,6,6,5892,05:00 - 06:59
springer,2012-03-18,6,2,9,11,5892,05:00 - 06:59
springer,2012-03-18,7,17,25,42,5892,07:00 - 08:59
springer,2012-03-18,8,25,71,96,5892,07:00 - 08:59
springer,2012-03-18,9,65,113,178,5892,09:00 - 10:59
springer,2012-03-18,10,139,212,351,5892,09:00 - 10:59
springer,2012-03-18,11,129,239,368,5892,11:00 - 12:59
springer,2012-03-18,12,222,281,503,5892,11:00 - 12:59
springer,2012-03-18,13,198,346,544,5892,13:00 - 14:59
springer,2012-03-18,14,218,303,521,5892,13:00 - 14:59
springer,2012-03-18,15,240,314,554,5892,15:00 - 16:59
springer,2012-03-18,16,229,312,541,5892,15:00 - 16:59
springer,2012-03-18,17,233,308,541,5892,17:00 - 18:59
springer,2012-03-18,18,165,294,459,5892,17:00 - 18:59
springer,2012-03-18,19,118,234,352,5892,19:00 - 20:59
springer,2012-03-18,20,59,139,198,5892,19:00 - 20:59
springer,2012-03-18,21,44,129,173,5892,21:00 - 22:59
springer,2012-03-18,22,21,79,100,5892,21:00 - 22:59
springer,2012-03-18,23,7,39,46,5892,23:00 - 24:59
springer,2012-03-19,0,4,19,23,6153,
springer,2012-03-19,1,0,15,15,6153,01:00 - 02:59
springer,2012-03-19,2,1,7,8,6153,01:00 - 02:59
springer,2012-03-19,3,0,2,2,6153,03:00 - 04:59
springer,2012-03-19,4,0,3,3,6153,03:00 - 04:59
springer,2012-03-19,5,0,31,31,6153,05:00 - 06:59
springer,2012-03-19,6,2,118,120,6153,05:00 - 06:59
springer,2012-03-19,7,25,329,354,6153,07:00 - 08:59
springer,2012-03-19,8,16,563,579,6153,07:00 - 08:59
springer,2012-03-19,9,55,276,331,6153,09:00 - 10:59
springer,2012-03-19,10,56,128,184,6153,09:00 - 10:59
springer,2012-03-19,11,56,145,201,6153,11:00 - 12:59
springer,2012-03-19,12,71,211,282,6153,11:00 - 12:59
springer,2012-03-19,13,69,194,263,6153,13:00 - 14:59
springer,2012-03-19,14,60,200,260,6153,13:00 - 14:59
springer,2012-03-19,15,97,189,286,6153,15:00 - 16:59
springer,2012-03-19,16,65,320,385,6153,15:00 - 16:59
springer,2012-03-19,17,106,615,721,6153,17:00 - 18:59
springer,2012-03-19,18,120,681,801,6153,17:00 - 18:59
springer,2012-03-19,19,86,463,549,6153,19:00 - 20:59
springer,2012-03-19,20,34,296,330,6153,19:00 - 20:59
springer,2012-03-19,21,33,190,223,6153,21:00 - 22:59
springer,2012-03-19,22,17,131,148,6153,21:00 - 22:59
springer,2012-03-19,23,9,45,54,6153,23:00 - 24:59
springer,2012-03-20,0,5,24,29,6093,
springer,2012-03-20,1,6,9,15,6093,01:00 - 02:59
springer,2012-03-20,2,2,8,10,6093,01:00 - 02:59
springer,2012-03-20,3,0,3,3,6093,03:00 - 04:59
springer,2012-03-20,4,0,6,6,6093,03:00 - 04:59
springer,2012-03-20,5,0,20,20,6093,05:00 - 06:59
springer,2012-03-20,6,6,94,100,6093,05:00 - 06:59
springer,2012-03-20,7,3,167,170,6093,07:00 - 08:59
springer,2012-03-20,8,28,488,516,6093,07:00 - 08:59
springer,2012-03-20,9,41,284,325,6093,09:00 - 10:59
springer,2012-03-20,10,44,119,163,6093,09:00 - 10:59
springer,2012-03-20,11,74,156,230,6093,11:00 - 12:59
springer,2012-03-20,12,56,205,261,6093,11:00 - 12:59
springer,2012-03-20,13,77,207,284,6093,13:00 - 14:59
springer,2012-03-20,14,66,182,248,6093,13:00 - 14:59
springer,2012-03-20,15,67,177,244,6093,15:00 - 16:59
springer,2012-03-20,16,99,332,431,6093,15:00 - 16:59
springer,2012-03-20,17,108,642,750,6093,17:00 - 18:59
springer,2012-03-20,18,136,665,801,6093,17:00 - 18:59
springer,2012-03-20,19,75,480,555,6093,19:00 - 20:59
springer,2012-03-20,20,78,299,377,6093,19:00 - 20:59
springer,2012-03-20,21,38,239,277,6093,21:00 - 22:59
springer,2012-03-20,22,32,156,188,6093,21:00 - 22:59
springer,2012-03-20,23,10,80,90,6093,23:00 - 24:59
summer,2012-03-21,0,4,29,33,6230,
summer,2012-03-21,1,4,22,26,6230,01:00 - 02:59
summer,2012-03-21,2,2,8,10,6230,01:00 - 02:59
summer,2012-03-21,3,1,7,8,6230,03:00 - 04:59
summer,2012-03-21,4,0,4,4,6230,03:00 - 04:59
summer,2012-03-21,5,4,35,39,6230,05:00 - 06:59
summer,2012-03-21,6,10,139,149,6230,05:00 - 06:59
summer,2012-03-21,7,34,338,372,6230,07:00 - 08:59
summer,2012-03-21,8,33,502,535,6230,07:00 - 08:59
summer,2012-03-21,9,38,255,293,6230,09:00 - 10:59
summer,2012-03-21,10,30,124,154,6230,09:00 - 10:59
summer,2012-03-21,11,38,154,192,6230,11:00 - 12:59
summer,2012-03-21,12,58,171,229,6230,11:00 - 12:59
summer,2012-03-21,13,81,222,303,6230,13:00 - 14:59
summer,2012-03-21,14,74,151,225,6230,13:00 - 14:59
summer,2012-03-21,15,68,175,243,6230,15:00 - 16:59
summer,2012-03-21,16,91,287,378,6230,15:00 - 16:59
summer,2012-03-21,17,113,616,729,6230,17:00 - 18:59
summer,2012-03-21,18,152,627,779,6230,17:00 - 18:59
summer,2012-03-21,19,86,496,582,6230,19:00 - 20:59
summer,2012-03-21,20,76,298,374,6230,19:00 - 20:59
summer,2012-03-21,21,47,204,251,6230,21:00 - 22:59
summer,2012-03-21,22,41,156,197,6230,21:00 - 22:59
summer,2012-03-21,23,37,88,125,6230,23:00 - 24:59
summer,2012-03-22,0,9,32,41,6871,
summer,2012-03-22,1,14,16,30,6871,01:00 - 02:59
summer,2012-03-22,2,1,5,6,6871,01:00 - 02:59
summer,2012-03-22,3,0,7,7,6871,03:00 - 04:59
summer,2012-03-22,4,0,6,6,6871,03:00 - 04:59
summer,2012-03-22,5,2,32,34,6871,05:00 - 06:59
summer,2012-03-22,6,10,126,136,6871,05:00 - 06:59
summer,2012-03-22,7,29,332,361,6871,07:00 - 08:59
summer,2012-03-22,8,51,598,649,6871,07:00 - 08:59
summer,2012-03-22,9,41,277,318,6871,09:00 - 10:59
summer,2012-03-22,10,32,110,142,6871,09:00 - 10:59
summer,2012-03-22,11,53,166,219,6871,11:00 - 12:59
summer,2012-03-22,12,48,224,272,6871,11:00 - 12:59
summer,2012-03-22,13,83,215,298,6871,13:00 - 14:59
summer,2012-03-22,14,96,161,257,6871,13:00 - 14:59
summer,2012-03-22,15,102,202,304,6871,15:00 - 16:59
summer,2012-03-22,16,125,300,425,6871,15:00 - 16:59
summer,2012-03-22,17,154,656,810,6871,17:00 - 18:59
summer,2012-03-22,18,147,654,801,6871,17:00 - 18:59
summer,2012-03-22,19,117,469,586,6871,19:00 - 20:59
summer,2012-03-22,20,64,360,424,6871,19:00 - 20:59
summer,2012-03-22,21,66,308,374,6871,21:00 - 22:59
summer,2012-03-22,22,56,164,220,6871,21:00 - 22:59
summer,2012-03-22,23,34,117,151,6871,23:00 - 24:59
summer,2012-03-23,0,30,65,95,8362,
summer,2012-03-23,1,18,32,50,8362,01:00 - 02:59
summer,2012-03-23,2,12,20,32,8362,01:00 - 02:59
summer,2012-03-23,3,4,6,10,8362,03:00 - 04:59
summer,2012-03-23,4,0,3,3,8362,03:00 - 04:59
summer,2012-03-23,5,5,29,34,8362,05:00 - 06:59
summer,2012-03-23,6,6,110,116,8362,05:00 - 06:59
summer,2012-03-23,7,28,318,346,8362,07:00 - 08:59
summer,2012-03-23,8,47,615,662,8362,07:00 - 08:59
summer,2012-03-23,9,75,305,380,8362,09:00 - 10:59
summer,2012-03-23,10,125,150,275,8362,09:00 - 10:59
summer,2012-03-23,11,131,187,318,8362,11:00 - 12:59
summer,2012-03-23,12,199,272,471,8362,11:00 - 12:59
summer,2012-03-23,13,172,256,428,8362,13:00 - 14:59
summer,2012-03-23,14,208,224,432,8362,13:00 - 14:59
summer,2012-03-23,15,191,281,472,8362,15:00 - 16:59
summer,2012-03-23,16,219,370,589,8362,15:00 - 16:59
summer,2012-03-23,17,264,693,957,8362,17:00 - 18:59
summer,2012-03-23,18,237,593,830,8362,17:00 - 18:59
summer,2012-03-23,19,213,473,686,8362,19:00 - 20:59
summer,2012-03-23,20,117,328,445,8362,19:00 - 20:59
summer,2012-03-23,21,64,220,284,8362,21:00 - 22:59
summer,2012-03-23,22,53,218,271,8362,21:00 - 22:59
summer,2012-03-23,23,51,125,176,8362,23:00 - 24:59
summer,2012-03-24,0,45,111,156,3372,
summer,2012-03-24,1,20,108,128,3372,01:00 - 02:59
summer,2012-03-24,2,14,55,69,3372,01:00 - 02:59
summer,2012-03-24,3,10,22,32,3372,03:00 - 04:59
summer,2012-03-24,4,1,6,7,3372,03:00 - 04:59
summer,2012-03-24,5,0,4,4,3372,05:00 - 06:59
summer,2012-03-24,6,4,24,28,3372,05:00 - 06:59
summer,2012-03-24,7,25,45,70,3372,07:00 - 08:59
summer,2012-03-24,8,41,113,154,3372,07:00 - 08:59
summer,2012-03-24,9,96,153,249,3372,09:00 - 10:59
summer,2012-03-24,10,148,197,345,3372,09:00 - 10:59
summer,2012-03-24,11,98,175,273,3372,11:00 - 12:59
summer,2012-03-24,12,61,122,183,3372,11:00 - 12:59
summer,2012-03-24,13,62,134,196,3372,13:00 - 14:59
summer,2012-03-24,14,63,160,223,3372,13:00 - 14:59
summer,2012-03-24,15,118,172,290,3372,15:00 - 16:59
summer,2012-03-24,16,49,128,177,3372,15:00 - 16:59
summer,2012-03-24,17,47,68,115,3372,17:00 - 18:59
summer,2012-03-24,18,27,110,137,3372,17:00 - 18:59
summer,2012-03-24,19,28,105,133,3372,19:00 - 20:59
summer,2012-03-24,20,31,80,111,3372,19:00 - 20:59
summer,2012-03-24,21,16,88,104,3372,21:00 - 22:59
summer,2012-03-24,22,12,71,83,3372,21:00 - 22:59
summer,2012-03-24,23,17,88,105,3372,23:00 - 24:59
summer,2012-03-25,0,18,62,80,4996,
summer,2012-03-25,1,24,65,89,4996,01:00 - 02:59
summer,2012-03-25,2,6,29,35,4996,01:00 - 02:59
summer,2012-03-25,3,8,10,18,4996,03:00 - 04:59
summer,2012-03-25,4,1,7,8,4996,03:00 - 04:59
summer,2012-03-25,5,0,6,6,4996,05:00 - 06:59
summer,2012-03-25,6,5,13,18,4996,05:00 - 06:59
summer,2012-03-25,7,14,25,39,4996,07:00 - 08:59
summer,2012-03-25,8,21,68,89,4996,07:00 - 08:59
summer,2012-03-25,9,26,92,118,4996,09:00 - 10:59
summer,2012-03-25,10,78,172,250,4996,09:00 - 10:59
summer,2012-03-25,11,106,217,323,4996,11:00 - 12:59
summer,2012-03-25,12,122,238,360,4996,11:00 - 12:59
summer,2012-03-25,13,110,257,367,4996,13:00 - 14:59
summer,2012-03-25,14,123,291,414,4996,13:00 - 14:59
summer,2012-03-25,15,139,282,421,4996,15:00 - 16:59
summer,2012-03-25,16,153,339,492,4996,15:00 - 16:59
summer,2012-03-25,17,146,273,419,4996,17:00 - 18:59
summer,2012-03-25,18,202,289,491,4996,17:00 - 18:59
summer,2012-03-25,19,114,261,375,4996,19:00 - 20:59
summer,2012-03-25,20,63,196,259,4996,19:00 - 20:59
summer,2012-03-25,21,25,124,149,4996,21:00 - 22:59
summer,2012-03-25,22,19,92,111,4996,21:00 - 22:59
summer,2012-03-25,23,9,56,65,4996,23:00 - 24:59
summer,2012-03-26,0,10,23,33,5558,
summer,2012-03-26,1,18,10,28,5558,01:00 - 02:59
summer,2012-03-26,2,14,6,20,5558,01:00 - 02:59
summer,2012-03-26,3,0,1,1,5558,03:00 - 04:59
summer,2012-03-26,4,0,4,4,5558,03:00 - 04:59
summer,2012-03-26,5,0,36,36,5558,05:00 - 06:59
summer,2012-03-26,6,7,110,117,5558,05:00 - 06:59
summer,2012-03-26,7,15,355,370,5558,07:00 - 08:59
summer,2012-03-26,8,32,625,657,5558,07:00 - 08:59
summer,2012-03-26,9,37,245,282,5558,09:00 - 10:59
summer,2012-03-26,10,55,98,153,5558,09:00 - 10:59
summer,2012-03-26,11,47,131,178,5558,11:00 - 12:59
summer,2012-03-26,12,63,216,279,5558,11:00 - 12:59
summer,2012-03-26,13,79,222,301,5558,13:00 - 14:59
summer,2012-03-26,14,58,159,217,5558,13:00 - 14:59
summer,2012-03-26,15,66,157,223,5558,15:00 - 16:59
summer,2012-03-26,16,60,245,305,5558,15:00 - 16:59
summer,2012-03-26,17,65,599,664,5558,17:00 - 18:59
summer,2012-03-26,18,90,594,684,5558,17:00 - 18:59
summer,2012-03-26,19,41,417,458,5558,19:00 - 20:59
summer,2012-03-26,20,12,209,221,5558,19:00 - 20:59
summer,2012-03-26,21,11,175,186,5558,21:00 - 22:59
summer,2012-03-26,22,13,80,93,5558,21:00 - 22:59
summer,2012-03-26,23,2,46,48,5558,23:00 - 24:59
summer,2012-03-27,0,1,9,10,5102,
summer,2012-03-27,1,1,4,5,5102,01:00 - 02:59
summer,2012-03-27,2,1,6,7,5102,01:00 - 02:59
summer,2012-03-27,3,0,4,4,5102,03:00 - 04:59
summer,2012-03-27,4,0,3,3,5102,03:00 - 04:59
summer,2012-03-27,5,1,16,17,5102,05:00 - 06:59
summer,2012-03-27,6,5,96,101,5102,05:00 - 06:59
summer,2012-03-27,7,9,277,286,5102,07:00 - 08:59
summer,2012-03-27,8,14,567,581,5102,07:00 - 08:59
summer,2012-03-27,9,8,259,267,5102,09:00 - 10:59
summer,2012-03-27,10,20,118,138,5102,09:00 - 10:59
summer,2012-03-27,11,34,141,175,5102,11:00 - 12:59
summer,2012-03-27,12,34,186,220,5102,11:00 - 12:59
summer,2012-03-27,13,46,165,211,5102,13:00 - 14:59
summer,2012-03-27,14,37,147,184,5102,13:00 - 14:59
summer,2012-03-27,15,42,158,200,5102,15:00 - 16:59
summer,2012-03-27,16,38,267,305,5102,15:00 - 16:59
summer,2012-03-27,17,72,542,614,5102,17:00 - 18:59
summer,2012-03-27,18,67,577,644,5102,17:00 - 18:59
summer,2012-03-27,19,40,377,417,5102,19:00 - 20:59
summer,2012-03-27,20,28,266,294,5102,19:00 - 20:59
summer,2012-03-27,21,21,200,221,5102,21:00 - 22:59
summer,2012-03-27,22,7,127,134,5102,21:00 - 22:59
summer,2012-03-27,23,5,59,64,5102,23:00 - 24:59
summer,2012-03-28,0,1,29,30,5698,
summer,2012-03-28,1,0,8,8,5698,01:00 - 02:59
summer,2012-03-28,2,0,3,3,5698,01:00 - 02:59
summer,2012-03-28,3,1,4,5,5698,03:00 - 04:59
summer,2012-03-28,4,1,0,1,5698,03:00 - 04:59
summer,2012-03-28,5,2,38,40,5698,05:00 - 06:59
summer,2012-03-28,6,4,111,115,5698,05:00 - 06:59
summer,2012-03-28,7,10,348,358,5698,07:00 - 08:59
summer,2012-03-28,8,19,639,658,5698,07:00 - 08:59
summer,2012-03-28,9,16,298,314,5698,09:00 - 10:59
summer,2012-03-28,10,33,140,173,5698,09:00 - 10:59
summer,2012-03-28,11,54,168,222,5698,11:00 - 12:59
summer,2012-03-28,12,50,218,268,5698,11:00 - 12:59
summer,2012-03-28,13,60,213,273,5698,13:00 - 14:59
summer,2012-03-28,14,52,169,221,5698,13:00 - 14:59
summer,2012-03-28,15,47,152,199,5698,15:00 - 16:59
summer,2012-03-28,16,51,170,221,5698,15:00 - 16:59
summer,2012-03-28,17,72,532,604,5698,17:00 - 18:59
summer,2012-03-28,18,61,580,641,5698,17:00 - 18:59
summer,2012-03-28,19,41,415,456,5698,19:00 - 20:59
summer,2012-03-28,20,38,324,362,5698,19:00 - 20:59
summer,2012-03-28,21,28,233,261,5698,21:00 - 22:59
summer,2012-03-28,22,21,151,172,5698,21:00 - 22:59
summer,2012-03-28,23,12,81,93,5698,23:00 - 24:59
summer,2012-03-29,0,10,38,48,6133,
summer,2012-03-29,1,15,18,33,6133,01:00 - 02:59
summer,2012-03-29,2,0,6,6,6133,01:00 - 02:59
summer,2012-03-29,3,1,4,5,6133,03:00 - 04:59
summer,2012-03-29,4,1,8,9,6133,03:00 - 04:59
summer,2012-03-29,5,2,30,32,6133,05:00 - 06:59
summer,2012-03-29,6,3,114,117,6133,05:00 - 06:59
summer,2012-03-29,7,14,353,367,6133,07:00 - 08:59
summer,2012-03-29,8,26,628,654,6133,07:00 - 08:59
summer,2012-03-29,9,22,299,321,6133,09:00 - 10:59
summer,2012-03-29,10,42,124,166,6133,09:00 - 10:59
summer,2012-03-29,11,54,166,220,6133,11:00 - 12:59
summer,2012-03-29,12,64,228,292,6133,11:00 - 12:59
summer,2012-03-29,13,50,223,273,6133,13:00 - 14:59
summer,2012-03-29,14,63,175,238,6133,13:00 - 14:59
summer,2012-03-29,15,109,198,307,6133,15:00 - 16:59
summer,2012-03-29,16,67,321,388,6133,15:00 - 16:59
summer,2012-03-29,17,83,620,703,6133,17:00 - 18:59
summer,2012-03-29,18,83,598,681,6133,17:00 - 18:59
summer,2012-03-29,19,47,421,468,6133,19:00 - 20:59
summer,2012-03-29,20,34,301,335,6133,19:00 - 20:59
summer,2012-03-29,21,10,214,224,6133,21:00 - 22:59
summer,2012-03-29,22,17,135,152,6133,21:00 - 22:59
summer,2012-03-29,23,17,77,94,6133,23:00 - 24:59
summer,2012-03-30,0,10,49,59,5459,
summer,2012-03-30,1,6,21,27,5459,01:00 - 02:59
summer,2012-03-30,2,1,6,7,5459,01:00 - 02:59
summer,2012-03-30,3,0,7,7,5459,03:00 - 04:59
summer,2012-03-30,4,1,1,2,5459,03:00 - 04:59
summer,2012-03-30,5,0,26,26,5459,05:00 - 06:59
summer,2012-03-30,6,5,81,86,5459,05:00 - 06:59
summer,2012-03-30,7,9,280,289,5459,07:00 - 08:59
summer,2012-03-30,8,38,555,593,5459,07:00 - 08:59
summer,2012-03-30,9,29,292,321,5459,09:00 - 10:59
summer,2012-03-30,10,50,137,187,5459,09:00 - 10:59
summer,2012-03-30,11,48,153,201,5459,11:00 - 12:59
summer,2012-03-30,12,62,208,270,5459,11:00 - 12:59
summer,2012-03-30,13,44,198,242,5459,13:00 - 14:59
summer,2012-03-30,14,56,173,229,5459,13:00 - 14:59
summer,2012-03-30,15,73,207,280,5459,15:00 - 16:59
summer,2012-03-30,16,75,292,367,5459,15:00 - 16:59
summer,2012-03-30,17,93,513,606,5459,17:00 - 18:59
summer,2012-03-30,18,68,492,560,5459,17:00 - 18:59
summer,2012-03-30,19,42,353,395,5459,19:00 - 20:59
summer,2012-03-30,20,17,192,209,5459,19:00 - 20:59
summer,2012-03-30,21,30,190,220,5459,21:00 - 22:59
summer,2012-03-30,22,23,130,153,5459,21:00 - 22:59
summer,2012-03-30,23,16,107,123,5459,23:00 - 24:59
summer,2012-03-31,0,12,80,92,6235,
summer,2012-03-31,1,17,65,82,6235,01:00 - 02:59
summer,2012-03-31,2,14,55,69,6235,01:00 - 02:59
summer,2012-03-31,3,10,21,31,6235,03:00 - 04:59
summer,2012-03-31,4,4,4,8,6235,03:00 - 04:59
summer,2012-03-31,5,0,5,5,6235,05:00 - 06:59
summer,2012-03-31,6,7,16,23,6235,05:00 - 06:59
summer,2012-03-31,7,5,39,44,6235,07:00 - 08:59
summer,2012-03-31,8,19,126,145,6235,07:00 - 08:59
summer,2012-03-31,9,62,161,223,6235,09:00 - 10:59
summer,2012-03-31,10,108,205,313,6235,09:00 - 10:59
summer,2012-03-31,11,184,279,463,6235,11:00 - 12:59
summer,2012-03-31,12,263,358,621,6235,11:00 - 12:59
summer,2012-03-31,13,265,373,638,6235,13:00 - 14:59
summer,2012-03-31,14,240,311,551,6235,13:00 - 14:59
summer,2012-03-31,15,275,330,605,6235,15:00 - 16:59
summer,2012-03-31,16,243,292,535,6235,15:00 - 16:59
summer,2012-03-31,17,238,305,543,6235,17:00 - 18:59
summer,2012-03-31,18,102,239,341,6235,17:00 - 18:59
summer,2012-03-31,19,93,191,284,6235,19:00 - 20:59
summer,2012-03-31,20,52,156,208,6235,19:00 - 20:59
summer,2012-03-31,21,36,107,143,6235,21:00 - 22:59
summer,2012-03-31,22,40,116,156,6235,21:00 - 22:59
summer,2012-03-31,23,12,100,112,6235,23:00 - 24:59
summer,2012-04-01,0,8,59,67,6041,
summer,2012-04-01,1,13,49,62,6041,01:00 - 02:59
summer,2012-04-01,2,20,61,81,6041,01:00 - 02:59
summer,2012-04-01,3,4,21,25,6041,03:00 - 04:59
summer,2012-04-01,4,3,9,12,6041,03:00 - 04:59
summer,2012-04-01,5,8,10,18,6041,05:00 - 06:59
summer,2012-04-01,6,9,88,97,6041,05:00 - 06:59
summer,2012-04-01,7,29,55,84,6041,07:00 - 08:59
summer,2012-04-01,8,37,88,125,6041,07:00 - 08:59
summer,2012-04-01,9,102,173,275,6041,09:00 - 10:59
summer,2012-04-01,10,132,228,360,6041,09:00 - 10:59
summer,2012-04-01,11,180,271,451,6041,11:00 - 12:59
summer,2012-04-01,12,187,258,445,6041,11:00 - 12:59
summer,2012-04-01,13,190,274,464,6041,13:00 - 14:59
summer,2012-04-01,14,283,278,561,6041,13:00 - 14:59
summer,2012-04-01,15,295,278,573,6041,15:00 - 16:59
summer,2012-04-01,16,236,275,511,6041,15:00 - 16:59
summer,2012-04-01,17,232,323,555,6041,17:00 - 18:59
summer,2012-04-01,18,153,279,432,6041,17:00 - 18:59
summer,2012-04-01,19,110,236,346,6041,19:00 - 20:59
summer,2012-04-01,20,66,166,232,6041,19:00 - 20:59
summer,2012-04-01,21,33,101,134,6041,21:00 - 22:59
summer,2012-04-01,22,7,61,68,6041,21:00 - 22:59
summer,2012-04-01,23,10,53,63,6041,23:00 - 24:59
summer,2012-04-02,0,6,11,17,5936,
summer,2012-04-02,1,0,5,5,5936,01:00 - 02:59
summer,2012-04-02,2,2,3,5,5936,01:00 - 02:59
summer,2012-04-02,4,2,2,4,5936,03:00 - 04:59
summer,2012-04-02,5,2,22,24,5936,05:00 - 06:59
summer,2012-04-02,6,6,104,110,5936,05:00 - 06:59
summer,2012-04-02,7,12,294,306,5936,07:00 - 08:59
summer,2012-04-02,8,36,553,589,5936,07:00 - 08:59
summer,2012-04-02,9,52,265,317,5936,09:00 - 10:59
summer,2012-04-02,10,85,119,204,5936,09:00 - 10:59
summer,2012-04-02,11,81,128,209,5936,11:00 - 12:59
summer,2012-04-02,12,100,181,281,5936,11:00 - 12:59
summer,2012-04-02,13,97,184,281,5936,13:00 - 14:59
summer,2012-04-02,14,127,141,268,5936,13:00 - 14:59
summer,2012-04-02,15,132,192,324,5936,15:00 - 16:59
summer,2012-04-02,16,104,291,395,5936,15:00 - 16:59
summer,2012-04-02,17,128,601,729,5936,17:00 - 18:59
summer,2012-04-02,18,75,543,618,5936,17:00 - 18:59
summer,2012-04-02,19,66,428,494,5936,19:00 - 20:59
summer,2012-04-02,20,48,281,329,5936,19:00 - 20:59
summer,2012-04-02,21,24,214,238,5936,21:00 - 22:59
summer,2012-04-02,22,17,106,123,5936,21:00 - 22:59
summer,2012-04-02,23,6,60,66,5936,23:00 - 24:59
summer,2012-04-03,0,1,32,33,6772,
summer,2012-04-03,1,0,11,11,6772,01:00 - 02:59
summer,2012-04-03,2,0,5,5,6772,01:00 - 02:59
summer,2012-04-03,3,0,3,3,6772,03:00 - 04:59
summer,2012-04-03,4,0,1,1,6772,03:00 - 04:59
summer,2012-04-03,5,2,25,27,6772,05:00 - 06:59
summer,2012-04-03,6,2,98,100,6772,05:00 - 06:59
summer,2012-04-03,7,14,327,341,6772,07:00 - 08:59
summer,2012-04-03,8,27,577,604,6772,07:00 - 08:59
summer,2012-04-03,9,54,354,408,6772,09:00 - 10:59
summer,2012-04-03,10,77,142,219,6772,09:00 - 10:59
summer,2012-04-03,11,91,167,258,6772,11:00 - 12:59
summer,2012-04-03,12,101,230,331,6772,11:00 - 12:59
summer,2012-04-03,13,120,225,345,6772,13:00 - 14:59
summer,2012-04-03,14,120,191,311,6772,13:00 - 14:59
summer,2012-04-03,15,109,207,316,6772,15:00 - 16:59
summer,2012-04-03,16,145,340,485,6772,15:00 - 16:59
summer,2012-04-03,17,123,634,757,6772,17:00 - 18:59
summer,2012-04-03,18,139,661,800,6772,17:00 - 18:59
summer,2012-04-03,19,98,460,558,6772,19:00 - 20:59
summer,2012-04-03,20,54,325,379,6772,19:00 - 20:59
summer,2012-04-03,21,33,210,243,6772,21:00 - 22:59
summer,2012-04-03,22,25,133,158,6772,21:00 - 22:59
summer,2012-04-03,23,13,66,79,6772,23:00 - 24:59
summer,2012-04-04,0,18,23,41,6436,
summer,2012-04-04,1,0,11,11,6436,01:00 - 02:59
summer,2012-04-04,2,0,5,5,6436,01:00 - 02:59
summer,2012-04-04,3,0,3,3,6436,03:00 - 04:59
summer,2012-04-04,4,0,1,1,6436,03:00 - 04:59
summer,2012-04-04,5,0,27,27,6436,05:00 - 06:59
summer,2012-04-04,6,6,120,126,6436,05:00 - 06:59
summer,2012-04-04,7,12,354,366,6436,07:00 - 08:59
summer,2012-04-04,8,31,653,684,6436,07:00 - 08:59
summer,2012-04-04,9,47,316,363,6436,09:00 - 10:59
summer,2012-04-04,10,68,99,167,6436,09:00 - 10:59
summer,2012-04-04,11,61,152,213,6436,11:00 - 12:59
summer,2012-04-04,12,73,210,283,6436,11:00 - 12:59
summer,2012-04-04,13,70,181,251,6436,13:00 - 14:59
summer,2012-04-04,14,82,176,258,6436,13:00 - 14:59
summer,2012-04-04,15,86,182,268,6436,15:00 - 16:59
summer,2012-04-04,16,86,304,390,6436,15:00 - 16:59
summer,2012-04-04,17,99,645,744,6436,17:00 - 18:59
summer,2012-04-04,18,113,646,759,6436,17:00 - 18:59
summer,2012-04-04,19,75,419,494,6436,19:00 - 20:59
summer,2012-04-04,20,39,333,372,6436,19:00 - 20:59
summer,2012-04-04,21,43,255,298,6436,21:00 - 22:59
summer,2012-04-04,22,30,151,181,6436,21:00 - 22:59
summer,2012-04-04,23,19,112,131,6436,23:00 - 24:59
summer,2012-04-05,0,12,33,45,6457,
summer,2012-04-05,1,4,9,13,6457,01:00 - 02:59
summer,2012-04-05,2,7,11,18,6457,01:00 - 02:59
summer,2012-04-05,3,0,5,5,6457,03:00 - 04:59
summer,2012-04-05,4,0,1,1,6457,03:00 - 04:59
summer,2012-04-05,5,1,28,29,6457,05:00 - 06:59
summer,2012-04-05,6,8,118,126,6457,05:00 - 06:59
summer,2012-04-05,7,15,339,354,6457,07:00 - 08:59
summer,2012-04-05,8,28,610,638,6457,07:00 - 08:59
summer,2012-04-05,9,61,290,351,6457,09:00 - 10:59
summer,2012-04-05,10,88,158,246,6457,09:00 - 10:59
summer,2012-04-05,11,109,159,268,6457,11:00 - 12:59
summer,2012-04-05,12,66,210,276,6457,11:00 - 12:59
summer,2012-04-05,13,89,202,291,6457,13:00 - 14:59
summer,2012-04-05,14,143,144,287,6457,13:00 - 14:59
summer,2012-04-05,15,98,171,269,6457,15:00 - 16:59
summer,2012-04-05,16,84,318,402,6457,15:00 - 16:59
summer,2012-04-05,17,145,677,822,6457,17:00 - 18:59
summer,2012-04-05,18,80,618,698,6457,17:00 - 18:59
summer,2012-04-05,19,64,423,487,6457,19:00 - 20:59
summer,2012-04-05,20,33,279,312,6457,19:00 - 20:59
summer,2012-04-05,21,25,209,234,6457,21:00 - 22:59
summer,2012-04-05,22,20,129,149,6457,21:00 - 22:59
summer,2012-04-05,23,12,124,136,6457,23:00 - 24:59
summer,2012-04-06,0,12,49,61,6460,
summer,2012-04-06,1,10,28,38,6460,01:00 - 02:59
summer,2012-04-06,2,6,5,11,6460,01:00 - 02:59
summer,2012-04-06,3,3,5,8,6460,03:00 - 04:59
summer,2012-04-06,4,2,3,5,6460,03:00 - 04:59
summer,2012-04-06,5,0,23,23,6460,05:00 - 06:59
summer,2012-04-06,6,0,80,80,6460,05:00 - 06:59
summer,2012-04-06,7,15,231,246,6460,07:00 - 08:59
summer,2012-04-06,8,19,489,508,6460,07:00 - 08:59
summer,2012-04-06,9,58,318,376,6460,09:00 - 10:59
summer,2012-04-06,10,81,157,238,6460,09:00 - 10:59
summer,2012-04-06,11,112,179,291,6460,11:00 - 12:59
summer,2012-04-06,12,113,224,337,6460,11:00 - 12:59
summer,2012-04-06,13,173,238,411,6460,13:00 - 14:59
summer,2012-04-06,14,240,250,490,6460,13:00 - 14:59
summer,2012-04-06,15,218,319,537,6460,15:00 - 16:59
summer,2012-04-06,16,184,352,536,6460,15:00 - 16:59
summer,2012-04-06,17,172,483,655,6460,17:00 - 18:59
summer,2012-04-06,18,104,380,484,6460,17:00 - 18:59
summer,2012-04-06,19,115,297,412,6460,19:00 - 20:59
summer,2012-04-06,20,61,191,252,6460,19:00 - 20:59
summer,2012-04-06,21,54,136,190,6460,21:00 - 22:59
summer,2012-04-06,22,34,124,158,6460,21:00 - 22:59
summer,2012-04-06,23,21,92,113,6460,23:00 - 24:59
summer,2012-04-07,0,9,85,94,6857,
summer,2012-04-07,1,9,60,69,6857,01:00 - 02:59
summer,2012-04-07,2,11,25,36,6857,01:00 - 02:59
summer,2012-04-07,3,7,21,28,6857,03:00 - 04:59
summer,2012-04-07,4,3,4,7,6857,03:00 - 04:59
summer,2012-04-07,5,0,2,2,6857,05:00 - 06:59
summer,2012-04-07,6,1,18,19,6857,05:00 - 06:59
summer,2012-04-07,7,14,40,54,6857,07:00 - 08:59
summer,2012-04-07,8,29,94,123,6857,07:00 - 08:59
summer,2012-04-07,9,103,173,276,6857,09:00 - 10:59
summer,2012-04-07,10,187,176,363,6857,09:00 - 10:59
summer,2012-04-07,11,251,244,495,6857,11:00 - 12:59
summer,2012-04-07,12,320,270,590,6857,11:00 - 12:59
summer,2012-04-07,13,355,288,643,6857,13:00 - 14:59
summer,2012-04-07,14,326,252,578,6857,13:00 - 14:59
summer,2012-04-07,15,321,305,626,6857,15:00 - 16:59
summer,2012-04-07,16,354,261,615,6857,15:00 - 16:59
summer,2012-04-07,17,299,268,567,6857,17:00 - 18:59
summer,2012-04-07,18,227,290,517,6857,17:00 - 18:59
summer,2012-04-07,19,170,243,413,6857,19:00 - 20:59
summer,2012-04-07,20,73,135,208,6857,19:00 - 20:59
summer,2012-04-07,21,75,159,234,6857,21:00 - 22:59
summer,2012-04-07,22,76,106,182,6857,21:00 - 22:59
summer,2012-04-07,23,32,86,118,6857,23:00 - 24:59
summer,2012-04-08,0,21,64,85,5169,
summer,2012-04-08,1,14,50,64,5169,01:00 - 02:59
summer,2012-04-08,2,7,25,32,5169,01:00 - 02:59
summer,2012-04-08,3,8,18,26,5169,03:00 - 04:59
summer,2012-04-08,4,0,7,7,5169,03:00 - 04:59
summer,2012-04-08,5,4,8,12,5169,05:00 - 06:59
summer,2012-04-08,6,7,21,28,5169,05:00 - 06:59
summer,2012-04-08,7,12,25,37,5169,07:00 - 08:59
summer,2012-04-08,8,19,65,84,5169,07:00 - 08:59
summer,2012-04-08,9,71,108,179,5169,09:00 - 10:59
summer,2012-04-08,10,113,186,299,5169,09:00 - 10:59
summer,2012-04-08,11,195,209,404,5169,11:00 - 12:59
summer,2012-04-08,12,198,259,457,5169,11:00 - 12:59
summer,2012-04-08,13,229,254,483,5169,13:00 - 14:59
summer,2012-04-08,14,254,249,503,5169,13:00 - 14:59
summer,2012-04-08,15,260,226,486,5169,15:00 - 16:59
summer,2012-04-08,16,232,244,476,5169,15:00 - 16:59
summer,2012-04-08,17,185,226,411,5169,17:00 - 18:59
summer,2012-04-08,18,151,159,310,5169,17:00 - 18:59
summer,2012-04-08,19,89,187,276,5169,19:00 - 20:59
summer,2012-04-08,20,65,146,211,5169,19:00 - 20:59
summer,2012-04-08,21,53,77,130,5169,21:00 - 22:59
summer,2012-04-08,22,33,85,118,5169,21:00 - 22:59
summer,2012-04-08,23,10,41,51,5169,23:00 - 24:59
summer,2012-04-09,0,8,29,37,5585,
summer,2012-04-09,1,4,12,16,5585,01:00 - 02:59
summer,2012-04-09,2,2,4,6,5585,01:00 - 02:59
summer,2012-04-09,3,0,3,3,5585,03:00 - 04:59
summer,2012-04-09,4,2,3,5,5585,03:00 - 04:59
summer,2012-04-09,5,2,30,32,5585,05:00 - 06:59
summer,2012-04-09,6,3,108,111,5585,05:00 - 06:59
summer,2012-04-09,7,11,320,331,5585,07:00 - 08:59
summer,2012-04-09,8,22,595,617,5585,07:00 - 08:59
summer,2012-04-09,9,50,236,286,5585,09:00 - 10:59
summer,2012-04-09,10,65,113,178,5585,09:00 - 10:59
summer,2012-04-09,11,96,127,223,5585,11:00 - 12:59
summer,2012-04-09,12,94,186,280,5585,11:00 - 12:59
summer,2012-04-09,13,108,173,281,5585,13:00 - 14:59
summer,2012-04-09,14,66,152,218,5585,13:00 - 14:59
summer,2012-04-09,15,82,173,255,5585,15:00 - 16:59
summer,2012-04-09,16,81,310,391,5585,15:00 - 16:59
summer,2012-04-09,17,67,565,632,5585,17:00 - 18:59
summer,2012-04-09,18,60,586,646,5585,17:00 - 18:59
summer,2012-04-09,19,35,386,421,5585,19:00 - 20:59
summer,2012-04-09,20,21,255,276,5585,19:00 - 20:59
summer,2012-04-09,21,14,151,165,5585,21:00 - 22:59
summer,2012-04-09,22,6,102,108,5585,21:00 - 22:59
summer,2012-04-09,23,6,61,67,5585,23:00 - 24:59
summer,2012-04-10,0,3,23,26,5918,
summer,2012-04-10,1,0,9,9,5918,01:00 - 02:59
summer,2012-04-10,2,0,2,2,5918,01:00 - 02:59
summer,2012-04-10,3,0,2,2,5918,03:00 - 04:59
summer,2012-04-10,4,0,2,2,5918,03:00 - 04:59
summer,2012-04-10,5,0,24,24,5918,05:00 - 06:59
summer,2012-04-10,6,3,100,103,5918,05:00 - 06:59
summer,2012-04-10,7,16,368,384,5918,07:00 - 08:59
summer,2012-04-10,8,22,670,692,5918,07:00 - 08:59
summer,2012-04-10,9,16,303,319,5918,09:00 - 10:59
summer,2012-04-10,10,49,132,181,5918,09:00 - 10:59
summer,2012-04-10,11,78,161,239,5918,11:00 - 12:59
summer,2012-04-10,12,75,184,259,5918,11:00 - 12:59
summer,2012-04-10,13,81,202,283,5918,13:00 - 14:59
summer,2012-04-10,14,75,149,224,5918,13:00 - 14:59
summer,2012-04-10,15,46,157,203,5918,15:00 - 16:59
summer,2012-04-10,16,66,296,362,5918,15:00 - 16:59
summer,2012-04-10,17,88,656,744,5918,17:00 - 18:59
summer,2012-04-10,18,78,626,704,5918,17:00 - 18:59
summer,2012-04-10,19,51,428,479,5918,19:00 - 20:59
summer,2012-04-10,20,34,248,282,5918,19:00 - 20:59
summer,2012-04-10,21,15,191,206,5918,21:00 - 22:59
summer,2012-04-10,22,9,118,127,5918,21:00 - 22:59
summer,2012-04-10,23,14,48,62,5918,23:00 - 24:59
summer,2012-04-11,0,8,22,30,4862,
summer,2012-04-11,1,3,9,12,4862,01:00 - 02:59
summer,2012-04-11,2,0,2,2,4862,01:00 - 02:59
summer,2012-04-11,3,0,2,2,4862,03:00 - 04:59
summer,2012-04-11,5,1,26,27,4862,05:00 - 06:59
summer,2012-04-11,6,3,103,106,4862,05:00 - 06:59
summer,2012-04-11,7,18,303,321,4862,07:00 - 08:59
summer,2012-04-11,8,14,581,595,4862,07:00 - 08:59
summer,2012-04-11,9,20,282,302,4862,09:00 - 10:59
summer,2012-04-11,10,26,127,153,4862,09:00 - 10:59
summer,2012-04-11,11,38,142,180,4862,11:00 - 12:59
summer,2012-04-11,12,35,147,182,4862,11:00 - 12:59
summer,2012-04-11,13,16,147,163,4862,13:00 - 14:59
summer,2012-04-11,14,34,101,135,4862,13:00 - 14:59
summer,2012-04-11,15,50,152,202,4862,15:00 - 16:59
summer,2012-04-11,16,51,256,307,4862,15:00 - 16:59
summer,2012-04-11,17,52,527,579,4862,17:00 - 18:59
summer,2012-04-11,18,39,546,585,4862,17:00 - 18:59
summer,2012-04-11,19,28,356,384,4862,19:00 - 20:59
summer,2012-04-11,20,22,213,235,4862,19:00 - 20:59
summer,2012-04-11,21,11,154,165,4862,21:00 - 22:59
summer,2012-04-11,22,4,130,134,4862,21:00 - 22:59
summer,2012-04-11,23,9,52,61,4862,23:00 - 24:59
summer,2012-04-12,0,1,22,23,5409,
summer,2012-04-12,1,2,7,9,5409,01:00 - 02:59
summer,2012-04-12,2,0,4,4,5409,01:00 - 02:59
summer,2012-04-12,3,2,3,5,5409,03:00 - 04:59
summer,2012-04-12,4,0,1,1,5409,03:00 - 04:59
summer,2012-04-12,5,0,21,21,5409,05:00 - 06:59
summer,2012-04-12,6,2,94,96,5409,05:00 - 06:59
summer,2012-04-12,7,12,294,306,5409,07:00 - 08:59
summer,2012-04-12,8,20,604,624,5409,07:00 - 08:59
summer,2012-04-12,9,16,271,287,5409,09:00 - 10:59
summer,2012-04-12,10,38,103,141,5409,09:00 - 10:59
summer,2012-04-12,11,50,174,224,5409,11:00 - 12:59
summer,2012-04-12,12,60,199,259,5409,11:00 - 12:59
summer,2012-04-12,13,55,148,203,5409,13:00 - 14:59
summer,2012-04-12,14,74,150,224,5409,13:00 - 14:59
summer,2012-04-12,15,42,169,211,5409,15:00 - 16:59
summer,2012-04-12,16,54,299,353,5409,15:00 - 16:59
summer,2012-04-12,17,60,596,656,5409,17:00 - 18:59
summer,2012-04-12,18,63,547,610,5409,17:00 - 18:59
summer,2012-04-12,19,50,383,433,5409,19:00 - 20:59
summer,2012-04-12,20,26,254,280,5409,19:00 - 20:59
summer,2012-04-12,21,13,174,187,5409,21:00 - 22:59
summer,2012-04-12,22,15,143,158,5409,21:00 - 22:59
summer,2012-04-12,23,8,86,94,5409,23:00 - 24:59
summer,2012-04-13,0,14,41,55,6398,
summer,2012-04-13,1,2,28,30,6398,01:00 - 02:59
summer,2012-04-13,2,6,5,11,6398,01:00 - 02:59
summer,2012-04-13,3,3,8,11,6398,03:00 - 04:59
summer,2012-04-13,4,1,4,5,6398,03:00 - 04:59
summer,2012-04-13,5,2,19,21,6398,05:00 - 06:59
summer,2012-04-13,6,0,84,84,6398,05:00 - 06:59
summer,2012-04-13,7,13,283,296,6398,07:00 - 08:59
summer,2012-04-13,8,24,539,563,6398,07:00 - 08:59
summer,2012-04-13,9,36,294,330,6398,09:00 - 10:59
summer,2012-04-13,10,59,133,192,6398,09:00 - 10:59
summer,2012-04-13,11,75,158,233,6398,11:00 - 12:59
summer,2012-04-13,12,104,218,322,6398,11:00 - 12:59
summer,2012-04-13,13,112,246,358,6398,13:00 - 14:59
summer,2012-04-13,14,125,223,348,6398,13:00 - 14:59
summer,2012-04-13,15,115,237,352,6398,15:00 - 16:59
summer,2012-04-13,16,113,350,463,6398,15:00 - 16:59
summer,2012-04-13,17,117,621,738,6398,17:00 - 18:59
summer,2012-04-13,18,107,564,671,6398,17:00 - 18:59
summer,2012-04-13,19,75,352,427,6398,19:00 - 20:59
summer,2012-04-13,20,44,242,286,6398,19:00 - 20:59
summer,2012-04-13,21,36,153,189,6398,21:00 - 22:59
summer,2012-04-13,22,34,181,215,6398,21:00 - 22:59
summer,2012-04-13,23,35,163,198,6398,23:00 - 24:59
summer,2012-04-14,0,11,85,96,7460,
summer,2012-04-14,1,10,60,70,7460,01:00 - 02:59
summer,2012-04-14,2,3,53,56,7460,01:00 - 02:59
summer,2012-04-14,3,6,26,32,7460,03:00 - 04:59
summer,2012-04-14,4,5,9,14,7460,03:00 - 04:59
summer,2012-04-14,5,2,5,7,7460,05:00 - 06:59
summer,2012-04-14,6,2,19,21,7460,05:00 - 06:59
summer,2012-04-14,7,8,56,64,7460,07:00 - 08:59
summer,2012-04-14,8,24,136,160,7460,07:00 - 08:59
summer,2012-04-14,9,59,206,265,7460,09:00 - 10:59
summer,2012-04-14,10,139,267,406,7460,09:00 - 10:59
summer,2012-04-14,11,207,357,564,7460,11:00 - 12:59
summer,2012-04-14,12,274,404,678,7460,11:00 - 12:59
summer,2012-04-14,13,308,370,678,7460,13:00 - 14:59
summer,2012-04-14,14,288,372,660,7460,13:00 - 14:59
summer,2012-04-14,15,311,347,658,7460,15:00 - 16:59
summer,2012-04-14,16,253,329,582,7460,15:00 - 16:59
summer,2012-04-14,17,251,309,560,7460,17:00 - 18:59
summer,2012-04-14,18,197,284,481,7460,17:00 - 18:59
summer,2012-04-14,19,163,296,459,7460,19:00 - 20:59
summer,2012-04-14,20,112,209,321,7460,19:00 - 20:59
summer,2012-04-14,21,53,167,220,7460,21:00 - 22:59
summer,2012-04-14,22,64,148,212,7460,21:00 - 22:59
summer,2012-04-14,23,45,151,196,7460,23:00 - 24:59
summer,2012-04-15,0,30,94,124,7132,
summer,2012-04-15,1,17,89,106,7132,01:00 - 02:59
summer,2012-04-15,2,20,54,74,7132,01:00 - 02:59
summer,2012-04-15,3,18,27,45,7132,03:00 - 04:59
summer,2012-04-15,4,2,10,12,7132,03:00 - 04:59
summer,2012-04-15,5,4,6,10,7132,05:00 - 06:59
summer,2012-04-15,6,5,11,16,7132,05:00 - 06:59
summer,2012-04-15,7,16,30,46,7132,07:00 - 08:59
summer,2012-04-15,8,33,64,97,7132,07:00 - 08:59
summer,2012-04-15,9,97,154,251,7132,09:00 - 10:59
summer,2012-04-15,10,186,235,421,7132,09:00 - 10:59
summer,2012-04-15,11,227,301,528,7132,11:00 - 12:59
summer,2012-04-15,12,275,360,635,7132,11:00 - 12:59
summer,2012-04-15,13,298,383,681,7132,13:00 - 14:59
summer,2012-04-15,14,282,346,628,7132,13:00 - 14:59
summer,2012-04-15,15,266,351,617,7132,15:00 - 16:59
summer,2012-04-15,16,286,330,616,7132,15:00 - 16:59
summer,2012-04-15,17,262,361,623,7132,17:00 - 18:59
summer,2012-04-15,18,184,295,479,7132,17:00 - 18:59
summer,2012-04-15,19,114,265,379,7132,19:00 - 20:59
summer,2012-04-15,20,86,205,291,7132,19:00 - 20:59
summer,2012-04-15,21,76,153,229,7132,21:00 - 22:59
summer,2012-04-15,22,37,97,134,7132,21:00 - 22:59
summer,2012-04-15,23,25,65,90,7132,23:00 - 24:59
summer,2012-04-16,0,15,26,41,6370,
summer,2012-04-16,1,7,21,28,6370,01:00 - 02:59
summer,2012-04-16,2,5,9,14,6370,01:00 - 02:59
summer,2012-04-16,3,3,5,8,6370,03:00 - 04:59
summer,2012-04-16,4,0,6,6,6370,03:00 - 04:59
summer,2012-04-16,5,4,34,38,6370,05:00 - 06:59
summer,2012-04-16,6,10,123,133,6370,05:00 - 06:59
summer,2012-04-16,7,20,367,387,6370,07:00 - 08:59
summer,2012-04-16,8,48,549,597,6370,07:00 - 08:59
summer,2012-04-16,9,59,238,297,6370,09:00 - 10:59
summer,2012-04-16,10,75,149,224,6370,09:00 - 10:59
summer,2012-04-16,11,115,136,251,6370,11:00 - 12:59
summer,2012-04-16,12,75,196,271,6370,11:00 - 12:59
summer,2012-04-16,13,79,184,263,6370,13:00 - 14:59
summer,2012-04-16,14,105,183,288,6370,13:00 - 14:59
summer,2012-04-16,15,81,194,275,6370,15:00 - 16:59
summer,2012-04-16,16,92,266,358,6370,15:00 - 16:59
summer,2012-04-16,17,111,601,712,6370,17:00 - 18:59
summer,2012-04-16,18,87,589,676,6370,17:00 - 18:59
summer,2012-04-16,19,61,461,522,6370,19:00 - 20:59
summer,2012-04-16,20,48,327,375,6370,19:00 - 20:59
summer,2012-04-16,21,39,232,271,6370,21:00 - 22:59
summer,2012-04-16,22,35,179,214,6370,21:00 - 22:59
summer,2012-04-16,23,24,97,121,6370,23:00 - 24:59
summer,2012-04-17,0,10,33,43,6691,
summer,2012-04-17,1,6,5,11,6691,01:00 - 02:59
summer,2012-04-17,2,1,3,4,6691,01:00 - 02:59
summer,2012-04-17,3,0,6,6,6691,03:00 - 04:59
summer,2012-04-17,4,3,6,9,6691,03:00 - 04:59
summer,2012-04-17,5,1,29,30,6691,05:00 - 06:59
summer,2012-04-17,6,8,136,144,6691,05:00 - 06:59
summer,2012-04-17,7,18,443,461,6691,07:00 - 08:59
summer,2012-04-17,8,42,631,673,6691,07:00 - 08:59
summer,2012-04-17,9,71,329,400,6691,09:00 - 10:59
summer,2012-04-17,10,52,165,217,6691,09:00 - 10:59
summer,2012-04-17,11,65,174,239,6691,11:00 - 12:59
summer,2012-04-17,12,65,179,244,6691,11:00 - 12:59
summer,2012-04-17,13,52,187,239,6691,13:00 - 14:59
summer,2012-04-17,14,59,198,257,6691,13:00 - 14:59
summer,2012-04-17,15,91,217,308,6691,15:00 - 16:59
summer,2012-04-17,16,50,320,370,6691,15:00 - 16:59
summer,2012-04-17,17,108,673,781,6691,17:00 - 18:59
summer,2012-04-17,18,105,670,775,6691,17:00 - 18:59
summer,2012-04-17,19,73,464,537,6691,19:00 - 20:59
summer,2012-04-17,20,44,358,402,6691,19:00 - 20:59
summer,2012-04-17,21,37,260,297,6691,21:00 - 22:59
summer,2012-04-17,22,18,144,162,6691,21:00 - 22:59
summer,2012-04-17,23,10,72,82,6691,23:00 - 24:59
summer,2012-04-18,0,3,35,38,4367,
summer,2012-04-18,1,1,13,14,4367,01:00 - 02:59
summer,2012-04-18,2,1,8,9,4367,01:00 - 02:59
summer,2012-04-18,3,0,6,6,4367,03:00 - 04:59
summer,2012-04-18,4,0,7,7,4367,03:00 - 04:59
summer,2012-04-18,5,0,34,34,4367,05:00 - 06:59
summer,2012-04-18,6,6,128,134,4367,05:00 - 06:59
summer,2012-04-18,7,10,408,418,4367,07:00 - 08:59
summer,2012-04-18,8,25,551,576,4367,07:00 - 08:59
summer,2012-04-18,9,20,245,265,4367,09:00 - 10:59
summer,2012-04-18,10,31,116,147,4367,09:00 - 10:59
summer,2012-04-18,11,14,105,119,4367,11:00 - 12:59
summer,2012-04-18,12,15,95,110,4367,11:00 - 12:59
summer,2012-04-18,13,13,51,64,4367,13:00 - 14:59
summer,2012-04-18,14,8,43,51,4367,13:00 - 14:59
summer,2012-04-18,15,10,88,98,4367,15:00 - 16:59
summer,2012-04-18,16,36,199,235,4367,15:00 - 16:59
summer,2012-04-18,17,46,442,488,4367,17:00 - 18:59
summer,2012-04-18,18,27,478,505,4367,17:00 - 18:59
summer,2012-04-18,19,26,342,368,4367,19:00 - 20:59
summer,2012-04-18,20,8,252,260,4367,19:00 - 20:59
summer,2012-04-18,21,24,165,189,4367,21:00 - 22:59
summer,2012-04-18,22,9,153,162,4367,21:00 - 22:59
summer,2012-04-18,23,14,56,70,4367,23:00 - 24:59
summer,2012-04-19,0,5,20,25,6565,
summer,2012-04-19,1,2,11,13,6565,01:00 - 02:59
summer,2012-04-19,2,2,4,6,6565,01:00 - 02:59
summer,2012-04-19,3,1,3,4,6565,03:00 - 04:59
summer,2012-04-19,4,0,4,4,6565,03:00 - 04:59
summer,2012-04-19,5,0,30,30,6565,05:00 - 06:59
summer,2012-04-19,6,4,116,120,6565,05:00 - 06:59
summer,2012-04-19,7,15,391,406,6565,07:00 - 08:59
summer,2012-04-19,8,26,651,677,6565,07:00 - 08:59
summer,2012-04-19,9,31,270,301,6565,09:00 - 10:59
summer,2012-04-19,10,46,143,189,6565,09:00 - 10:59
summer,2012-04-19,11,46,183,229,6565,11:00 - 12:59
summer,2012-04-19,12,51,213,264,6565,11:00 - 12:59
summer,2012-04-19,13,52,186,238,6565,13:00 - 14:59
summer,2012-04-19,14,54,183,237,6565,13:00 - 14:59
summer,2012-04-19,15,66,196,262,6565,15:00 - 16:59
summer,2012-04-19,16,63,324,387,6565,15:00 - 16:59
summer,2012-04-19,17,85,663,748,6565,17:00 - 18:59
summer,2012-04-19,18,99,677,776,6565,17:00 - 18:59
summer,2012-04-19,19,70,516,586,6565,19:00 - 20:59
summer,2012-04-19,20,52,352,404,6565,19:00 - 20:59
summer,2012-04-19,21,27,240,267,6565,21:00 - 22:59
summer,2012-04-19,22,29,219,248,6565,21:00 - 22:59
summer,2012-04-19,23,20,124,144,6565,23:00 - 24:59
summer,2012-04-20,0,5,59,64,7290,
summer,2012-04-20,1,3,22,25,7290,01:00 - 02:59
summer,2012-04-20,2,3,18,21,7290,01:00 - 02:59
summer,2012-04-20,3,1,9,10,7290,03:00 - 04:59
summer,2012-04-20,4,0,3,3,7290,03:00 - 04:59
summer,2012-04-20,5,1,24,25,7290,05:00 - 06:59
summer,2012-04-20,6,8,105,113,7290,05:00 - 06:59
summer,2012-04-20,7,9,350,359,7290,07:00 - 08:59
summer,2012-04-20,8,32,668,700,7290,07:00 - 08:59
summer,2012-04-20,9,30,329,359,7290,09:00 - 10:59
summer,2012-04-20,10,67,170,237,7290,09:00 - 10:59
summer,2012-04-20,11,64,190,254,7290,11:00 - 12:59
summer,2012-04-20,12,102,260,362,7290,11:00 - 12:59
summer,2012-04-20,13,105,276,381,7290,13:00 - 14:59
summer,2012-04-20,14,156,238,394,7290,13:00 - 14:59
summer,2012-04-20,15,145,262,407,7290,15:00 - 16:59
summer,2012-04-20,16,151,429,580,7290,15:00 - 16:59
summer,2012-04-20,17,122,697,819,7290,17:00 - 18:59
summer,2012-04-20,18,110,558,668,7290,17:00 - 18:59
summer,2012-04-20,19,82,410,492,7290,19:00 - 20:59
summer,2012-04-20,20,52,289,341,7290,19:00 - 20:59
summer,2012-04-20,21,35,252,287,7290,21:00 - 22:59
summer,2012-04-20,22,26,176,202,7290,21:00 - 22:59
summer,2012-04-20,23,31,156,187,7290,23:00 - 24:59
summer,2012-04-21,0,31,111,142,6624,
summer,2012-04-21,1,24,64,88,6624,01:00 - 02:59
summer,2012-04-21,2,12,69,81,6624,01:00 - 02:59
summer,2012-04-21,3,4,25,29,6624,03:00 - 04:59
summer,2012-04-21,4,0,9,9,6624,03:00 - 04:59
summer,2012-04-21,5,0,1,1,6624,05:00 - 06:59
summer,2012-04-21,6,10,21,31,6624,05:00 - 06:59
summer,2012-04-21,7,21,55,76,6624,07:00 - 08:59
summer,2012-04-21,8,52,149,201,6624,07:00 - 08:59
summer,2012-04-21,9,115,216,331,6624,09:00 - 10:59
summer,2012-04-21,10,183,299,482,6624,09:00 - 10:59
summer,2012-04-21,11,260,348,608,6624,11:00 - 12:59
summer,2012-04-21,12,262,378,640,6624,11:00 - 12:59
summer,2012-04-21,13,291,358,649,6624,13:00 - 14:59
summer,2012-04-21,14,278,331,609,6624,13:00 - 14:59
summer,2012-04-21,15,267,361,628,6624,15:00 - 16:59
summer,2012-04-21,16,267,372,639,6624,15:00 - 16:59
summer,2012-04-21,17,259,309,568,6624,17:00 - 18:59
summer,2012-04-21,18,133,283,416,6624,17:00 - 18:59
summer,2012-04-21,19,9,45,54,6624,19:00 - 20:59
summer,2012-04-21,20,5,34,39,6624,19:00 - 20:59
summer,2012-04-21,21,20,82,102,6624,21:00 - 22:59
summer,2012-04-21,22,20,90,110,6624,21:00 - 22:59
summer,2012-04-21,23,18,73,91,6624,23:00 - 24:59
summer,2012-04-22,0,32,85,117,1027,
summer,2012-04-22,1,10,63,73,1027,01:00 - 02:59
summer,2012-04-22,2,7,49,56,1027,01:00 - 02:59
summer,2012-04-22,3,7,33,40,1027,03:00 - 04:59
summer,2012-04-22,4,0,7,7,1027,03:00 - 04:59
summer,2012-04-22,5,0,6,6,1027,05:00 - 06:59
summer,2012-04-22,6,6,6,12,1027,05:00 - 06:59
summer,2012-04-22,7,2,22,24,1027,07:00 - 08:59
summer,2012-04-22,8,8,43,51,1027,07:00 - 08:59
summer,2012-04-22,9,8,71,79,1027,09:00 - 10:59
summer,2012-04-22,10,11,57,68,1027,09:00 - 10:59
summer,2012-04-22,11,7,70,77,1027,11:00 - 12:59
summer,2012-04-22,12,5,56,61,1027,11:00 - 12:59
summer,2012-04-22,13,5,47,52,1027,13:00 - 14:59
summer,2012-04-22,14,3,50,53,1027,13:00 - 14:59
summer,2012-04-22,15,0,38,38,1027,15:00 - 16:59
summer,2012-04-22,16,4,32,36,1027,15:00 - 16:59
summer,2012-04-22,17,2,25,27,1027,17:00 - 18:59
summer,2012-04-22,18,1,38,39,1027,17:00 - 18:59
summer,2012-04-22,19,1,34,35,1027,19:00 - 20:59
summer,2012-04-22,20,1,34,35,1027,19:00 - 20:59
summer,2012-04-22,21,0,11,11,1027,21:00 - 22:59
summer,2012-04-22,22,0,13,13,1027,21:00 - 22:59
summer,2012-04-22,23,0,17,17,1027,23:00 - 24:59
summer,2012-04-23,0,0,6,6,3214,
summer,2012-04-23,1,1,1,2,3214,01:00 - 02:59
summer,2012-04-23,2,1,3,4,3214,01:00 - 02:59
summer,2012-04-23,3,0,1,1,3214,03:00 - 04:59
summer,2012-04-23,4,0,3,3,3214,03:00 - 04:59
summer,2012-04-23,5,0,14,14,3214,05:00 - 06:59
summer,2012-04-23,6,2,43,45,3214,05:00 - 06:59
summer,2012-04-23,7,1,206,207,3214,07:00 - 08:59
summer,2012-04-23,8,11,471,482,3214,07:00 - 08:59
summer,2012-04-23,9,17,255,272,3214,09:00 - 10:59
summer,2012-04-23,10,12,88,100,3214,09:00 - 10:59
summer,2012-04-23,11,10,91,101,3214,11:00 - 12:59
summer,2012-04-23,12,12,117,129,3214,11:00 - 12:59
summer,2012-04-23,13,9,98,107,3214,13:00 - 14:59
summer,2012-04-23,14,12,102,114,3214,13:00 - 14:59
summer,2012-04-23,15,11,101,112,3214,15:00 - 16:59
summer,2012-04-23,16,10,93,103,3214,15:00 - 16:59
summer,2012-04-23,17,13,219,232,3214,17:00 - 18:59
summer,2012-04-23,18,10,369,379,3214,17:00 - 18:59
summer,2012-04-23,19,11,287,298,3214,19:00 - 20:59
summer,2012-04-23,20,17,186,203,3214,19:00 - 20:59
summer,2012-04-23,21,7,145,152,3214,21:00 - 22:59
summer,2012-04-23,22,18,71,89,3214,21:00 - 22:59
summer,2012-04-23,23,10,49,59,3214,23:00 - 24:59
summer,2012-04-24,0,0,13,13,5633,
summer,2012-04-24,1,1,6,7,5633,01:00 - 02:59
summer,2012-04-24,2,0,3,3,5633,01:00 - 02:59
summer,2012-04-24,3,0,2,2,5633,03:00 - 04:59
summer,2012-04-24,4,0,3,3,5633,03:00 - 04:59
summer,2012-04-24,5,0,22,22,5633,05:00 - 06:59
summer,2012-04-24,6,3,117,120,5633,05:00 - 06:59
summer,2012-04-24,7,3,387,390,5633,07:00 - 08:59
summer,2012-04-24,8,12,599,611,5633,07:00 - 08:59
summer,2012-04-24,9,6,302,308,5633,09:00 - 10:59
summer,2012-04-24,10,33,129,162,5633,09:00 - 10:59
summer,2012-04-24,11,27,157,184,5633,11:00 - 12:59
summer,2012-04-24,12,36,188,224,5633,11:00 - 12:59
summer,2012-04-24,13,35,189,224,5633,13:00 - 14:59
summer,2012-04-24,14,50,166,216,5633,13:00 - 14:59
summer,2012-04-24,15,60,176,236,5633,15:00 - 16:59
summer,2012-04-24,16,54,308,362,5633,15:00 - 16:59
summer,2012-04-24,17,72,619,691,5633,17:00 - 18:59
summer,2012-04-24,18,52,580,632,5633,17:00 - 18:59
summer,2012-04-24,19,33,449,482,5633,19:00 - 20:59
summer,2012-04-24,20,16,269,285,5633,19:00 - 20:59
summer,2012-04-24,21,13,213,226,5633,21:00 - 22:59
summer,2012-04-24,22,8,149,157,5633,21:00 - 22:59
summer,2012-04-24,23,4,69,73,5633,23:00 - 24:59
summer,2012-04-25,0,13,23,36,6196,
summer,2012-04-25,1,8,17,25,6196,01:00 - 02:59
summer,2012-04-25,2,1,6,7,6196,01:00 - 02:59
summer,2012-04-25,3,0,3,3,6196,03:00 - 04:59
summer,2012-04-25,4,0,6,6,6196,03:00 - 04:59
summer,2012-04-25,5,0,24,24,6196,05:00 - 06:59
summer,2012-04-25,6,3,103,106,6196,05:00 - 06:59
summer,2012-04-25,7,13,376,389,6196,07:00 - 08:59
summer,2012-04-25,8,20,634,654,6196,07:00 - 08:59
summer,2012-04-25,9,33,288,321,6196,09:00 - 10:59
summer,2012-04-25,10,44,138,182,6196,09:00 - 10:59
summer,2012-04-25,11,42,177,219,6196,11:00 - 12:59
summer,2012-04-25,12,49,220,269,6196,11:00 - 12:59
summer,2012-04-25,13,35,193,228,6196,13:00 - 14:59
summer,2012-04-25,14,47,176,223,6196,13:00 - 14:59
summer,2012-04-25,15,47,182,229,6196,15:00 - 16:59
summer,2012-04-25,16,49,327,376,6196,15:00 - 16:59
summer,2012-04-25,17,68,664,732,6196,17:00 - 18:59
summer,2012-04-25,18,60,649,709,6196,17:00 - 18:59
summer,2012-04-25,19,42,501,543,6196,19:00 - 20:59
summer,2012-04-25,20,22,358,380,6196,19:00 - 20:59
summer,2012-04-25,21,27,212,239,6196,21:00 - 22:59
summer,2012-04-25,22,22,170,192,6196,21:00 - 22:59
summer,2012-04-25,23,10,94,104,6196,23:00 - 24:59
summer,2012-04-26,0,1,42,43,5026,
summer,2012-04-26,1,1,22,23,5026,01:00 - 02:59
summer,2012-04-26,2,3,10,13,5026,01:00 - 02:59
summer,2012-04-26,3,1,5,6,5026,03:00 - 04:59
summer,2012-04-26,4,1,2,3,5026,03:00 - 04:59
summer,2012-04-26,5,0,17,17,5026,05:00 - 06:59
summer,2012-04-26,6,5,122,127,5026,05:00 - 06:59
summer,2012-04-26,7,3,222,225,5026,07:00 - 08:59
summer,2012-04-26,8,4,358,362,5026,07:00 - 08:59
summer,2012-04-26,9,12,189,201,5026,09:00 - 10:59
summer,2012-04-26,10,14,125,139,5026,09:00 - 10:59
summer,2012-04-26,11,16,135,151,5026,11:00 - 12:59
summer,2012-04-26,12,24,180,204,5026,11:00 - 12:59
summer,2012-04-26,13,19,178,197,5026,13:00 - 14:59
summer,2012-04-26,14,37,132,169,5026,13:00 - 14:59
summer,2012-04-26,15,39,165,204,5026,15:00 - 16:59
summer,2012-04-26,16,37,281,318,5026,15:00 - 16:59
summer,2012-04-26,17,49,565,614,5026,17:00 - 18:59
summer,2012-04-26,18,75,589,664,5026,17:00 - 18:59
summer,2012-04-26,19,57,407,464,5026,19:00 - 20:59
summer,2012-04-26,20,23,314,337,5026,19:00 - 20:59
summer,2012-04-26,21,28,222,250,5026,21:00 - 22:59
summer,2012-04-26,22,20,163,183,5026,21:00 - 22:59
summer,2012-04-26,23,6,106,112,5026,23:00 - 24:59
summer,2012-04-27,0,12,61,73,6233,
summer,2012-04-27,1,3,32,35,6233,01:00 - 02:59
summer,2012-04-27,2,4,18,22,6233,01:00 - 02:59
summer,2012-04-27,3,1,2,3,6233,03:00 - 04:59
summer,2012-04-27,4,0,6,6,6233,03:00 - 04:59
summer,2012-04-27,5,0,19,19,6233,05:00 - 06:59
summer,2012-04-27,6,5,115,120,6233,05:00 - 06:59
summer,2012-04-27,7,10,305,315,6233,07:00 - 08:59
summer,2012-04-27,8,17,575,592,6233,07:00 - 08:59
summer,2012-04-27,9,42,292,334,6233,09:00 - 10:59
summer,2012-04-27,10,64,172,236,6233,09:00 - 10:59
summer,2012-04-27,11,47,186,233,6233,11:00 - 12:59
summer,2012-04-27,12,63,244,307,6233,11:00 - 12:59
summer,2012-04-27,13,94,212,306,6233,13:00 - 14:59
summer,2012-04-27,14,94,206,300,6233,13:00 - 14:59
summer,2012-04-27,15,101,223,324,6233,15:00 - 16:59
summer,2012-04-27,16,105,335,440,6233,15:00 - 16:59
summer,2012-04-27,17,89,613,702,6233,17:00 - 18:59
summer,2012-04-27,18,94,560,654,6233,17:00 - 18:59
summer,2012-04-27,19,62,379,441,6233,19:00 - 20:59
summer,2012-04-27,20,49,240,289,6233,19:00 - 20:59
summer,2012-04-27,21,23,185,208,6233,21:00 - 22:59
summer,2012-04-27,22,24,134,158,6233,21:00 - 22:59
summer,2012-04-27,23,11,105,116,6233,23:00 - 24:59
summer,2012-04-28,0,4,99,103,4220,
summer,2012-04-28,1,7,60,67,4220,01:00 - 02:59
summer,2012-04-28,2,8,49,57,4220,01:00 - 02:59
summer,2012-04-28,3,3,23,26,4220,03:00 - 04:59
summer,2012-04-28,4,0,2,2,4220,03:00 - 04:59
summer,2012-04-28,5,2,3,5,4220,05:00 - 06:59
summer,2012-04-28,6,10,18,28,4220,05:00 - 06:59
summer,2012-04-28,7,10,45,55,4220,07:00 - 08:59
summer,2012-04-28,8,24,134,158,4220,07:00 - 08:59
summer,2012-04-28,9,45,169,214,4220,09:00 - 10:59
summer,2012-04-28,10,60,231,291,4220,09:00 - 10:59
summer,2012-04-28,11,96,262,358,4220,11:00 - 12:59
summer,2012-04-28,12,105,276,381,4220,11:00 - 12:59
summer,2012-04-28,13,120,269,389,4220,13:00 - 14:59
summer,2012-04-28,14,147,293,440,4220,13:00 - 14:59
summer,2012-04-28,15,148,260,408,4220,15:00 - 16:59
summer,2012-04-28,16,132,244,376,4220,15:00 - 16:59
summer,2012-04-28,17,98,224,322,4220,17:00 - 18:59
summer,2012-04-28,18,17,73,90,4220,17:00 - 18:59
summer,2012-04-28,19,29,110,139,4220,19:00 - 20:59
summer,2012-04-28,20,21,81,102,4220,19:00 - 20:59
summer,2012-04-28,21,12,72,84,4220,21:00 - 22:59
summer,2012-04-28,22,17,66,83,4220,21:00 - 22:59
summer,2012-04-28,23,5,37,42,4220,23:00 - 24:59
summer,2012-04-29,0,0,36,36,6304,
summer,2012-04-29,1,5,37,42,6304,01:00 - 02:59
summer,2012-04-29,2,4,36,40,6304,01:00 - 02:59
summer,2012-04-29,3,2,14,16,6304,03:00 - 04:59
summer,2012-04-29,4,0,4,4,6304,03:00 - 04:59
summer,2012-04-29,5,0,6,6,6304,05:00 - 06:59
summer,2012-04-29,6,1,6,7,6304,05:00 - 06:59
summer,2012-04-29,7,7,20,27,6304,07:00 - 08:59
summer,2012-04-29,8,26,81,107,6304,07:00 - 08:59
summer,2012-04-29,9,52,133,185,6304,09:00 - 10:59
summer,2012-04-29,10,127,253,380,6304,09:00 - 10:59
summer,2012-04-29,11,128,283,411,6304,11:00 - 12:59
summer,2012-04-29,12,223,361,584,6304,11:00 - 12:59
summer,2012-04-29,13,226,369,595,6304,13:00 - 14:59
summer,2012-04-29,14,281,372,653,6304,13:00 - 14:59
summer,2012-04-29,15,279,324,603,6304,15:00 - 16:59
summer,2012-04-29,16,240,347,587,6304,15:00 - 16:59
summer,2012-04-29,17,188,334,522,6304,17:00 - 18:59
summer,2012-04-29,18,164,323,487,6304,17:00 - 18:59
summer,2012-04-29,19,128,247,375,6304,19:00 - 20:59
summer,2012-04-29,20,45,198,243,6304,19:00 - 20:59
summer,2012-04-29,21,65,139,204,6304,21:00 - 22:59
summer,2012-04-29,22,23,85,108,6304,21:00 - 22:59
summer,2012-04-29,23,15,67,82,6304,23:00 - 24:59
summer,2012-04-30,0,12,36,48,5572,
summer,2012-04-30,1,9,15,24,5572,01:00 - 02:59
summer,2012-04-30,2,3,5,8,5572,01:00 - 02:59
summer,2012-04-30,3,0,4,4,5572,03:00 - 04:59
summer,2012-04-30,4,0,2,2,5572,03:00 - 04:59
summer,2012-04-30,5,1,19,20,5572,05:00 - 06:59
summer,2012-04-30,6,2,121,123,5572,05:00 - 06:59
summer,2012-04-30,7,6,343,349,5572,07:00 - 08:59
summer,2012-04-30,8,17,579,596,5572,07:00 - 08:59
summer,2012-04-30,9,29,239,268,5572,09:00 - 10:59
summer,2012-04-30,10,41,116,157,5572,09:00 - 10:59
summer,2012-04-30,11,52,111,163,5572,11:00 - 12:59
summer,2012-04-30,12,45,180,225,5572,11:00 - 12:59
summer,2012-04-30,13,48,199,247,5572,13:00 - 14:59
summer,2012-04-30,14,56,162,218,5572,13:00 - 14:59
summer,2012-04-30,15,55,176,231,5572,15:00 - 16:59
summer,2012-04-30,16,44,303,347,5572,15:00 - 16:59
summer,2012-04-30,17,66,617,683,5572,17:00 - 18:59
summer,2012-04-30,18,53,611,664,5572,17:00 - 18:59
summer,2012-04-30,19,51,420,471,5572,19:00 - 20:59
summer,2012-04-30,20,28,281,309,5572,19:00 - 20:59
summer,2012-04-30,21,26,195,221,5572,21:00 - 22:59
summer,2012-04-30,22,11,123,134,5572,21:00 - 22:59
summer,2012-04-30,23,10,50,60,5572,23:00 - 24:59
summer,2012-05-01,0,7,28,35,5740,
summer,2012-05-01,1,0,21,21,5740,01:00 - 02:59
summer,2012-05-01,2,1,7,8,5740,01:00 - 02:59
summer,2012-05-01,3,1,2,3,5740,03:00 - 04:59
summer,2012-05-01,4,1,7,8,5740,03:00 - 04:59
summer,2012-05-01,5,0,17,17,5740,05:00 - 06:59
summer,2012-05-01,6,2,24,26,5740,05:00 - 06:59
summer,2012-05-01,7,8,161,169,5740,07:00 - 08:59
summer,2012-05-01,8,19,538,557,5740,07:00 - 08:59
summer,2012-05-01,9,18,331,349,5740,09:00 - 10:59
summer,2012-05-01,10,30,144,174,5740,09:00 - 10:59
summer,2012-05-01,11,50,179,229,5740,11:00 - 12:59
summer,2012-05-01,12,41,228,269,5740,11:00 - 12:59
summer,2012-05-01,13,41,208,249,5740,13:00 - 14:59
summer,2012-05-01,14,37,167,204,5740,13:00 - 14:59
summer,2012-05-01,15,48,186,234,5740,15:00 - 16:59
summer,2012-05-01,16,41,313,354,5740,15:00 - 16:59
summer,2012-05-01,17,65,616,681,5740,17:00 - 18:59
summer,2012-05-01,18,81,662,743,5740,17:00 - 18:59
summer,2012-05-01,19,58,429,487,5740,19:00 - 20:59
summer,2012-05-01,20,36,299,335,5740,19:00 - 20:59
summer,2012-05-01,21,31,251,282,5740,21:00 - 22:59
summer,2012-05-01,22,21,190,211,5740,21:00 - 22:59
summer,2012-05-01,23,16,79,95,5740,23:00 - 24:59
summer,2012-05-02,0,4,43,47,6169,
summer,2012-05-02,1,8,7,15,6169,01:00 - 02:59
summer,2012-05-02,2,7,9,16,6169,01:00 - 02:59
summer,2012-05-02,3,0,6,6,6169,03:00 - 04:59
summer,2012-05-02,4,2,2,4,6169,03:00 - 04:59
summer,2012-05-02,5,2,31,33,6169,05:00 - 06:59
summer,2012-05-02,6,3,117,120,6169,05:00 - 06:59
summer,2012-05-02,7,14,344,358,6169,07:00 - 08:59
summer,2012-05-02,8,26,640,666,6169,07:00 - 08:59
summer,2012-05-02,9,26,289,315,6169,09:00 - 10:59
summer,2012-05-02,10,28,147,175,6169,09:00 - 10:59
summer,2012-05-02,11,39,145,184,6169,11:00 - 12:59
summer,2012-05-02,12,35,210,245,6169,11:00 - 12:59
summer,2012-05-02,13,49,179,228,6169,13:00 - 14:59
summer,2012-05-02,14,51,189,240,6169,13:00 - 14:59
summer,2012-05-02,15,52,204,256,6169,15:00 - 16:59
summer,2012-05-02,16,54,313,367,6169,15:00 - 16:59
summer,2012-05-02,17,70,659,729,6169,17:00 - 18:59
summer,2012-05-02,18,43,770,813,6169,17:00 - 18:59
summer,2012-05-02,19,43,461,504,6169,19:00 - 20:59
summer,2012-05-02,20,42,296,338,6169,19:00 - 20:59
summer,2012-05-02,21,21,218,239,6169,21:00 - 22:59
summer,2012-05-02,22,27,146,173,6169,21:00 - 22:59
summer,2012-05-02,23,21,77,98,6169,23:00 - 24:59
summer,2012-05-03,0,15,75,90,6421,
summer,2012-05-03,1,9,15,24,6421,01:00 - 02:59
summer,2012-05-03,2,4,13,17,6421,01:00 - 02:59
summer,2012-05-03,3,2,4,6,6421,03:00 - 04:59
summer,2012-05-03,4,0,2,2,6421,03:00 - 04:59
summer,2012-05-03,5,1,20,21,6421,05:00 - 06:59
summer,2012-05-03,6,8,128,136,6421,05:00 - 06:59
summer,2012-05-03,7,8,376,384,6421,07:00 - 08:59
summer,2012-05-03,8,19,608,627,6421,07:00 - 08:59
summer,2012-05-03,9,25,279,304,6421,09:00 - 10:59
summer,2012-05-03,10,36,132,168,6421,09:00 - 10:59
summer,2012-05-03,11,34,167,201,6421,11:00 - 12:59
summer,2012-05-03,12,64,237,301,6421,11:00 - 12:59
summer,2012-05-03,13,48,217,265,6421,13:00 - 14:59
summer,2012-05-03,14,33,171,204,6421,13:00 - 14:59
summer,2012-05-03,15,63,220,283,6421,15:00 - 16:59
summer,2012-05-03,16,45,325,370,6421,15:00 - 16:59
summer,2012-05-03,17,87,617,704,6421,17:00 - 18:59
summer,2012-05-03,18,64,642,706,6421,17:00 - 18:59
summer,2012-05-03,19,55,467,522,6421,19:00 - 20:59
summer,2012-05-03,20,52,368,420,6421,19:00 - 20:59
summer,2012-05-03,21,42,257,299,6421,21:00 - 22:59
summer,2012-05-03,22,29,217,246,6421,21:00 - 22:59
summer,2012-05-03,23,21,100,121,6421,23:00 - 24:59
summer,2012-05-04,0,19,70,89,6296,
summer,2012-05-04,1,15,33,48,6296,01:00 - 02:59
summer,2012-05-04,2,0,11,11,6296,01:00 - 02:59
summer,2012-05-04,3,0,14,14,6296,03:00 - 04:59
summer,2012-05-04,4,0,4,4,6296,03:00 - 04:59
summer,2012-05-04,5,0,24,24,6296,05:00 - 06:59
summer,2012-05-04,6,8,127,135,6296,05:00 - 06:59
summer,2012-05-04,7,9,347,356,6296,07:00 - 08:59
summer,2012-05-04,8,34,584,618,6296,07:00 - 08:59
summer,2012-05-04,9,32,262,294,6296,09:00 - 10:59
summer,2012-05-04,10,45,154,199,6296,09:00 - 10:59
summer,2012-05-04,11,77,181,258,6296,11:00 - 12:59
summer,2012-05-04,12,46,125,171,6296,11:00 - 12:59
summer,2012-05-04,13,71,207,278,6296,13:00 - 14:59
summer,2012-05-04,14,83,159,242,6296,13:00 - 14:59
summer,2012-05-04,15,103,240,343,6296,15:00 - 16:59
summer,2012-05-04,16,82,358,440,6296,15:00 - 16:59
summer,2012-05-04,17,96,547,643,6296,17:00 - 18:59
summer,2012-05-04,18,77,564,641,6296,17:00 - 18:59
summer,2012-05-04,19,64,388,452,6296,19:00 - 20:59
summer,2012-05-04,20,58,255,313,6296,19:00 - 20:59
summer,2012-05-04,21,49,186,235,6296,21:00 - 22:59
summer,2012-05-04,22,50,182,232,6296,21:00 - 22:59
summer,2012-05-04,23,51,205,256,6296,23:00 - 24:59
summer,2012-05-05,0,42,111,153,6883,
summer,2012-05-05,1,28,79,107,6883,01:00 - 02:59
summer,2012-05-05,2,24,51,75,6883,01:00 - 02:59
summer,2012-05-05,3,11,21,32,6883,03:00 - 04:59
summer,2012-05-05,4,0,9,9,6883,03:00 - 04:59
summer,2012-05-05,5,8,14,22,6883,05:00 - 06:59
summer,2012-05-05,6,9,33,42,6883,05:00 - 06:59
summer,2012-05-05,7,8,79,87,6883,07:00 - 08:59
summer,2012-05-05,8,42,155,197,6883,07:00 - 08:59
summer,2012-05-05,9,61,223,284,6883,09:00 - 10:59
summer,2012-05-05,10,148,284,432,6883,09:00 - 10:59
summer,2012-05-05,11,221,354,575,6883,11:00 - 12:59
summer,2012-05-05,12,220,330,550,6883,11:00 - 12:59
summer,2012-05-05,13,217,307,524,6883,13:00 - 14:59
summer,2012-05-05,14,187,241,428,6883,13:00 - 14:59
summer,2012-05-05,15,241,300,541,6883,15:00 - 16:59
summer,2012-05-05,16,230,310,540,6883,15:00 - 16:59
summer,2012-05-05,17,204,298,502,6883,17:00 - 18:59
summer,2012-05-05,18,156,278,434,6883,17:00 - 18:59
summer,2012-05-05,19,151,254,405,6883,19:00 - 20:59
summer,2012-05-05,20,100,209,309,6883,19:00 - 20:59
summer,2012-05-05,21,86,183,269,6883,21:00 - 22:59
summer,2012-05-05,22,67,150,217,6883,21:00 - 22:59
summer,2012-05-05,23,35,114,149,6883,23:00 - 24:59
summer,2012-05-06,0,23,111,134,6359,
summer,2012-05-06,1,37,84,121,6359,01:00 - 02:59
summer,2012-05-06,2,29,64,93,6359,01:00 - 02:59
summer,2012-05-06,3,9,19,28,6359,03:00 - 04:59
summer,2012-05-06,4,9,7,16,6359,03:00 - 04:59
summer,2012-05-06,5,1,10,11,6359,05:00 - 06:59
summer,2012-05-06,6,3,14,17,6359,05:00 - 06:59
summer,2012-05-06,7,5,31,36,6359,07:00 - 08:59
summer,2012-05-06,8,23,91,114,6359,07:00 - 08:59
summer,2012-05-06,9,63,128,191,6359,09:00 - 10:59
summer,2012-05-06,10,112,221,333,6359,09:00 - 10:59
summer,2012-05-06,11,144,270,414,6359,11:00 - 12:59
summer,2012-05-06,12,207,351,558,6359,11:00 - 12:59
summer,2012-05-06,13,197,368,565,6359,13:00 - 14:59
summer,2012-05-06,14,226,292,518,6359,13:00 - 14:59
summer,2012-05-06,15,229,342,571,6359,15:00 - 16:59
summer,2012-05-06,16,181,363,544,6359,15:00 - 16:59
summer,2012-05-06,17,195,316,511,6359,17:00 - 18:59
summer,2012-05-06,18,131,332,463,6359,17:00 - 18:59
summer,2012-05-06,19,117,266,383,6359,19:00 - 20:59
summer,2012-05-06,20,73,203,276,6359,19:00 - 20:59
summer,2012-05-06,21,55,148,203,6359,21:00 - 22:59
summer,2012-05-06,22,44,113,157,6359,21:00 - 22:59
summer,2012-05-06,23,22,80,102,6359,23:00 - 24:59
summer,2012-05-07,0,13,21,34,6273,
summer,2012-05-07,1,1,8,9,6273,01:00 - 02:59
summer,2012-05-07,2,1,5,6,6273,01:00 - 02:59
summer,2012-05-07,3,2,3,5,6273,03:00 - 04:59
summer,2012-05-07,4,0,2,2,6273,03:00 - 04:59
summer,2012-05-07,5,2,21,23,6273,05:00 - 06:59
summer,2012-05-07,6,8,134,142,6273,05:00 - 06:59
summer,2012-05-07,7,18,367,385,6273,07:00 - 08:59
summer,2012-05-07,8,31,608,639,6273,07:00 - 08:59
summer,2012-05-07,9,61,289,350,6273,09:00 - 10:59
summer,2012-05-07,10,62,128,190,6273,09:00 - 10:59
summer,2012-05-07,11,64,149,213,6273,11:00 - 12:59
summer,2012-05-07,12,74,189,263,6273,11:00 - 12:59
summer,2012-05-07,13,75,197,272,6273,13:00 - 14:59
summer,2012-05-07,14,59,180,239,6273,13:00 - 14:59
summer,2012-05-07,15,76,186,262,6273,15:00 - 16:59
summer,2012-05-07,16,68,320,388,6273,15:00 - 16:59
summer,2012-05-07,17,102,667,769,6273,17:00 - 18:59
summer,2012-05-07,18,78,602,680,6273,17:00 - 18:59
summer,2012-05-07,19,83,463,546,6273,19:00 - 20:59
summer,2012-05-07,20,46,277,323,6273,19:00 - 20:59
summer,2012-05-07,21,37,210,247,6273,21:00 - 22:59
summer,2012-05-07,22,26,147,173,6273,21:00 - 22:59
summer,2012-05-07,23,21,92,113,6273,23:00 - 24:59
summer,2012-05-08,0,10,28,38,5728,
summer,2012-05-08,1,6,3,9,5728,01:00 - 02:59
summer,2012-05-08,2,9,7,16,5728,01:00 - 02:59
summer,2012-05-08,3,2,4,6,5728,03:00 - 04:59
summer,2012-05-08,4,0,5,5,5728,03:00 - 04:59
summer,2012-05-08,5,0,20,20,5728,05:00 - 06:59
summer,2012-05-08,6,7,158,165,5728,05:00 - 06:59
summer,2012-05-08,7,21,442,463,5728,07:00 - 08:59
summer,2012-05-08,8,36,605,641,5728,07:00 - 08:59
summer,2012-05-08,9,37,258,295,5728,09:00 - 10:59
summer,2012-05-08,10,46,111,157,5728,09:00 - 10:59
summer,2012-05-08,11,60,157,217,5728,11:00 - 12:59
summer,2012-05-08,12,60,203,263,5728,11:00 - 12:59
summer,2012-05-08,13,53,166,219,5728,13:00 - 14:59
summer,2012-05-08,14,8,63,71,5728,13:00 - 14:59
summer,2012-05-08,15,40,94,134,5728,15:00 - 16:59
summer,2012-05-08,16,54,335,389,5728,15:00 - 16:59
summer,2012-05-08,17,77,640,717,5728,17:00 - 18:59
summer,2012-05-08,18,69,641,710,5728,17:00 - 18:59
summer,2012-05-08,19,59,399,458,5728,19:00 - 20:59
summer,2012-05-08,20,40,262,302,5728,19:00 - 20:59
summer,2012-05-08,21,21,202,223,5728,21:00 - 22:59
summer,2012-05-08,22,13,134,147,5728,21:00 - 22:59
summer,2012-05-08,23,10,53,63,5728,23:00 - 24:59
summer,2012-05-09,0,8,27,35,4717,
summer,2012-05-09,1,3,11,14,4717,01:00 - 02:59
summer,2012-05-09,2,0,1,1,4717,01:00 - 02:59
summer,2012-05-09,3,0,2,2,4717,03:00 - 04:59
summer,2012-05-09,4,0,5,5,4717,03:00 - 04:59
summer,2012-05-09,5,1,27,28,4717,05:00 - 06:59
summer,2012-05-09,6,5,121,126,4717,05:00 - 06:59
summer,2012-05-09,7,17,401,418,4717,07:00 - 08:59
summer,2012-05-09,8,28,594,622,4717,07:00 - 08:59
summer,2012-05-09,9,40,285,325,4717,09:00 - 10:59
summer,2012-05-09,10,40,113,153,4717,09:00 - 10:59
summer,2012-05-09,11,45,156,201,4717,11:00 - 12:59
summer,2012-05-09,12,58,222,280,4717,11:00 - 12:59
summer,2012-05-09,13,50,216,266,4717,13:00 - 14:59
summer,2012-05-09,14,68,175,243,4717,13:00 - 14:59
summer,2012-05-09,15,68,191,259,4717,15:00 - 16:59
summer,2012-05-09,16,68,289,357,4717,15:00 - 16:59
summer,2012-05-09,17,76,629,705,4717,17:00 - 18:59
summer,2012-05-09,18,23,349,372,4717,17:00 - 18:59
summer,2012-05-09,19,2,96,98,4717,19:00 - 20:59
summer,2012-05-09,20,3,48,51,4717,19:00 - 20:59
summer,2012-05-09,21,4,30,34,4717,21:00 - 22:59
summer,2012-05-09,22,5,62,67,4717,21:00 - 22:59
summer,2012-05-09,23,8,47,55,4717,23:00 - 24:59
summer,2012-05-10,0,2,31,33,6572,
summer,2012-05-10,1,2,9,11,6572,01:00 - 02:59
summer,2012-05-10,2,0,3,3,6572,01:00 - 02:59
summer,2012-05-10,3,0,3,3,6572,03:00 - 04:59
summer,2012-05-10,4,0,2,2,6572,03:00 - 04:59
summer,2012-05-10,5,1,23,24,6572,05:00 - 06:59
summer,2012-05-10,6,9,130,139,6572,05:00 - 06:59
summer,2012-05-10,7,8,393,401,6572,07:00 - 08:59
summer,2012-05-10,8,27,603,630,6572,07:00 - 08:59
summer,2012-05-10,9,62,299,361,6572,09:00 - 10:59
summer,2012-05-10,10,42,112,154,6572,09:00 - 10:59
summer,2012-05-10,11,77,179,256,6572,11:00 - 12:59
summer,2012-05-10,12,65,207,272,6572,11:00 - 12:59
summer,2012-05-10,13,90,228,318,6572,13:00 - 14:59
summer,2012-05-10,14,61,186,247,6572,13:00 - 14:59
summer,2012-05-10,15,79,192,271,6572,15:00 - 16:59
summer,2012-05-10,16,87,334,421,6572,15:00 - 16:59
summer,2012-05-10,17,84,648,732,6572,17:00 - 18:59
summer,2012-05-10,18,109,661,770,6572,17:00 - 18:59
summer,2012-05-10,19,84,469,553,6572,19:00 - 20:59
summer,2012-05-10,20,59,315,374,6572,19:00 - 20:59
summer,2012-05-10,21,19,211,230,6572,21:00 - 22:59
summer,2012-05-10,22,36,196,232,6572,21:00 - 22:59
summer,2012-05-10,23,23,112,135,6572,23:00 - 24:59
summer,2012-05-11,0,17,47,64,7030,
summer,2012-05-11,1,14,32,46,7030,01:00 - 02:59
summer,2012-05-11,2,15,16,31,7030,01:00 - 02:59
summer,2012-05-11,3,5,8,13,7030,03:00 - 04:59
summer,2012-05-11,4,3,6,9,7030,03:00 - 04:59
summer,2012-05-11,5,3,23,26,7030,05:00 - 06:59
summer,2012-05-11,6,7,128,135,7030,05:00 - 06:59
summer,2012-05-11,7,6,345,351,7030,07:00 - 08:59
summer,2012-05-11,8,41,579,620,7030,07:00 - 08:59
summer,2012-05-11,9,34,288,322,7030,09:00 - 10:59
summer,2012-05-11,10,69,141,210,7030,09:00 - 10:59
summer,2012-05-11,11,88,203,291,7030,11:00 - 12:59
summer,2012-05-11,12,89,259,348,7030,11:00 - 12:59
summer,2012-05-11,13,100,263,363,7030,13:00 - 14:59
summer,2012-05-11,14,116,218,334,7030,13:00 - 14:59
summer,2012-05-11,15,140,299,439,7030,15:00 - 16:59
summer,2012-05-11,16,128,397,525,7030,15:00 - 16:59
summer,2012-05-11,17,102,677,779,7030,17:00 - 18:59
summer,2012-05-11,18,78,518,596,7030,17:00 - 18:59
summer,2012-05-11,19,73,430,503,7030,19:00 - 20:59
summer,2012-05-11,20,64,277,341,7030,19:00 - 20:59
summer,2012-05-11,21,45,225,270,7030,21:00 - 22:59
summer,2012-05-11,22,44,190,234,7030,21:00 - 22:59
summer,2012-05-11,23,38,142,180,7030,23:00 - 24:59
summer,2012-05-12,0,25,111,136,7429,
summer,2012-05-12,1,14,79,93,7429,01:00 - 02:59
summer,2012-05-12,2,10,46,56,7429,01:00 - 02:59
summer,2012-05-12,3,14,20,34,7429,03:00 - 04:59
summer,2012-05-12,4,3,6,9,7429,03:00 - 04:59
summer,2012-05-12,5,5,8,13,7429,05:00 - 06:59
summer,2012-05-12,6,10,23,33,7429,05:00 - 06:59
summer,2012-05-12,7,10,57,67,7429,07:00 - 08:59
summer,2012-05-12,8,22,156,178,7429,07:00 - 08:59
summer,2012-05-12,9,87,248,335,7429,09:00 - 10:59
summer,2012-05-12,10,132,279,411,7429,09:00 - 10:59
summer,2012-05-12,11,157,365,522,7429,11:00 - 12:59
summer,2012-05-12,12,206,353,559,7429,11:00 - 12:59
summer,2012-05-12,13,293,366,659,7429,13:00 - 14:59
summer,2012-05-12,14,257,358,615,7429,13:00 - 14:59
summer,2012-05-12,15,269,321,590,7429,15:00 - 16:59
summer,2012-05-12,16,254,337,591,7429,15:00 - 16:59
summer,2012-05-12,17,233,343,576,7429,17:00 - 18:59
summer,2012-05-12,18,164,382,546,7429,17:00 - 18:59
summer,2012-05-12,19,166,273,439,7429,19:00 - 20:59
summer,2012-05-12,20,113,174,287,7429,19:00 - 20:59
summer,2012-05-12,21,74,156,230,7429,21:00 - 22:59
summer,2012-05-12,22,62,212,274,7429,21:00 - 22:59
summer,2012-05-12,23,42,134,176,7429,23:00 - 24:59
summer,2012-05-13,0,19,79,98,6118,
summer,2012-05-13,1,22,72,94,6118,01:00 - 02:59
summer,2012-05-13,2,22,60,82,6118,01:00 - 02:59
summer,2012-05-13,3,2,26,28,6118,03:00 - 04:59
summer,2012-05-13,4,2,7,9,6118,03:00 - 04:59
summer,2012-05-13,5,4,8,12,6118,05:00 - 06:59
summer,2012-05-13,6,6,15,21,6118,05:00 - 06:59
summer,2012-05-13,7,18,42,60,6118,07:00 - 08:59
summer,2012-05-13,8,32,124,156,6118,07:00 - 08:59
summer,2012-05-13,9,79,143,222,6118,09:00 - 10:59
summer,2012-05-13,10,128,222,350,6118,09:00 - 10:59
summer,2012-05-13,11,150,278,428,6118,11:00 - 12:59
summer,2012-05-13,12,189,342,531,6118,11:00 - 12:59
summer,2012-05-13,13,255,347,602,6118,13:00 - 14:59
summer,2012-05-13,14,228,324,552,6118,13:00 - 14:59
summer,2012-05-13,15,190,309,499,6118,15:00 - 16:59
summer,2012-05-13,16,225,339,564,6118,15:00 - 16:59
summer,2012-05-13,17,191,287,478,6118,17:00 - 18:59
summer,2012-05-13,18,129,260,389,6118,17:00 - 18:59
summer,2012-05-13,19,107,232,339,6118,19:00 - 20:59
summer,2012-05-13,20,67,163,230,6118,19:00 - 20:59
summer,2012-05-13,21,48,121,169,6118,21:00 - 22:59
summer,2012-05-13,22,42,89,131,6118,21:00 - 22:59
summer,2012-05-13,23,17,57,74,6118,23:00 - 24:59
summer,2012-05-14,0,21,14,35,2843,
summer,2012-05-14,1,5,6,11,2843,01:00 - 02:59
summer,2012-05-14,2,1,1,2,2843,01:00 - 02:59
summer,2012-05-14,3,0,2,2,2843,03:00 - 04:59
summer,2012-05-14,4,3,3,6,2843,03:00 - 04:59
summer,2012-05-14,5,1,25,26,2843,05:00 - 06:59
summer,2012-05-14,6,3,62,65,2843,05:00 - 06:59
summer,2012-05-14,7,3,72,75,2843,07:00 - 08:59
summer,2012-05-14,8,1,155,156,2843,07:00 - 08:59
summer,2012-05-14,9,5,105,110,2843,09:00 - 10:59
summer,2012-05-14,10,6,53,59,2843,09:00 - 10:59
summer,2012-05-14,11,12,67,79,2843,11:00 - 12:59
summer,2012-05-14,12,53,132,185,2843,11:00 - 12:59
summer,2012-05-14,13,33,143,176,2843,13:00 - 14:59
summer,2012-05-14,14,43,128,171,2843,13:00 - 14:59
summer,2012-05-14,15,40,156,196,2843,15:00 - 16:59
summer,2012-05-14,16,20,91,111,2843,15:00 - 16:59
summer,2012-05-14,17,25,204,229,2843,17:00 - 18:59
summer,2012-05-14,18,17,283,300,2843,17:00 - 18:59
summer,2012-05-14,19,10,294,304,2843,19:00 - 20:59
summer,2012-05-14,20,11,178,189,2843,19:00 - 20:59
summer,2012-05-14,21,7,145,152,2843,21:00 - 22:59
summer,2012-05-14,22,11,118,129,2843,21:00 - 22:59
summer,2012-05-14,23,11,64,75,2843,23:00 - 24:59
summer,2012-05-15,0,7,25,32,5115,
summer,2012-05-15,1,5,14,19,5115,01:00 - 02:59
summer,2012-05-15,2,1,3,4,5115,01:00 - 02:59
summer,2012-05-15,3,1,5,6,5115,03:00 - 04:59
summer,2012-05-15,4,1,4,5,5115,03:00 - 04:59
summer,2012-05-15,5,0,8,8,5115,05:00 - 06:59
summer,2012-05-15,6,2,22,24,5115,05:00 - 06:59
summer,2012-05-15,7,1,91,92,5115,07:00 - 08:59
summer,2012-05-15,8,8,401,409,5115,07:00 - 08:59
summer,2012-05-15,9,28,327,355,5115,09:00 - 10:59
summer,2012-05-15,10,27,144,171,5115,09:00 - 10:59
summer,2012-05-15,11,38,186,224,5115,11:00 - 12:59
summer,2012-05-15,12,44,220,264,5115,11:00 - 12:59
summer,2012-05-15,13,35,204,239,5115,13:00 - 14:59
summer,2012-05-15,14,39,145,184,5115,13:00 - 14:59
summer,2012-05-15,15,51,205,256,5115,15:00 - 16:59
summer,2012-05-15,16,74,300,374,5115,15:00 - 16:59
summer,2012-05-15,17,75,603,678,5115,17:00 - 18:59
summer,2012-05-15,18,68,665,733,5115,17:00 - 18:59
summer,2012-05-15,19,57,455,512,5115,19:00 - 20:59
summer,2012-05-15,20,30,233,263,5115,19:00 - 20:59
summer,2012-05-15,21,11,98,109,5115,21:00 - 22:59
summer,2012-05-15,22,9,74,83,5115,21:00 - 22:59
summer,2012-05-15,23,13,58,71,5115,23:00 - 24:59
summer,2012-05-16,0,12,27,39,7424,
summer,2012-05-16,1,7,14,21,7424,01:00 - 02:59
summer,2012-05-16,2,5,14,19,7424,01:00 - 02:59
summer,2012-05-16,3,1,5,6,7424,03:00 - 04:59
summer,2012-05-16,4,1,3,4,7424,03:00 - 04:59
summer,2012-05-16,5,4,34,38,7424,05:00 - 06:59
summer,2012-05-16,6,8,150,158,7424,05:00 - 06:59
summer,2012-05-16,7,14,426,440,7424,07:00 - 08:59
summer,2012-05-16,8,33,617,650,7424,07:00 - 08:59
summer,2012-05-16,9,33,314,347,7424,09:00 - 10:59
summer,2012-05-16,10,43,149,192,7424,09:00 - 10:59
summer,2012-05-16,11,55,212,267,7424,11:00 - 12:59
summer,2012-05-16,12,59,271,330,7424,11:00 - 12:59
summer,2012-05-16,13,77,273,350,7424,13:00 - 14:59
summer,2012-05-16,14,42,221,263,7424,13:00 - 14:59
summer,2012-05-16,15,52,222,274,7424,15:00 - 16:59
summer,2012-05-16,16,70,376,446,7424,15:00 - 16:59
summer,2012-05-16,17,104,769,873,7424,17:00 - 18:59
summer,2012-05-16,18,97,749,846,7424,17:00 - 18:59
summer,2012-05-16,19,91,499,590,7424,19:00 - 20:59
summer,2012-05-16,20,61,398,459,7424,19:00 - 20:59
summer,2012-05-16,21,63,330,393,7424,21:00 - 22:59
summer,2012-05-16,22,33,253,286,7424,21:00 - 22:59
summer,2012-05-16,23,26,107,133,7424,23:00 - 24:59
summer,2012-05-17,0,30,49,79,7384,
summer,2012-05-17,1,12,16,28,7384,01:00 - 02:59
summer,2012-05-17,2,8,8,16,7384,01:00 - 02:59
summer,2012-05-17,3,0,3,3,7384,03:00 - 04:59
summer,2012-05-17,4,3,13,16,7384,03:00 - 04:59
summer,2012-05-17,5,1,34,35,7384,05:00 - 06:59
summer,2012-05-17,6,10,149,159,7384,05:00 - 06:59
summer,2012-05-17,7,25,449,474,7384,07:00 - 08:59
summer,2012-05-17,8,29,605,634,7384,07:00 - 08:59
summer,2012-05-17,9,57,289,346,7384,09:00 - 10:59
summer,2012-05-17,10,43,162,205,7384,09:00 - 10:59
summer,2012-05-17,11,77,202,279,7384,11:00 - 12:59
summer,2012-05-17,12,72,276,348,7384,11:00 - 12:59
summer,2012-05-17,13,86,241,327,7384,13:00 - 14:59
summer,2012-05-17,14,68,202,270,7384,13:00 - 14:59
summer,2012-05-17,15,83,233,316,7384,15:00 - 16:59
summer,2012-05-17,16,86,344,430,7384,15:00 - 16:59
summer,2012-05-17,17,133,719,852,7384,17:00 - 18:59
summer,2012-05-17,18,134,734,868,7384,17:00 - 18:59
summer,2012-05-17,19,86,451,537,7384,19:00 - 20:59
summer,2012-05-17,20,83,363,446,7384,19:00 - 20:59
summer,2012-05-17,21,45,254,299,7384,21:00 - 22:59
summer,2012-05-17,22,42,209,251,7384,21:00 - 22:59
summer,2012-05-17,23,29,137,166,7384,23:00 - 24:59
summer,2012-05-18,0,13,57,70,7639,
summer,2012-05-18,1,16,33,49,7639,01:00 - 02:59
summer,2012-05-18,2,12,9,21,7639,01:00 - 02:59
summer,2012-05-18,3,6,8,14,7639,03:00 - 04:59
summer,2012-05-18,4,0,11,11,7639,03:00 - 04:59
summer,2012-05-18,5,1,33,34,7639,05:00 - 06:59
summer,2012-05-18,6,14,168,182,7639,05:00 - 06:59
summer,2012-05-18,7,40,475,515,7639,07:00 - 08:59
summer,2012-05-18,8,49,696,745,7639,07:00 - 08:59
summer,2012-05-18,9,57,304,361,7639,09:00 - 10:59
summer,2012-05-18,10,74,181,255,7639,09:00 - 10:59
summer,2012-05-18,11,109,225,334,7639,11:00 - 12:59
summer,2012-05-18,12,108,252,360,7639,11:00 - 12:59
summer,2012-05-18,13,98,297,395,7639,13:00 - 14:59
summer,2012-05-18,14,108,242,350,7639,13:00 - 14:59
summer,2012-05-18,15,131,260,391,7639,15:00 - 16:59
summer,2012-05-18,16,151,417,568,7639,15:00 - 16:59
summer,2012-05-18,17,124,688,812,7639,17:00 - 18:59
summer,2012-05-18,18,99,570,669,7639,17:00 - 18:59
summer,2012-05-18,19,91,392,483,7639,19:00 - 20:59
summer,2012-05-18,20,73,264,337,7639,19:00 - 20:59
summer,2012-05-18,21,49,209,258,7639,21:00 - 22:59
summer,2012-05-18,22,57,194,251,7639,21:00 - 22:59
summer,2012-05-18,23,41,133,174,7639,23:00 - 24:59
summer,2012-05-19,0,30,118,148,8294,
summer,2012-05-19,1,20,84,104,8294,01:00 - 02:59
summer,2012-05-19,2,13,56,69,8294,01:00 - 02:59
summer,2012-05-19,3,10,23,33,8294,03:00 - 04:59
summer,2012-05-19,4,6,8,14,8294,03:00 - 04:59
summer,2012-05-19,5,1,11,12,8294,05:00 - 06:59
summer,2012-05-19,6,12,38,50,8294,05:00 - 06:59
summer,2012-05-19,7,28,67,95,8294,07:00 - 08:59
summer,2012-05-19,8,33,162,195,8294,07:00 - 08:59
summer,2012-05-19,9,79,213,292,8294,09:00 - 10:59
summer,2012-05-19,10,177,275,452,8294,09:00 - 10:59
summer,2012-05-19,11,235,351,586,8294,11:00 - 12:59
summer,2012-05-19,12,276,366,642,8294,11:00 - 12:59
summer,2012-05-19,13,332,372,704,8294,13:00 - 14:59
summer,2012-05-19,14,361,369,730,8294,13:00 - 14:59
summer,2012-05-19,15,356,316,672,8294,15:00 - 16:59
summer,2012-05-19,16,331,311,642,8294,15:00 - 16:59
summer,2012-05-19,17,279,347,626,8294,17:00 - 18:59
summer,2012-05-19,18,254,391,645,8294,17:00 - 18:59
summer,2012-05-19,19,203,229,432,8294,19:00 - 20:59
summer,2012-05-19,20,118,197,315,8294,19:00 - 20:59
summer,2012-05-19,21,81,178,259,8294,21:00 - 22:59
summer,2012-05-19,22,104,234,338,8294,21:00 - 22:59
summer,2012-05-19,23,71,168,239,8294,23:00 - 24:59
summer,2012-05-20,0,42,128,170,7129,
summer,2012-05-20,1,28,102,130,7129,01:00 - 02:59
summer,2012-05-20,2,36,62,98,7129,01:00 - 02:59
summer,2012-05-20,3,26,40,66,7129,03:00 - 04:59
summer,2012-05-20,4,2,14,16,7129,03:00 - 04:59
summer,2012-05-20,5,1,7,8,7129,05:00 - 06:59
summer,2012-05-20,6,4,21,25,7129,05:00 - 06:59
summer,2012-05-20,7,35,55,90,7129,07:00 - 08:59
summer,2012-05-20,8,51,120,171,7129,07:00 - 08:59
summer,2012-05-20,9,129,184,313,7129,09:00 - 10:59
summer,2012-05-20,10,174,258,432,7129,09:00 - 10:59
summer,2012-05-20,11,258,323,581,7129,11:00 - 12:59
summer,2012-05-20,12,247,390,637,7129,11:00 - 12:59
summer,2012-05-20,13,244,363,607,7129,13:00 - 14:59
summer,2012-05-20,14,236,307,543,7129,13:00 - 14:59
summer,2012-05-20,15,246,256,502,7129,15:00 - 16:59
summer,2012-05-20,16,238,339,577,7129,15:00 - 16:59
summer,2012-05-20,17,209,340,549,7129,17:00 - 18:59
summer,2012-05-20,18,146,328,474,7129,17:00 - 18:59
summer,2012-05-20,19,142,260,402,7129,19:00 - 20:59
summer,2012-05-20,20,83,191,274,7129,19:00 - 20:59
summer,2012-05-20,21,51,182,233,7129,21:00 - 22:59
summer,2012-05-20,22,44,101,145,7129,21:00 - 22:59
summer,2012-05-20,23,32,54,86,7129,23:00 - 24:59
summer,2012-05-21,0,12,28,40,4359,
summer,2012-05-21,1,4,11,15,4359,01:00 - 02:59
summer,2012-05-21,2,2,9,11,4359,01:00 - 02:59
summer,2012-05-21,3,0,2,2,4359,03:00 - 04:59
summer,2012-05-21,4,2,5,7,4359,03:00 - 04:59
summer,2012-05-21,5,1,14,15,4359,05:00 - 06:59
summer,2012-05-21,6,3,76,79,4359,05:00 - 06:59
summer,2012-05-21,7,7,146,153,4359,07:00 - 08:59
summer,2012-05-21,8,12,258,270,4359,07:00 - 08:59
summer,2012-05-21,9,14,172,186,4359,09:00 - 10:59
summer,2012-05-21,10,28,71,99,4359,09:00 - 10:59
summer,2012-05-21,11,24,82,106,4359,11:00 - 12:59
summer,2012-05-21,12,46,124,170,4359,11:00 - 12:59
summer,2012-05-21,13,49,135,184,4359,13:00 - 14:59
summer,2012-05-21,14,45,135,180,4359,13:00 - 14:59
summer,2012-05-21,15,67,158,225,4359,15:00 - 16:59
summer,2012-05-21,16,46,269,315,4359,15:00 - 16:59
summer,2012-05-21,17,40,468,508,4359,17:00 - 18:59
summer,2012-05-21,18,52,478,530,4359,17:00 - 18:59
summer,2012-05-21,19,57,391,448,4359,19:00 - 20:59
summer,2012-05-21,20,44,292,336,4359,19:00 - 20:59
summer,2012-05-21,21,31,210,241,4359,21:00 - 22:59
summer,2012-05-21,22,26,116,142,4359,21:00 - 22:59
summer,2012-05-21,23,18,79,97,4359,23:00 - 24:59
summer,2012-05-22,0,10,26,36,6073,
summer,2012-05-22,1,11,16,27,6073,01:00 - 02:59
summer,2012-05-22,2,1,10,11,6073,01:00 - 02:59
summer,2012-05-22,3,0,5,5,6073,03:00 - 04:59
summer,2012-05-22,4,0,7,7,6073,03:00 - 04:59
summer,2012-05-22,5,0,17,17,6073,05:00 - 06:59
summer,2012-05-22,6,8,129,137,6073,05:00 - 06:59
summer,2012-05-22,7,9,315,324,6073,07:00 - 08:59
summer,2012-05-22,8,20,570,590,6073,07:00 - 08:59
summer,2012-05-22,9,46,287,333,6073,09:00 - 10:59
summer,2012-05-22,10,52,148,200,6073,09:00 - 10:59
summer,2012-05-22,11,39,150,189,6073,11:00 - 12:59
summer,2012-05-22,12,76,178,254,6073,11:00 - 12:59
summer,2012-05-22,13,48,195,243,6073,13:00 - 14:59
summer,2012-05-22,14,73,149,222,6073,13:00 - 14:59
summer,2012-05-22,15,54,191,245,6073,15:00 - 16:59
summer,2012-05-22,16,70,316,386,6073,15:00 - 16:59
summer,2012-05-22,17,69,716,785,6073,17:00 - 18:59
summer,2012-05-22,18,76,709,785,6073,17:00 - 18:59
summer,2012-05-22,19,44,320,364,6073,19:00 - 20:59
summer,2012-05-22,20,54,319,373,6073,19:00 - 20:59
summer,2012-05-22,21,28,233,261,6073,21:00 - 22:59
summer,2012-05-22,22,17,157,174,6073,21:00 - 22:59
summer,2012-05-22,23,14,91,105,6073,23:00 - 24:59
summer,2012-05-23,0,19,28,47,5260,
summer,2012-05-23,1,23,9,32,5260,01:00 - 02:59
summer,2012-05-23,2,2,10,12,5260,01:00 - 02:59
summer,2012-05-23,3,0,5,5,5260,03:00 - 04:59
summer,2012-05-23,4,0,3,3,5260,03:00 - 04:59
summer,2012-05-23,5,6,29,35,5260,05:00 - 06:59
summer,2012-05-23,6,6,154,160,5260,05:00 - 06:59
summer,2012-05-23,7,16,452,468,5260,07:00 - 08:59
summer,2012-05-23,8,38,681,719,5260,07:00 - 08:59
summer,2012-05-23,9,39,258,297,5260,09:00 - 10:59
summer,2012-05-23,10,52,139,191,5260,09:00 - 10:59
summer,2012-05-23,11,46,151,197,5260,11:00 - 12:59
summer,2012-05-23,12,42,206,248,5260,11:00 - 12:59
summer,2012-05-23,13,69,201,270,5260,13:00 - 14:59
summer,2012-05-23,14,67,181,248,5260,13:00 - 14:59
summer,2012-05-23,15,65,192,257,5260,15:00 - 16:59
summer,2012-05-23,16,62,216,278,5260,15:00 - 16:59
summer,2012-05-23,17,45,240,285,5260,17:00 - 18:59
summer,2012-05-23,18,31,296,327,5260,17:00 - 18:59
summer,2012-05-23,19,40,336,376,5260,19:00 - 20:59
summer,2012-05-23,20,28,267,295,5260,19:00 - 20:59
summer,2012-05-23,21,24,221,245,5260,21:00 - 22:59
summer,2012-05-23,22,23,136,159,5260,21:00 - 22:59
summer,2012-05-23,23,23,83,106,5260,23:00 - 24:59
summer,2012-05-24,0,7,49,56,6770,
summer,2012-05-24,1,9,21,30,6770,01:00 - 02:59
summer,2012-05-24,2,1,15,16,6770,01:00 - 02:59
summer,2012-05-24,3,1,3,4,6770,03:00 - 04:59
summer,2012-05-24,4,0,5,5,6770,03:00 - 04:59
summer,2012-05-24,5,1,29,30,6770,05:00 - 06:59
summer,2012-05-24,6,10,146,156,6770,05:00 - 06:59
summer,2012-05-24,7,22,393,415,6770,07:00 - 08:59
summer,2012-05-24,8,33,659,692,6770,07:00 - 08:59
summer,2012-05-24,9,34,267,301,6770,09:00 - 10:59
summer,2012-05-24,10,47,138,185,6770,09:00 - 10:59
summer,2012-05-24,11,61,160,221,6770,11:00 - 12:59
summer,2012-05-24,12,76,213,289,6770,11:00 - 12:59
summer,2012-05-24,13,69,233,302,6770,13:00 - 14:59
summer,2012-05-24,14,72,180,252,6770,13:00 - 14:59
summer,2012-05-24,15,69,222,291,6770,15:00 - 16:59
summer,2012-05-24,16,61,329,390,6770,15:00 - 16:59
summer,2012-05-24,17,120,678,798,6770,17:00 - 18:59
summer,2012-05-24,18,118,634,752,6770,17:00 - 18:59
summer,2012-05-24,19,76,416,492,6770,19:00 - 20:59
summer,2012-05-24,20,55,343,398,6770,19:00 - 20:59
summer,2012-05-24,21,48,237,285,6770,21:00 - 22:59
summer,2012-05-24,22,33,210,243,6770,21:00 - 22:59
summer,2012-05-24,23,36,131,167,6770,23:00 - 24:59
summer,2012-05-25,0,10,63,73,6734,
summer,2012-05-25,1,8,34,42,6734,01:00 - 02:59
summer,2012-05-25,2,7,16,23,6734,01:00 - 02:59
summer,2012-05-25,3,8,6,14,6734,03:00 - 04:59
summer,2012-05-25,4,3,6,9,6734,03:00 - 04:59
summer,2012-05-25,5,2,28,30,6734,05:00 - 06:59
summer,2012-05-25,6,5,108,113,6734,05:00 - 06:59
summer,2012-05-25,7,7,352,359,6734,07:00 - 08:59
summer,2012-05-25,8,32,551,583,6734,07:00 - 08:59
summer,2012-05-25,9,52,288,340,6734,09:00 - 10:59
summer,2012-05-25,10,69,163,232,6734,09:00 - 10:59
summer,2012-05-25,11,90,193,283,6734,11:00 - 12:59
summer,2012-05-25,12,84,237,321,6734,11:00 - 12:59
summer,2012-05-25,13,86,247,333,6734,13:00 - 14:59
summer,2012-05-25,14,104,263,367,6734,13:00 - 14:59
summer,2012-05-25,15,106,360,466,6734,15:00 - 16:59
summer,2012-05-25,16,137,447,584,6734,15:00 - 16:59
summer,2012-05-25,17,124,529,653,6734,17:00 - 18:59
summer,2012-05-25,18,131,391,522,6734,17:00 - 18:59
summer,2012-05-25,19,111,293,404,6734,19:00 - 20:59
summer,2012-05-25,20,80,270,350,6734,19:00 - 20:59
summer,2012-05-25,21,62,193,255,6734,21:00 - 22:59
summer,2012-05-25,22,65,147,212,6734,21:00 - 22:59
summer,2012-05-25,23,34,132,166,6734,23:00 - 24:59
summer,2012-05-26,0,18,98,116,6536,
summer,2012-05-26,1,18,64,82,6536,01:00 - 02:59
summer,2012-05-26,2,9,55,64,6536,01:00 - 02:59
summer,2012-05-26,3,9,22,31,6536,03:00 - 04:59
summer,2012-05-26,4,0,2,2,6536,03:00 - 04:59
summer,2012-05-26,5,0,10,10,6536,05:00 - 06:59
summer,2012-05-26,6,6,25,31,6536,05:00 - 06:59
summer,2012-05-26,7,10,44,54,6536,07:00 - 08:59
summer,2012-05-26,8,38,103,141,6536,07:00 - 08:59
summer,2012-05-26,9,97,192,289,6536,09:00 - 10:59
summer,2012-05-26,10,181,256,437,6536,09:00 - 10:59
summer,2012-05-26,11,208,312,520,6536,11:00 - 12:59
summer,2012-05-26,12,236,293,529,6536,11:00 - 12:59
summer,2012-05-26,13,265,274,539,6536,13:00 - 14:59
summer,2012-05-26,14,307,257,564,6536,13:00 - 14:59
summer,2012-05-26,15,274,239,513,6536,15:00 - 16:59
summer,2012-05-26,16,261,243,504,6536,15:00 - 16:59
summer,2012-05-26,17,235,227,462,6536,17:00 - 18:59
summer,2012-05-26,18,199,216,415,6536,17:00 - 18:59
summer,2012-05-26,19,159,214,373,6536,19:00 - 20:59
summer,2012-05-26,20,103,152,255,6536,19:00 - 20:59
summer,2012-05-26,21,100,151,251,6536,21:00 - 22:59
summer,2012-05-26,22,86,118,204,6536,21:00 - 22:59
summer,2012-05-26,23,36,114,150,6536,23:00 - 24:59
summer,2012-05-27,0,48,89,137,6591,
summer,2012-05-27,1,17,61,78,6591,01:00 - 02:59
summer,2012-05-27,2,16,45,61,6591,01:00 - 02:59
summer,2012-05-27,3,11,25,36,6591,03:00 - 04:59
summer,2012-05-27,4,4,7,11,6591,03:00 - 04:59
summer,2012-05-27,5,2,5,7,6591,05:00 - 06:59
summer,2012-05-27,6,8,14,22,6591,05:00 - 06:59
summer,2012-05-27,7,22,30,52,6591,07:00 - 08:59
summer,2012-05-27,8,69,82,151,6591,07:00 - 08:59
summer,2012-05-27,9,130,140,270,6591,09:00 - 10:59
summer,2012-05-27,10,209,215,424,6591,09:00 - 10:59
summer,2012-05-27,11,268,251,519,6591,11:00 - 12:59
summer,2012-05-27,12,301,269,570,6591,11:00 - 12:59
summer,2012-05-27,13,270,228,498,6591,13:00 - 14:59
summer,2012-05-27,14,317,230,547,6591,13:00 - 14:59
summer,2012-05-27,15,290,245,535,6591,15:00 - 16:59
summer,2012-05-27,16,258,243,501,6591,15:00 - 16:59
summer,2012-05-27,17,275,247,522,6591,17:00 - 18:59
summer,2012-05-27,18,266,252,518,6591,17:00 - 18:59
summer,2012-05-27,19,230,212,442,6591,19:00 - 20:59
summer,2012-05-27,20,168,224,392,6591,19:00 - 20:59
summer,2012-05-27,21,64,79,143,6591,21:00 - 22:59
summer,2012-05-27,22,9,50,59,6591,21:00 - 22:59
summer,2012-05-27,23,31,65,96,6591,23:00 - 24:59
summer,2012-05-28,0,21,44,65,6043,
summer,2012-05-28,1,14,45,59,6043,01:00 - 02:59
summer,2012-05-28,2,20,28,48,6043,01:00 - 02:59
summer,2012-05-28,3,6,12,18,6043,03:00 - 04:59
summer,2012-05-28,4,2,4,6,6043,03:00 - 04:59
summer,2012-05-28,5,4,5,9,6043,05:00 - 06:59
summer,2012-05-28,6,6,14,20,6043,05:00 - 06:59
summer,2012-05-28,7,24,43,67,6043,07:00 - 08:59
summer,2012-05-28,8,62,93,155,6043,07:00 - 08:59
summer,2012-05-28,9,121,142,263,6043,09:00 - 10:59
summer,2012-05-28,10,189,175,364,6043,09:00 - 10:59
summer,2012-05-28,11,254,222,476,6043,11:00 - 12:59
summer,2012-05-28,12,233,292,525,6043,11:00 - 12:59
summer,2012-05-28,13,272,284,556,6043,13:00 - 14:59
summer,2012-05-28,14,238,227,465,6043,13:00 - 14:59
summer,2012-05-28,15,181,279,460,6043,15:00 - 16:59
summer,2012-05-28,16,223,278,501,6043,15:00 - 16:59
summer,2012-05-28,17,158,247,405,6043,17:00 - 18:59
summer,2012-05-28,18,132,251,383,6043,17:00 - 18:59
summer,2012-05-28,19,148,247,395,6043,19:00 - 20:59
summer,2012-05-28,20,114,203,317,6043,19:00 - 20:59
summer,2012-05-28,21,66,181,247,6043,21:00 - 22:59
summer,2012-05-28,22,47,110,157,6043,21:00 - 22:59
summer,2012-05-28,23,22,60,82,6043,23:00 - 24:59
summer,2012-05-29,0,12,33,45,5743,
summer,2012-05-29,1,1,13,14,5743,01:00 - 02:59
summer,2012-05-29,2,0,8,8,5743,01:00 - 02:59
summer,2012-05-29,3,1,2,3,5743,03:00 - 04:59
summer,2012-05-29,4,0,5,5,5743,03:00 - 04:59
summer,2012-05-29,5,1,32,33,5743,05:00 - 06:59
summer,2012-05-29,6,9,145,154,5743,05:00 - 06:59
summer,2012-05-29,7,19,431,450,5743,07:00 - 08:59
summer,2012-05-29,8,46,588,634,5743,07:00 - 08:59
summer,2012-05-29,9,26,231,257,5743,09:00 - 10:59
summer,2012-05-29,10,67,116,183,5743,09:00 - 10:59
summer,2012-05-29,11,50,147,197,5743,11:00 - 12:59
summer,2012-05-29,12,56,181,237,5743,11:00 - 12:59
summer,2012-05-29,13,63,176,239,5743,13:00 - 14:59
summer,2012-05-29,14,80,158,238,5743,13:00 - 14:59
summer,2012-05-29,15,71,185,256,5743,15:00 - 16:59
summer,2012-05-29,16,73,320,393,5743,15:00 - 16:59
summer,2012-05-29,17,107,674,781,5743,17:00 - 18:59
summer,2012-05-29,18,78,632,710,5743,17:00 - 18:59
summer,2012-05-29,19,69,457,526,5743,19:00 - 20:59
summer,2012-05-29,20,36,168,204,5743,19:00 - 20:59
summer,2012-05-29,21,3,68,71,5743,21:00 - 22:59
summer,2012-05-29,22,2,53,55,5743,21:00 - 22:59
summer,2012-05-29,23,10,40,50,5743,23:00 - 24:59
summer,2012-05-30,0,4,32,36,6855,
summer,2012-05-30,1,0,4,4,6855,01:00 - 02:59
summer,2012-05-30,2,1,4,5,6855,01:00 - 02:59
summer,2012-05-30,3,0,5,5,6855,03:00 - 04:59
summer,2012-05-30,4,0,6,6,6855,03:00 - 04:59
summer,2012-05-30,5,1,40,41,6855,05:00 - 06:59
summer,2012-05-30,6,5,139,144,6855,05:00 - 06:59
summer,2012-05-30,7,14,469,483,6855,07:00 - 08:59
summer,2012-05-30,8,29,642,671,6855,07:00 - 08:59
summer,2012-05-30,9,23,282,305,6855,09:00 - 10:59
summer,2012-05-30,10,39,138,177,6855,09:00 - 10:59
summer,2012-05-30,11,53,155,208,6855,11:00 - 12:59
summer,2012-05-30,12,33,220,253,6855,11:00 - 12:59
summer,2012-05-30,13,53,236,289,6855,13:00 - 14:59
summer,2012-05-30,14,44,208,252,6855,13:00 - 14:59
summer,2012-05-30,15,54,221,275,6855,15:00 - 16:59
summer,2012-05-30,16,46,352,398,6855,15:00 - 16:59
summer,2012-05-30,17,83,756,839,6855,17:00 - 18:59
summer,2012-05-30,18,50,746,796,6855,17:00 - 18:59
summer,2012-05-30,19,50,506,556,6855,19:00 - 20:59
summer,2012-05-30,20,57,374,431,6855,19:00 - 20:59
summer,2012-05-30,21,41,263,304,6855,21:00 - 22:59
summer,2012-05-30,22,26,191,217,6855,21:00 - 22:59
summer,2012-05-30,23,39,121,160,6855,23:00 - 24:59
summer,2012-05-31,0,13,48,61,7338,
summer,2012-05-31,1,4,22,26,7338,01:00 - 02:59
summer,2012-05-31,2,6,8,14,7338,01:00 - 02:59
summer,2012-05-31,3,0,8,8,7338,03:00 - 04:59
summer,2012-05-31,4,0,8,8,7338,03:00 - 04:59
summer,2012-05-31,5,1,32,33,7338,05:00 - 06:59
summer,2012-05-31,6,7,171,178,7338,05:00 - 06:59
summer,2012-05-31,7,18,489,507,7338,07:00 - 08:59
summer,2012-05-31,8,18,675,693,7338,07:00 - 08:59
summer,2012-05-31,9,47,264,311,7338,09:00 - 10:59
summer,2012-05-31,10,65,155,220,7338,09:00 - 10:59
summer,2012-05-31,11,65,153,218,7338,11:00 - 12:59
summer,2012-05-31,12,62,230,292,7338,11:00 - 12:59
summer,2012-05-31,13,77,216,293,7338,13:00 - 14:59
summer,2012-05-31,14,61,193,254,7338,13:00 - 14:59
summer,2012-05-31,15,81,209,290,7338,15:00 - 16:59
summer,2012-05-31,16,103,384,487,7338,15:00 - 16:59
summer,2012-05-31,17,85,742,827,7338,17:00 - 18:59
summer,2012-05-31,18,85,700,785,7338,17:00 - 18:59
summer,2012-05-31,19,104,487,591,7338,19:00 - 20:59
summer,2012-05-31,20,88,391,479,7338,19:00 - 20:59
summer,2012-05-31,21,41,318,359,7338,21:00 - 22:59
summer,2012-05-31,22,43,221,264,7338,21:00 - 22:59
summer,2012-05-31,23,26,114,140,7338,23:00 - 24:59
summer,2012-06-01,0,10,76,86,4127,
summer,2012-06-01,1,0,34,34,4127,01:00 - 02:59
summer,2012-06-01,2,3,13,16,4127,01:00 - 02:59
summer,2012-06-01,3,0,4,4,4127,03:00 - 04:59
summer,2012-06-01,4,1,5,6,4127,03:00 - 04:59
summer,2012-06-01,5,4,41,45,4127,05:00 - 06:59
summer,2012-06-01,6,5,136,141,4127,05:00 - 06:59
summer,2012-06-01,7,33,369,402,4127,07:00 - 08:59
summer,2012-06-01,8,19,675,694,4127,07:00 - 08:59
summer,2012-06-01,9,24,274,298,4127,09:00 - 10:59
summer,2012-06-01,10,49,155,204,4127,09:00 - 10:59
summer,2012-06-01,11,42,193,235,4127,11:00 - 12:59
summer,2012-06-01,12,72,238,310,4127,11:00 - 12:59
summer,2012-06-01,13,76,240,316,4127,13:00 - 14:59
summer,2012-06-01,14,55,199,254,4127,13:00 - 14:59
summer,2012-06-01,15,45,213,258,4127,15:00 - 16:59
summer,2012-06-01,16,36,186,222,4127,15:00 - 16:59
summer,2012-06-01,17,25,202,227,4127,17:00 - 18:59
summer,2012-06-01,18,10,100,110,4127,17:00 - 18:59
summer,2012-06-01,19,4,41,45,4127,19:00 - 20:59
summer,2012-06-01,20,1,38,39,4127,19:00 - 20:59
summer,2012-06-01,21,12,73,85,4127,21:00 - 22:59
summer,2012-06-01,22,1,22,23,4127,21:00 - 22:59
summer,2012-06-01,23,6,67,73,4127,23:00 - 24:59
summer,2012-06-02,0,5,81,86,8120,
summer,2012-06-02,1,15,61,76,8120,01:00 - 02:59
summer,2012-06-02,2,3,38,41,8120,01:00 - 02:59
summer,2012-06-02,3,8,18,26,8120,03:00 - 04:59
summer,2012-06-02,4,2,11,13,8120,03:00 - 04:59
summer,2012-06-02,5,1,11,12,8120,05:00 - 06:59
summer,2012-06-02,6,5,31,36,8120,05:00 - 06:59
summer,2012-06-02,7,9,77,86,8120,07:00 - 08:59
summer,2012-06-02,8,30,180,210,8120,07:00 - 08:59
summer,2012-06-02,9,89,243,332,8120,09:00 - 10:59
summer,2012-06-02,10,145,348,493,8120,09:00 - 10:59
summer,2012-06-02,11,179,357,536,8120,11:00 - 12:59
summer,2012-06-02,12,250,418,668,8120,11:00 - 12:59
summer,2012-06-02,13,279,400,679,8120,13:00 - 14:59
summer,2012-06-02,14,259,388,647,8120,13:00 - 14:59
summer,2012-06-02,15,297,405,702,8120,15:00 - 16:59
summer,2012-06-02,16,275,369,644,8120,15:00 - 16:59
summer,2012-06-02,17,248,338,586,8120,17:00 - 18:59
summer,2012-06-02,18,171,341,512,8120,17:00 - 18:59
summer,2012-06-02,19,185,369,554,8120,19:00 - 20:59
summer,2012-06-02,20,139,260,399,8120,19:00 - 20:59
summer,2012-06-02,21,96,220,316,8120,21:00 - 22:59
summer,2012-06-02,22,52,176,228,8120,21:00 - 22:59
summer,2012-06-02,23,53,185,238,8120,23:00 - 24:59
summer,2012-06-03,0,27,142,169,7641,
summer,2012-06-03,1,21,100,121,7641,01:00 - 02:59
summer,2012-06-03,2,22,67,89,7641,01:00 - 02:59
summer,2012-06-03,3,16,34,50,7641,03:00 - 04:59
summer,2012-06-03,4,1,12,13,7641,03:00 - 04:59
summer,2012-06-03,5,1,11,12,7641,05:00 - 06:59
summer,2012-06-03,6,6,16,22,7641,05:00 - 06:59
summer,2012-06-03,7,6,29,35,7641,07:00 - 08:59
summer,2012-06-03,8,30,110,140,7641,07:00 - 08:59
summer,2012-06-03,9,70,230,300,7641,09:00 - 10:59
summer,2012-06-03,10,127,277,404,7641,09:00 - 10:59
summer,2012-06-03,11,199,312,511,7641,11:00 - 12:59
summer,2012-06-03,12,276,408,684,7641,11:00 - 12:59
summer,2012-06-03,13,265,421,686,7641,13:00 - 14:59
summer,2012-06-03,14,267,411,678,7641,13:00 - 14:59
summer,2012-06-03,15,236,408,644,7641,15:00 - 16:59
summer,2012-06-03,16,226,436,662,7641,15:00 - 16:59
summer,2012-06-03,17,192,386,578,7641,17:00 - 18:59
summer,2012-06-03,18,153,343,496,7641,17:00 - 18:59
summer,2012-06-03,19,116,337,453,7641,19:00 - 20:59
summer,2012-06-03,20,84,230,314,7641,19:00 - 20:59
summer,2012-06-03,21,66,180,246,7641,21:00 - 22:59
summer,2012-06-03,22,61,165,226,7641,21:00 - 22:59
summer,2012-06-03,23,26,82,108,7641,23:00 - 24:59
summer,2012-06-04,0,11,38,49,6998,
summer,2012-06-04,1,4,10,14,6998,01:00 - 02:59
summer,2012-06-04,2,1,10,11,6998,01:00 - 02:59
summer,2012-06-04,3,0,5,5,6998,03:00 - 04:59
summer,2012-06-04,4,2,6,8,6998,03:00 - 04:59
summer,2012-06-04,5,2,33,35,6998,05:00 - 06:59
summer,2012-06-04,6,4,135,139,6998,05:00 - 06:59
summer,2012-06-04,7,13,504,517,6998,07:00 - 08:59
summer,2012-06-04,8,22,643,665,6998,07:00 - 08:59
summer,2012-06-04,9,38,244,282,6998,09:00 - 10:59
summer,2012-06-04,10,67,120,187,6998,09:00 - 10:59
summer,2012-06-04,11,71,168,239,6998,11:00 - 12:59
summer,2012-06-04,12,62,220,282,6998,11:00 - 12:59
summer,2012-06-04,13,85,189,274,6998,13:00 - 14:59
summer,2012-06-04,14,84,186,270,6998,13:00 - 14:59
summer,2012-06-04,15,77,215,292,6998,15:00 - 16:59
summer,2012-06-04,16,73,375,448,6998,15:00 - 16:59
summer,2012-06-04,17,101,733,834,6998,17:00 - 18:59
summer,2012-06-04,18,103,719,822,6998,17:00 - 18:59
summer,2012-06-04,19,91,554,645,6998,19:00 - 20:59
summer,2012-06-04,20,71,390,461,6998,19:00 - 20:59
summer,2012-06-04,21,40,225,265,6998,21:00 - 22:59
summer,2012-06-04,22,41,127,168,6998,21:00 - 22:59
summer,2012-06-04,23,8,78,86,6998,23:00 - 24:59
summer,2012-06-05,0,6,28,34,7001,
summer,2012-06-05,1,2,18,20,7001,01:00 - 02:59
summer,2012-06-05,2,0,8,8,7001,01:00 - 02:59
summer,2012-06-05,3,0,5,5,7001,03:00 - 04:59
summer,2012-06-05,4,1,4,5,7001,03:00 - 04:59
summer,2012-06-05,5,1,35,36,7001,05:00 - 06:59
summer,2012-06-05,6,7,177,184,7001,05:00 - 06:59
summer,2012-06-05,7,29,540,569,7001,07:00 - 08:59
summer,2012-06-05,8,30,680,710,7001,07:00 - 08:59
summer,2012-06-05,9,50,285,335,7001,09:00 - 10:59
summer,2012-06-05,10,58,118,176,7001,09:00 - 10:59
summer,2012-06-05,11,65,162,227,7001,11:00 - 12:59
summer,2012-06-05,12,45,202,247,7001,11:00 - 12:59
summer,2012-06-05,13,66,201,267,7001,13:00 - 14:59
summer,2012-06-05,14,82,194,276,7001,13:00 - 14:59
summer,2012-06-05,15,54,218,272,7001,15:00 - 16:59
summer,2012-06-05,16,91,382,473,7001,15:00 - 16:59
summer,2012-06-05,17,86,764,850,7001,17:00 - 18:59
summer,2012-06-05,18,111,679,790,7001,17:00 - 18:59
summer,2012-06-05,19,68,445,513,7001,19:00 - 20:59
summer,2012-06-05,20,44,371,415,7001,19:00 - 20:59
summer,2012-06-05,21,30,253,283,7001,21:00 - 22:59
summer,2012-06-05,22,22,171,193,7001,21:00 - 22:59
summer,2012-06-05,23,20,93,113,7001,23:00 - 24:59
summer,2012-06-06,0,3,46,49,7055,
summer,2012-06-06,1,6,21,27,7055,01:00 - 02:59
summer,2012-06-06,2,4,7,11,7055,01:00 - 02:59
summer,2012-06-06,3,0,8,8,7055,03:00 - 04:59
summer,2012-06-06,4,3,7,10,7055,03:00 - 04:59
summer,2012-06-06,5,1,37,38,7055,05:00 - 06:59
summer,2012-06-06,6,7,165,172,7055,05:00 - 06:59
summer,2012-06-06,7,16,531,547,7055,07:00 - 08:59
summer,2012-06-06,8,31,637,668,7055,07:00 - 08:59
summer,2012-06-06,9,35,268,303,7055,09:00 - 10:59
summer,2012-06-06,10,55,148,203,7055,09:00 - 10:59
summer,2012-06-06,11,65,161,226,7055,11:00 - 12:59
summer,2012-06-06,12,80,235,315,7055,11:00 - 12:59
summer,2012-06-06,13,73,230,303,7055,13:00 - 14:59
summer,2012-06-06,14,111,191,302,7055,13:00 - 14:59
summer,2012-06-06,15,75,225,300,7055,15:00 - 16:59
summer,2012-06-06,16,107,345,452,7055,15:00 - 16:59
summer,2012-06-06,17,72,652,724,7055,17:00 - 18:59
summer,2012-06-06,18,94,688,782,7055,17:00 - 18:59
summer,2012-06-06,19,52,486,538,7055,19:00 - 20:59
summer,2012-06-06,20,59,349,408,7055,19:00 - 20:59
summer,2012-06-06,21,38,260,298,7055,21:00 - 22:59
summer,2012-06-06,22,27,221,248,7055,21:00 - 22:59
summer,2012-06-06,23,13,110,123,7055,23:00 - 24:59
summer,2012-06-07,0,9,50,59,7494,
summer,2012-06-07,1,5,17,22,7494,01:00 - 02:59
summer,2012-06-07,2,0,12,12,7494,01:00 - 02:59
summer,2012-06-07,3,0,5,5,7494,03:00 - 04:59
summer,2012-06-07,4,0,6,6,7494,03:00 - 04:59
summer,2012-06-07,5,0,34,34,7494,05:00 - 06:59
summer,2012-06-07,6,5,165,170,7494,05:00 - 06:59
summer,2012-06-07,7,20,506,526,7494,07:00 - 08:59
summer,2012-06-07,8,20,661,681,7494,07:00 - 08:59
summer,2012-06-07,9,37,300,337,7494,09:00 - 10:59
summer,2012-06-07,10,56,154,210,7494,09:00 - 10:59
summer,2012-06-07,11,67,170,237,7494,11:00 - 12:59
summer,2012-06-07,12,62,274,336,7494,11:00 - 12:59
summer,2012-06-07,13,65,250,315,7494,13:00 - 14:59
summer,2012-06-07,14,67,198,265,7494,13:00 - 14:59
summer,2012-06-07,15,99,234,333,7494,15:00 - 16:59
summer,2012-06-07,16,77,389,466,7494,15:00 - 16:59
summer,2012-06-07,17,91,778,869,7494,17:00 - 18:59
summer,2012-06-07,18,110,703,813,7494,17:00 - 18:59
summer,2012-06-07,19,65,537,602,7494,19:00 - 20:59
summer,2012-06-07,20,76,402,478,7494,19:00 - 20:59
summer,2012-06-07,21,30,283,313,7494,21:00 - 22:59
summer,2012-06-07,22,35,193,228,7494,21:00 - 22:59
summer,2012-06-07,23,42,135,177,7494,23:00 - 24:59
summer,2012-06-08,0,18,59,77,7736,
summer,2012-06-08,1,4,25,29,7736,01:00 - 02:59
summer,2012-06-08,2,2,17,19,7736,01:00 - 02:59
summer,2012-06-08,3,0,8,8,7736,03:00 - 04:59
summer,2012-06-08,4,1,9,10,7736,03:00 - 04:59
summer,2012-06-08,5,1,28,29,7736,05:00 - 06:59
summer,2012-06-08,6,8,131,139,7736,05:00 - 06:59
summer,2012-06-08,7,19,409,428,7736,07:00 - 08:59
summer,2012-06-08,8,37,663,700,7736,07:00 - 08:59
summer,2012-06-08,9,47,335,382,7736,09:00 - 10:59
summer,2012-06-08,10,62,187,249,7736,09:00 - 10:59
summer,2012-06-08,11,65,199,264,7736,11:00 - 12:59
summer,2012-06-08,12,89,280,369,7736,11:00 - 12:59
summer,2012-06-08,13,129,287,416,7736,13:00 - 14:59
summer,2012-06-08,14,128,245,373,7736,13:00 - 14:59
summer,2012-06-08,15,98,299,397,7736,15:00 - 16:59
summer,2012-06-08,16,111,412,523,7736,15:00 - 16:59
summer,2012-06-08,17,114,679,793,7736,17:00 - 18:59
summer,2012-06-08,18,147,576,723,7736,17:00 - 18:59
summer,2012-06-08,19,95,460,555,7736,19:00 - 20:59
summer,2012-06-08,20,117,291,408,7736,19:00 - 20:59
summer,2012-06-08,21,83,256,339,7736,21:00 - 22:59
summer,2012-06-08,22,61,230,291,7736,21:00 - 22:59
summer,2012-06-08,23,52,163,215,7736,23:00 - 24:59
summer,2012-06-09,0,54,152,206,7498,
summer,2012-06-09,1,34,89,123,7498,01:00 - 02:59
summer,2012-06-09,2,21,68,89,7498,01:00 - 02:59
summer,2012-06-09,3,12,28,40,7498,03:00 - 04:59
summer,2012-06-09,4,2,6,8,7498,03:00 - 04:59
summer,2012-06-09,5,4,15,19,7498,05:00 - 06:59
summer,2012-06-09,6,17,63,80,7498,05:00 - 06:59
summer,2012-06-09,7,26,61,87,7498,07:00 - 08:59
summer,2012-06-09,8,42,202,244,7498,07:00 - 08:59
summer,2012-06-09,9,99,241,340,7498,09:00 - 10:59
summer,2012-06-09,10,168,298,466,7498,09:00 - 10:59
summer,2012-06-09,11,218,351,569,7498,11:00 - 12:59
summer,2012-06-09,12,196,335,531,7498,11:00 - 12:59
summer,2012-06-09,13,236,349,585,7498,13:00 - 14:59
summer,2012-06-09,14,239,354,593,7498,13:00 - 14:59
summer,2012-06-09,15,218,337,555,7498,15:00 - 16:59
summer,2012-06-09,16,219,315,534,7498,15:00 - 16:59
summer,2012-06-09,17,238,257,495,7498,17:00 - 18:59
summer,2012-06-09,18,175,276,451,7498,17:00 - 18:59
summer,2012-06-09,19,128,232,360,7498,19:00 - 20:59
summer,2012-06-09,20,125,238,363,7498,19:00 - 20:59
summer,2012-06-09,21,105,211,316,7498,21:00 - 22:59
summer,2012-06-09,22,63,151,214,7498,21:00 - 22:59
summer,2012-06-09,23,69,161,230,7498,23:00 - 24:59
summer,2012-06-10,0,33,125,158,6598,
summer,2012-06-10,1,32,84,116,6598,01:00 - 02:59
summer,2012-06-10,2,17,56,73,6598,01:00 - 02:59
summer,2012-06-10,3,6,23,29,6598,03:00 - 04:59
summer,2012-06-10,4,1,9,10,6598,03:00 - 04:59
summer,2012-06-10,5,3,10,13,6598,05:00 - 06:59
summer,2012-06-10,6,3,27,30,6598,05:00 - 06:59
summer,2012-06-10,7,21,41,62,6598,07:00 - 08:59
summer,2012-06-10,8,59,122,181,6598,07:00 - 08:59
summer,2012-06-10,9,91,175,266,6598,09:00 - 10:59
summer,2012-06-10,10,148,265,413,6598,09:00 - 10:59
summer,2012-06-10,11,184,315,499,6598,11:00 - 12:59
summer,2012-06-10,12,173,329,502,6598,11:00 - 12:59
summer,2012-06-10,13,204,288,492,6598,13:00 - 14:59
summer,2012-06-10,14,186,314,500,6598,13:00 - 14:59
summer,2012-06-10,15,159,316,475,6598,15:00 - 16:59
summer,2012-06-10,16,173,335,508,6598,15:00 - 16:59
summer,2012-06-10,17,184,337,521,6598,17:00 - 18:59
summer,2012-06-10,18,164,326,490,6598,17:00 - 18:59
summer,2012-06-10,19,115,260,375,6598,19:00 - 20:59
summer,2012-06-10,20,113,250,363,6598,19:00 - 20:59
summer,2012-06-10,21,83,170,253,6598,21:00 - 22:59
summer,2012-06-10,22,42,117,159,6598,21:00 - 22:59
summer,2012-06-10,23,30,80,110,6598,23:00 - 24:59
summer,2012-06-11,0,8,33,41,6664,
summer,2012-06-11,1,9,15,24,6664,01:00 - 02:59
summer,2012-06-11,2,5,12,17,6664,01:00 - 02:59
summer,2012-06-11,3,2,4,6,6664,03:00 - 04:59
summer,2012-06-11,4,0,7,7,6664,03:00 - 04:59
summer,2012-06-11,5,1,36,37,6664,05:00 - 06:59
summer,2012-06-11,6,8,136,144,6664,05:00 - 06:59
summer,2012-06-11,7,25,478,503,6664,07:00 - 08:59
summer,2012-06-11,8,38,613,651,6664,07:00 - 08:59
summer,2012-06-11,9,57,259,316,6664,09:00 - 10:59
summer,2012-06-11,10,52,95,147,6664,09:00 - 10:59
summer,2012-06-11,11,59,143,202,6664,11:00 - 12:59
summer,2012-06-11,12,63,198,261,6664,11:00 - 12:59
summer,2012-06-11,13,63,185,248,6664,13:00 - 14:59
summer,2012-06-11,14,66,193,259,6664,13:00 - 14:59
summer,2012-06-11,15,72,187,259,6664,15:00 - 16:59
summer,2012-06-11,16,87,340,427,6664,15:00 - 16:59
summer,2012-06-11,17,85,715,800,6664,17:00 - 18:59
summer,2012-06-11,18,105,726,831,6664,17:00 - 18:59
summer,2012-06-11,19,89,507,596,6664,19:00 - 20:59
summer,2012-06-11,20,61,333,394,6664,19:00 - 20:59
summer,2012-06-11,21,32,218,250,6664,21:00 - 22:59
summer,2012-06-11,22,22,142,164,6664,21:00 - 22:59
summer,2012-06-11,23,8,72,80,6664,23:00 - 24:59
summer,2012-06-12,0,2,26,28,4972,
summer,2012-06-12,1,5,11,16,4972,01:00 - 02:59
summer,2012-06-12,2,0,6,6,4972,01:00 - 02:59
summer,2012-06-12,3,3,9,12,4972,03:00 - 04:59
summer,2012-06-12,4,0,4,4,4972,03:00 - 04:59
summer,2012-06-12,5,1,28,29,4972,05:00 - 06:59
summer,2012-06-12,6,6,130,136,4972,05:00 - 06:59
summer,2012-06-12,7,16,287,303,4972,07:00 - 08:59
summer,2012-06-12,8,15,598,613,4972,07:00 - 08:59
summer,2012-06-12,9,31,254,285,4972,09:00 - 10:59
summer,2012-06-12,10,29,96,125,4972,09:00 - 10:59
summer,2012-06-12,11,8,57,65,4972,11:00 - 12:59
summer,2012-06-12,12,19,76,95,4972,11:00 - 12:59
summer,2012-06-12,13,11,48,59,4972,13:00 - 14:59
summer,2012-06-12,14,12,48,60,4972,13:00 - 14:59
summer,2012-06-12,15,22,94,116,4972,15:00 - 16:59
summer,2012-06-12,16,30,209,239,4972,15:00 - 16:59
summer,2012-06-12,17,56,625,681,4972,17:00 - 18:59
summer,2012-06-12,18,57,596,653,4972,17:00 - 18:59
summer,2012-06-12,19,47,444,491,4972,19:00 - 20:59
summer,2012-06-12,20,36,350,386,4972,19:00 - 20:59
summer,2012-06-12,21,41,233,274,4972,21:00 - 22:59
summer,2012-06-12,22,19,188,207,4972,21:00 - 22:59
summer,2012-06-12,23,11,78,89,4972,23:00 - 24:59
summer,2012-06-13,0,7,27,34,7421,
summer,2012-06-13,1,7,21,28,7421,01:00 - 02:59
summer,2012-06-13,2,0,4,4,7421,01:00 - 02:59
summer,2012-06-13,3,1,7,8,7421,03:00 - 04:59
summer,2012-06-13,4,1,9,10,7421,03:00 - 04:59
summer,2012-06-13,5,2,38,40,7421,05:00 - 06:59
summer,2012-06-13,6,6,188,194,7421,05:00 - 06:59
summer,2012-06-13,7,25,480,505,7421,07:00 - 08:59
summer,2012-06-13,8,41,672,713,7421,07:00 - 08:59
summer,2012-06-13,9,54,298,352,7421,09:00 - 10:59
summer,2012-06-13,10,64,134,198,7421,09:00 - 10:59
summer,2012-06-13,11,64,182,246,7421,11:00 - 12:59
summer,2012-06-13,12,93,241,334,7421,11:00 - 12:59
summer,2012-06-13,13,52,203,255,7421,13:00 - 14:59
summer,2012-06-13,14,98,222,320,7421,13:00 - 14:59
summer,2012-06-13,15,65,216,281,7421,15:00 - 16:59
summer,2012-06-13,16,72,320,392,7421,15:00 - 16:59
summer,2012-06-13,17,75,782,857,7421,17:00 - 18:59
summer,2012-06-13,18,104,640,744,7421,17:00 - 18:59
summer,2012-06-13,19,123,548,671,7421,19:00 - 20:59
summer,2012-06-13,20,86,362,448,7421,19:00 - 20:59
summer,2012-06-13,21,79,317,396,7421,21:00 - 22:59
summer,2012-06-13,22,29,209,238,7421,21:00 - 22:59
summer,2012-06-13,23,25,128,153,7421,23:00 - 24:59
summer,2012-06-14,0,3,45,48,7363,
summer,2012-06-14,1,4,17,21,7363,01:00 - 02:59
summer,2012-06-14,2,1,8,9,7363,01:00 - 02:59
summer,2012-06-14,3,1,4,5,7363,03:00 - 04:59
summer,2012-06-14,4,0,6,6,7363,03:00 - 04:59
summer,2012-06-14,5,0,40,40,7363,05:00 - 06:59
summer,2012-06-14,6,12,169,181,7363,05:00 - 06:59
summer,2012-06-14,7,26,480,506,7363,07:00 - 08:59
summer,2012-06-14,8,37,682,719,7363,07:00 - 08:59
summer,2012-06-14,9,45,312,357,7363,09:00 - 10:59
summer,2012-06-14,10,47,132,179,7363,09:00 - 10:59
summer,2012-06-14,11,60,168,228,7363,11:00 - 12:59
summer,2012-06-14,12,55,210,265,7363,11:00 - 12:59
summer,2012-06-14,13,71,213,284,7363,13:00 - 14:59
summer,2012-06-14,14,84,214,298,7363,13:00 - 14:59
summer,2012-06-14,15,111,213,324,7363,15:00 - 16:59
summer,2012-06-14,16,70,368,438,7363,15:00 - 16:59
summer,2012-06-14,17,117,750,867,7363,17:00 - 18:59
summer,2012-06-14,18,107,716,823,7363,17:00 - 18:59
summer,2012-06-14,19,96,483,579,7363,19:00 - 20:59
summer,2012-06-14,20,84,351,435,7363,19:00 - 20:59
summer,2012-06-14,21,67,270,337,7363,21:00 - 22:59
summer,2012-06-14,22,46,196,242,7363,21:00 - 22:59
summer,2012-06-14,23,36,136,172,7363,23:00 - 24:59
summer,2012-06-15,0,26,68,94,7665,
summer,2012-06-15,1,9,42,51,7665,01:00 - 02:59
summer,2012-06-15,2,0,15,15,7665,01:00 - 02:59
summer,2012-06-15,3,2,3,5,7665,03:00 - 04:59
summer,2012-06-15,4,1,13,14,7665,03:00 - 04:59
summer,2012-06-15,5,2,31,33,7665,05:00 - 06:59
summer,2012-06-15,6,9,142,151,7665,05:00 - 06:59
summer,2012-06-15,7,17,413,430,7665,07:00 - 08:59
summer,2012-06-15,8,44,609,653,7665,07:00 - 08:59
summer,2012-06-15,9,58,308,366,7665,09:00 - 10:59
summer,2012-06-15,10,56,160,216,7665,09:00 - 10:59
summer,2012-06-15,11,106,180,286,7665,11:00 - 12:59
summer,2012-06-15,12,111,292,403,7665,11:00 - 12:59
summer,2012-06-15,13,121,272,393,7665,13:00 - 14:59
summer,2012-06-15,14,121,255,376,7665,13:00 - 14:59
summer,2012-06-15,15,107,270,377,7665,15:00 - 16:59
summer,2012-06-15,16,132,426,558,7665,15:00 - 16:59
summer,2012-06-15,17,125,698,823,7665,17:00 - 18:59
summer,2012-06-15,18,121,572,693,7665,17:00 - 18:59
summer,2012-06-15,19,98,369,467,7665,19:00 - 20:59
summer,2012-06-15,20,89,296,385,7665,19:00 - 20:59
summer,2012-06-15,21,83,250,333,7665,21:00 - 22:59
summer,2012-06-15,22,79,242,321,7665,21:00 - 22:59
summer,2012-06-15,23,46,176,222,7665,23:00 - 24:59
summer,2012-06-16,0,25,112,137,7702,
summer,2012-06-16,1,16,79,95,7702,01:00 - 02:59
summer,2012-06-16,2,12,55,67,7702,01:00 - 02:59
summer,2012-06-16,3,8,19,27,7702,03:00 - 04:59
summer,2012-06-16,4,3,5,8,7702,03:00 - 04:59
summer,2012-06-16,5,2,21,23,7702,05:00 - 06:59
summer,2012-06-16,6,11,36,47,7702,05:00 - 06:59
summer,2012-06-16,7,10,68,78,7702,07:00 - 08:59
summer,2012-06-16,8,47,157,204,7702,07:00 - 08:59
summer,2012-06-16,9,88,279,367,7702,09:00 - 10:59
summer,2012-06-16,10,139,296,435,7702,09:00 - 10:59
summer,2012-06-16,11,213,353,566,7702,11:00 - 12:59
summer,2012-06-16,12,254,349,603,7702,11:00 - 12:59
summer,2012-06-16,13,293,324,617,7702,13:00 - 14:59
summer,2012-06-16,14,264,309,573,7702,13:00 - 14:59
summer,2012-06-16,15,295,288,583,7702,15:00 - 16:59
summer,2012-06-16,16,238,304,542,7702,15:00 - 16:59
summer,2012-06-16,17,244,349,593,7702,17:00 - 18:59
summer,2012-06-16,18,256,315,571,7702,17:00 - 18:59
summer,2012-06-16,19,184,277,461,7702,19:00 - 20:59
summer,2012-06-16,20,123,229,352,7702,19:00 - 20:59
summer,2012-06-16,21,98,192,290,7702,21:00 - 22:59
summer,2012-06-16,22,91,189,280,7702,21:00 - 22:59
summer,2012-06-16,23,49,134,183,7702,23:00 - 24:59
summer,2012-06-17,0,31,117,148,6978,
summer,2012-06-17,1,21,67,88,6978,01:00 - 02:59
summer,2012-06-17,2,19,55,74,6978,01:00 - 02:59
summer,2012-06-17,3,6,22,28,6978,03:00 - 04:59
summer,2012-06-17,4,2,16,18,6978,03:00 - 04:59
summer,2012-06-17,5,4,13,17,6978,05:00 - 06:59
summer,2012-06-17,6,7,16,23,6978,05:00 - 06:59
summer,2012-06-17,7,18,30,48,6978,07:00 - 08:59
summer,2012-06-17,8,24,95,119,6978,07:00 - 08:59
summer,2012-06-17,9,91,183,274,6978,09:00 - 10:59
summer,2012-06-17,10,148,288,436,6978,09:00 - 10:59
summer,2012-06-17,11,196,350,546,6978,11:00 - 12:59
summer,2012-06-17,12,260,355,615,6978,11:00 - 12:59
summer,2012-06-17,13,267,347,614,6978,13:00 - 14:59
summer,2012-06-17,14,255,327,582,6978,13:00 - 14:59
summer,2012-06-17,15,203,260,463,6978,15:00 - 16:59
summer,2012-06-17,16,240,340,580,6978,15:00 - 16:59
summer,2012-06-17,17,232,361,593,6978,17:00 - 18:59
summer,2012-06-17,18,203,310,513,6978,17:00 - 18:59
summer,2012-06-17,19,146,244,390,6978,19:00 - 20:59
summer,2012-06-17,20,101,201,302,6978,19:00 - 20:59
summer,2012-06-17,21,76,170,246,6978,21:00 - 22:59
summer,2012-06-17,22,55,98,153,6978,21:00 - 22:59
summer,2012-06-17,23,29,79,108,6978,23:00 - 24:59
summer,2012-06-18,0,12,28,40,5099,
summer,2012-06-18,1,9,5,14,5099,01:00 - 02:59
summer,2012-06-18,2,3,6,9,5099,01:00 - 02:59
summer,2012-06-18,3,1,3,4,5099,03:00 - 04:59
summer,2012-06-18,4,0,9,9,5099,03:00 - 04:59
summer,2012-06-18,5,1,22,23,5099,05:00 - 06:59
summer,2012-06-18,6,0,37,37,5099,05:00 - 06:59
summer,2012-06-18,7,10,135,145,5099,07:00 - 08:59
summer,2012-06-18,8,27,447,474,5099,07:00 - 08:59
summer,2012-06-18,9,28,222,250,5099,09:00 - 10:59
summer,2012-06-18,10,13,78,91,5099,09:00 - 10:59
summer,2012-06-18,11,25,96,121,5099,11:00 - 12:59
summer,2012-06-18,12,29,139,168,5099,11:00 - 12:59
summer,2012-06-18,13,51,174,225,5099,13:00 - 14:59
summer,2012-06-18,14,59,160,219,5099,13:00 - 14:59
summer,2012-06-18,15,61,176,237,5099,15:00 - 16:59
summer,2012-06-18,16,53,279,332,5099,15:00 - 16:59
summer,2012-06-18,17,54,669,723,5099,17:00 - 18:59
summer,2012-06-18,18,47,595,642,5099,17:00 - 18:59
summer,2012-06-18,19,52,411,463,5099,19:00 - 20:59
summer,2012-06-18,20,45,317,362,5099,19:00 - 20:59
summer,2012-06-18,21,35,238,273,5099,21:00 - 22:59
summer,2012-06-18,22,21,143,164,5099,21:00 - 22:59
summer,2012-06-18,23,17,57,74,5099,23:00 - 24:59
summer,2012-06-19,0,5,30,35,6825,
summer,2012-06-19,1,1,13,14,6825,01:00 - 02:59
summer,2012-06-19,2,1,14,15,6825,01:00 - 02:59
summer,2012-06-19,3,1,7,8,6825,03:00 - 04:59
summer,2012-06-19,4,1,9,10,6825,03:00 - 04:59
summer,2012-06-19,5,3,34,37,6825,05:00 - 06:59
summer,2012-06-19,6,9,152,161,6825,05:00 - 06:59
summer,2012-06-19,7,18,462,480,6825,07:00 - 08:59
summer,2012-06-19,8,40,633,673,6825,07:00 - 08:59
summer,2012-06-19,9,40,288,328,6825,09:00 - 10:59
summer,2012-06-19,10,44,136,180,6825,09:00 - 10:59
summer,2012-06-19,11,56,174,230,6825,11:00 - 12:59
summer,2012-06-19,12,70,222,292,6825,11:00 - 12:59
summer,2012-06-19,13,69,203,272,6825,13:00 - 14:59
summer,2012-06-19,14,61,166,227,6825,13:00 - 14:59
summer,2012-06-19,15,72,187,259,6825,15:00 - 16:59
summer,2012-06-19,16,48,286,334,6825,15:00 - 16:59
summer,2012-06-19,17,86,725,811,6825,17:00 - 18:59
summer,2012-06-19,18,91,704,795,6825,17:00 - 18:59
summer,2012-06-19,19,82,432,514,6825,19:00 - 20:59
summer,2012-06-19,20,59,399,458,6825,19:00 - 20:59
summer,2012-06-19,21,37,239,276,6825,21:00 - 22:59
summer,2012-06-19,22,51,240,291,6825,21:00 - 22:59
summer,2012-06-19,23,23,102,125,6825,23:00 - 24:59
summer,2012-06-20,0,5,48,53,6211,
summer,2012-06-20,1,7,20,27,6211,01:00 - 02:59
summer,2012-06-20,2,1,5,6,6211,01:00 - 02:59
summer,2012-06-20,3,2,6,8,6211,03:00 - 04:59
summer,2012-06-20,4,1,6,7,6211,03:00 - 04:59
summer,2012-06-20,5,2,37,39,6211,05:00 - 06:59
summer,2012-06-20,6,9,156,165,6211,05:00 - 06:59
summer,2012-06-20,7,20,444,464,6211,07:00 - 08:59
summer,2012-06-20,8,43,600,643,6211,07:00 - 08:59
summer,2012-06-20,9,40,276,316,6211,09:00 - 10:59
summer,2012-06-20,10,41,126,167,6211,09:00 - 10:59
summer,2012-06-20,11,54,134,188,6211,11:00 - 12:59
summer,2012-06-20,12,30,150,180,6211,11:00 - 12:59
summer,2012-06-20,13,48,163,211,6211,13:00 - 14:59
summer,2012-06-20,14,56,134,190,6211,13:00 - 14:59
summer,2012-06-20,15,36,143,179,6211,15:00 - 16:59
summer,2012-06-20,16,51,284,335,6211,15:00 - 16:59
summer,2012-06-20,17,80,611,691,6211,17:00 - 18:59
summer,2012-06-20,18,81,591,672,6211,17:00 - 18:59
summer,2012-06-20,19,90,449,539,6211,19:00 - 20:59
summer,2012-06-20,20,81,326,407,6211,19:00 - 20:59
summer,2012-06-20,21,42,302,344,6211,21:00 - 22:59
summer,2012-06-20,22,31,226,257,6211,21:00 - 22:59
summer,2012-06-20,23,21,102,123,6211,23:00 - 24:59
fall,2012-06-21,0,16,53,69,5905,
fall,2012-06-21,1,2,16,18,5905,01:00 - 02:59
fall,2012-06-21,2,11,7,18,5905,01:00 - 02:59
fall,2012-06-21,3,3,8,11,5905,03:00 - 04:59
fall,2012-06-21,4,1,11,12,5905,03:00 - 04:59
fall,2012-06-21,5,3,37,40,5905,05:00 - 06:59
fall,2012-06-21,6,3,147,150,5905,05:00 - 06:59
fall,2012-06-21,7,26,437,463,5905,07:00 - 08:59
fall,2012-06-21,8,27,563,590,5905,07:00 - 08:59
fall,2012-06-21,9,32,224,256,5905,09:00 - 10:59
fall,2012-06-21,10,36,114,150,5905,09:00 - 10:59
fall,2012-06-21,11,40,121,161,5905,11:00 - 12:59
fall,2012-06-21,12,33,182,215,5905,11:00 - 12:59
fall,2012-06-21,13,31,141,172,5905,13:00 - 14:59
fall,2012-06-21,14,27,149,176,5905,13:00 - 14:59
fall,2012-06-21,15,40,154,194,5905,15:00 - 16:59
fall,2012-06-21,16,37,283,320,5905,15:00 - 16:59
fall,2012-06-21,17,80,535,615,5905,17:00 - 18:59
fall,2012-06-21,18,78,562,640,5905,17:00 - 18:59
fall,2012-06-21,19,84,415,499,5905,19:00 - 20:59
fall,2012-06-21,20,79,357,436,5905,19:00 - 20:59
fall,2012-06-21,21,55,256,311,5905,21:00 - 22:59
fall,2012-06-21,22,22,221,243,5905,21:00 - 22:59
fall,2012-06-21,23,12,134,146,5905,23:00 - 24:59
fall,2012-06-22,0,16,77,93,5823,
fall,2012-06-22,1,3,28,31,5823,01:00 - 02:59
fall,2012-06-22,2,0,12,12,5823,01:00 - 02:59
fall,2012-06-22,3,1,6,7,5823,03:00 - 04:59
fall,2012-06-22,4,3,7,10,5823,03:00 - 04:59
fall,2012-06-22,5,3,35,38,5823,05:00 - 06:59
fall,2012-06-22,6,4,118,122,5823,05:00 - 06:59
fall,2012-06-22,7,19,340,359,5823,07:00 - 08:59
fall,2012-06-22,8,49,564,613,5823,07:00 - 08:59
fall,2012-06-22,9,55,278,333,5823,09:00 - 10:59
fall,2012-06-22,10,52,133,185,5823,09:00 - 10:59
fall,2012-06-22,11,76,160,236,5823,11:00 - 12:59
fall,2012-06-22,12,63,191,254,5823,11:00 - 12:59
fall,2012-06-22,13,72,228,300,5823,13:00 - 14:59
fall,2012-06-22,14,65,198,263,5823,13:00 - 14:59
fall,2012-06-22,15,72,212,284,5823,15:00 - 16:59
fall,2012-06-22,16,67,313,380,5823,15:00 - 16:59
fall,2012-06-22,17,95,551,646,5823,17:00 - 18:59
fall,2012-06-22,18,62,443,505,5823,17:00 - 18:59
fall,2012-06-22,19,45,317,362,5823,19:00 - 20:59
fall,2012-06-22,20,31,171,202,5823,19:00 - 20:59
fall,2012-06-22,21,40,177,217,5823,21:00 - 22:59
fall,2012-06-22,22,42,155,197,5823,21:00 - 22:59
fall,2012-06-22,23,29,145,174,5823,23:00 - 24:59
fall,2012-06-23,0,14,102,116,7458,
fall,2012-06-23,1,16,107,123,7458,01:00 - 02:59
fall,2012-06-23,2,18,75,93,7458,01:00 - 02:59
fall,2012-06-23,3,10,32,42,7458,03:00 - 04:59
fall,2012-06-23,4,6,13,19,7458,03:00 - 04:59
fall,2012-06-23,5,1,11,12,7458,05:00 - 06:59
fall,2012-06-23,6,10,37,47,7458,05:00 - 06:59
fall,2012-06-23,7,19,59,78,7458,07:00 - 08:59
fall,2012-06-23,8,34,133,167,7458,07:00 - 08:59
fall,2012-06-23,9,85,247,332,7458,09:00 - 10:59
fall,2012-06-23,10,177,317,494,7458,09:00 - 10:59
fall,2012-06-23,11,167,349,516,7458,11:00 - 12:59
fall,2012-06-23,12,203,399,602,7458,11:00 - 12:59
fall,2012-06-23,13,226,338,564,7458,13:00 - 14:59
fall,2012-06-23,14,238,371,609,7458,13:00 - 14:59
fall,2012-06-23,15,217,266,483,7458,15:00 - 16:59
fall,2012-06-23,16,196,317,513,7458,15:00 - 16:59
fall,2012-06-23,17,214,316,530,7458,17:00 - 18:59
fall,2012-06-23,18,194,287,481,7458,17:00 - 18:59
fall,2012-06-23,19,185,240,425,7458,19:00 - 20:59
fall,2012-06-23,20,158,228,386,7458,19:00 - 20:59
fall,2012-06-23,21,99,223,322,7458,21:00 - 22:59
fall,2012-06-23,22,101,178,279,7458,21:00 - 22:59
fall,2012-06-23,23,69,156,225,7458,23:00 - 24:59
fall,2012-06-24,0,31,132,163,6891,
fall,2012-06-24,1,39,88,127,6891,01:00 - 02:59
fall,2012-06-24,2,34,80,114,6891,01:00 - 02:59
fall,2012-06-24,3,19,41,60,6891,03:00 - 04:59
fall,2012-06-24,4,4,9,13,6891,03:00 - 04:59
fall,2012-06-24,5,1,7,8,6891,05:00 - 06:59
fall,2012-06-24,6,6,19,25,6891,05:00 - 06:59
fall,2012-06-24,7,23,48,71,6891,07:00 - 08:59
fall,2012-06-24,8,38,103,141,6891,07:00 - 08:59
fall,2012-06-24,9,63,169,232,6891,09:00 - 10:59
fall,2012-06-24,10,161,291,452,6891,09:00 - 10:59
fall,2012-06-24,11,215,291,506,6891,11:00 - 12:59
fall,2012-06-24,12,227,329,556,6891,11:00 - 12:59
fall,2012-06-24,13,237,348,585,6891,13:00 - 14:59
fall,2012-06-24,14,253,298,551,6891,13:00 - 14:59
fall,2012-06-24,15,197,290,487,6891,15:00 - 16:59
fall,2012-06-24,16,181,280,461,6891,15:00 - 16:59
fall,2012-06-24,17,203,329,532,6891,17:00 - 18:59
fall,2012-06-24,18,186,348,534,6891,17:00 - 18:59
fall,2012-06-24,19,176,247,423,6891,19:00 - 20:59
fall,2012-06-24,20,108,224,332,6891,19:00 - 20:59
fall,2012-06-24,21,76,177,253,6891,21:00 - 22:59
fall,2012-06-24,22,53,125,178,6891,21:00 - 22:59
fall,2012-06-24,23,20,67,87,6891,23:00 - 24:59
fall,2012-06-25,0,31,37,68,6779,
fall,2012-06-25,1,11,20,31,6779,01:00 - 02:59
fall,2012-06-25,2,4,10,14,6779,01:00 - 02:59
fall,2012-06-25,3,1,4,5,6779,03:00 - 04:59
fall,2012-06-25,4,0,4,4,6779,03:00 - 04:59
fall,2012-06-25,5,1,42,43,6779,05:00 - 06:59
fall,2012-06-25,6,11,147,158,6779,05:00 - 06:59
fall,2012-06-25,7,30,455,485,6779,07:00 - 08:59
fall,2012-06-25,8,53,555,608,6779,07:00 - 08:59
fall,2012-06-25,9,37,231,268,6779,09:00 - 10:59
fall,2012-06-25,10,58,126,184,6779,09:00 - 10:59
fall,2012-06-25,11,54,127,181,6779,11:00 - 12:59
fall,2012-06-25,12,74,196,270,6779,11:00 - 12:59
fall,2012-06-25,13,79,181,260,6779,13:00 - 14:59
fall,2012-06-25,14,90,161,251,6779,13:00 - 14:59
fall,2012-06-25,15,65,168,233,6779,15:00 - 16:59
fall,2012-06-25,16,104,310,414,6779,15:00 - 16:59
fall,2012-06-25,17,76,757,833,6779,17:00 - 18:59
fall,2012-06-25,18,100,691,791,6779,17:00 - 18:59
fall,2012-06-25,19,74,508,582,6779,19:00 - 20:59
fall,2012-06-25,20,100,375,475,6779,19:00 - 20:59
fall,2012-06-25,21,50,281,331,6779,21:00 - 22:59
fall,2012-06-25,22,21,166,187,6779,21:00 - 22:59
fall,2012-06-25,23,15,88,103,6779,23:00 - 24:59
fall,2012-06-26,0,8,29,37,7442,
fall,2012-06-26,1,11,19,30,7442,01:00 - 02:59
fall,2012-06-26,2,2,7,9,7442,01:00 - 02:59
fall,2012-06-26,3,2,7,9,7442,03:00 - 04:59
fall,2012-06-26,4,1,9,10,7442,03:00 - 04:59
fall,2012-06-26,5,3,36,39,7442,05:00 - 06:59
fall,2012-06-26,6,12,176,188,7442,05:00 - 06:59
fall,2012-06-26,7,21,531,552,7442,07:00 - 08:59
fall,2012-06-26,8,34,622,656,7442,07:00 - 08:59
fall,2012-06-26,9,30,298,328,7442,09:00 - 10:59
fall,2012-06-26,10,37,153,190,7442,09:00 - 10:59
fall,2012-06-26,11,46,189,235,7442,11:00 - 12:59
fall,2012-06-26,12,80,228,308,7442,11:00 - 12:59
fall,2012-06-26,13,74,232,306,7442,13:00 - 14:59
fall,2012-06-26,14,81,186,267,7442,13:00 - 14:59
fall,2012-06-26,15,88,229,317,7442,15:00 - 16:59
fall,2012-06-26,16,67,349,416,7442,15:00 - 16:59
fall,2012-06-26,17,104,796,900,7442,17:00 - 18:59
fall,2012-06-26,18,105,719,824,7442,17:00 - 18:59
fall,2012-06-26,19,83,529,612,7442,19:00 - 20:59
fall,2012-06-26,20,88,417,505,7442,19:00 - 20:59
fall,2012-06-26,21,61,267,328,7442,21:00 - 22:59
fall,2012-06-26,22,26,219,245,7442,21:00 - 22:59
fall,2012-06-26,23,13,118,131,7442,23:00 - 24:59
fall,2012-06-27,0,15,39,54,7335,
fall,2012-06-27,1,5,18,23,7335,01:00 - 02:59
fall,2012-06-27,2,2,12,14,7335,01:00 - 02:59
fall,2012-06-27,3,1,7,8,7335,03:00 - 04:59
fall,2012-06-27,4,0,11,11,7335,03:00 - 04:59
fall,2012-06-27,5,2,34,36,7335,05:00 - 06:59
fall,2012-06-27,6,7,193,200,7335,05:00 - 06:59
fall,2012-06-27,7,29,498,527,7335,07:00 - 08:59
fall,2012-06-27,8,49,638,687,7335,07:00 - 08:59
fall,2012-06-27,9,29,253,282,7335,09:00 - 10:59
fall,2012-06-27,10,34,138,172,7335,09:00 - 10:59
fall,2012-06-27,11,64,145,209,7335,11:00 - 12:59
fall,2012-06-27,12,77,245,322,7335,11:00 - 12:59
fall,2012-06-27,13,77,244,321,7335,13:00 - 14:59
fall,2012-06-27,14,78,192,270,7335,13:00 - 14:59
fall,2012-06-27,15,61,188,249,7335,15:00 - 16:59
fall,2012-06-27,16,55,337,392,7335,15:00 - 16:59
fall,2012-06-27,17,113,730,843,7335,17:00 - 18:59
fall,2012-06-27,18,85,719,804,7335,17:00 - 18:59
fall,2012-06-27,19,101,542,643,7335,19:00 - 20:59
fall,2012-06-27,20,76,369,445,7335,19:00 - 20:59
fall,2012-06-27,21,54,313,367,7335,21:00 - 22:59
fall,2012-06-27,22,52,245,297,7335,21:00 - 22:59
fall,2012-06-27,23,11,148,159,7335,23:00 - 24:59
fall,2012-06-28,0,2,52,54,6879,
fall,2012-06-28,1,11,14,25,6879,01:00 - 02:59
fall,2012-06-28,2,1,12,13,6879,01:00 - 02:59
fall,2012-06-28,3,1,6,7,6879,03:00 - 04:59
fall,2012-06-28,4,0,11,11,6879,03:00 - 04:59
fall,2012-06-28,5,8,39,47,6879,05:00 - 06:59
fall,2012-06-28,6,8,185,193,6879,05:00 - 06:59
fall,2012-06-28,7,24,484,508,6879,07:00 - 08:59
fall,2012-06-28,8,40,577,617,6879,07:00 - 08:59
fall,2012-06-28,9,33,318,351,6879,09:00 - 10:59
fall,2012-06-28,10,40,144,184,6879,09:00 - 10:59
fall,2012-06-28,11,41,170,211,6879,11:00 - 12:59
fall,2012-06-28,12,49,227,276,6879,11:00 - 12:59
fall,2012-06-28,13,31,205,236,6879,13:00 - 14:59
fall,2012-06-28,14,66,188,254,6879,13:00 - 14:59
fall,2012-06-28,15,24,195,219,6879,15:00 - 16:59
fall,2012-06-28,16,56,331,387,6879,15:00 - 16:59
fall,2012-06-28,17,71,634,705,6879,17:00 - 18:59
fall,2012-06-28,18,100,597,697,6879,17:00 - 18:59
fall,2012-06-28,19,79,492,571,6879,19:00 - 20:59
fall,2012-06-28,20,71,399,470,6879,19:00 - 20:59
fall,2012-06-28,21,89,309,398,6879,21:00 - 22:59
fall,2012-06-28,22,50,224,274,6879,21:00 - 22:59
fall,2012-06-28,23,26,145,171,6879,23:00 - 24:59
fall,2012-06-29,0,24,90,114,5463,
fall,2012-06-29,1,9,33,42,5463,01:00 - 02:59
fall,2012-06-29,2,3,15,18,5463,01:00 - 02:59
fall,2012-06-29,3,3,5,8,5463,03:00 - 04:59
fall,2012-06-29,4,1,9,10,5463,03:00 - 04:59
fall,2012-06-29,5,6,39,45,5463,05:00 - 06:59
fall,2012-06-29,6,15,148,163,5463,05:00 - 06:59
fall,2012-06-29,7,19,361,380,5463,07:00 - 08:59
fall,2012-06-29,8,48,576,624,5463,07:00 - 08:59
fall,2012-06-29,9,39,261,300,5463,09:00 - 10:59
fall,2012-06-29,10,32,139,171,5463,09:00 - 10:59
fall,2012-06-29,11,51,137,188,5463,11:00 - 12:59
fall,2012-06-29,12,53,173,226,5463,11:00 - 12:59
fall,2012-06-29,13,45,194,239,5463,13:00 - 14:59
fall,2012-06-29,14,49,184,233,5463,13:00 - 14:59
fall,2012-06-29,15,47,183,230,5463,15:00 - 16:59
fall,2012-06-29,16,59,292,351,5463,15:00 - 16:59
fall,2012-06-29,17,82,457,539,5463,17:00 - 18:59
fall,2012-06-29,18,50,414,464,5463,17:00 - 18:59
fall,2012-06-29,19,60,303,363,5463,19:00 - 20:59
fall,2012-06-29,20,53,255,308,5463,19:00 - 20:59
fall,2012-06-29,21,41,195,236,5463,21:00 - 22:59
fall,2012-06-29,22,34,129,163,5463,21:00 - 22:59
fall,2012-06-29,23,6,42,48,5463,23:00 - 24:59
fall,2012-06-30,0,4,65,69,5687,
fall,2012-06-30,1,3,55,58,5687,01:00 - 02:59
fall,2012-06-30,2,7,54,61,5687,01:00 - 02:59
fall,2012-06-30,3,3,20,23,5687,03:00 - 04:59
fall,2012-06-30,4,3,15,18,5687,03:00 - 04:59
fall,2012-06-30,5,3,7,10,5687,05:00 - 06:59
fall,2012-06-30,6,6,36,42,5687,05:00 - 06:59
fall,2012-06-30,7,10,82,92,5687,07:00 - 08:59
fall,2012-06-30,8,26,168,194,5687,07:00 - 08:59
fall,2012-06-30,9,41,234,275,5687,09:00 - 10:59
fall,2012-06-30,10,96,308,404,5687,09:00 - 10:59
fall,2012-06-30,11,102,350,452,5687,11:00 - 12:59
fall,2012-06-30,12,143,328,471,5687,11:00 - 12:59
fall,2012-06-30,13,105,323,428,5687,13:00 - 14:59
fall,2012-06-30,14,114,295,409,5687,13:00 - 14:59
fall,2012-06-30,15,117,287,404,5687,15:00 - 16:59
fall,2012-06-30,16,109,264,373,5687,15:00 - 16:59
fall,2012-06-30,17,131,231,362,5687,17:00 - 18:59
fall,2012-06-30,18,91,248,339,5687,17:00 - 18:59
fall,2012-06-30,19,134,240,374,5687,19:00 - 20:59
fall,2012-06-30,20,88,204,292,5687,19:00 - 20:59
fall,2012-06-30,21,48,165,213,5687,21:00 - 22:59
fall,2012-06-30,22,38,134,172,5687,21:00 - 22:59
fall,2012-06-30,23,33,119,152,5687,23:00 - 24:59
fall,2012-07-01,0,27,122,149,5531,
fall,2012-07-01,1,12,81,93,5531,01:00 - 02:59
fall,2012-07-01,2,21,69,90,5531,01:00 - 02:59
fall,2012-07-01,3,6,27,33,5531,03:00 - 04:59
fall,2012-07-01,4,0,4,4,5531,03:00 - 04:59
fall,2012-07-01,5,3,7,10,5531,05:00 - 06:59
fall,2012-07-01,6,8,19,27,5531,05:00 - 06:59
fall,2012-07-01,7,13,37,50,5531,07:00 - 08:59
fall,2012-07-01,8,36,106,142,5531,07:00 - 08:59
fall,2012-07-01,9,51,168,219,5531,09:00 - 10:59
fall,2012-07-01,10,98,268,366,5531,09:00 - 10:59
fall,2012-07-01,11,121,256,377,5531,11:00 - 12:59
fall,2012-07-01,12,114,319,433,5531,11:00 - 12:59
fall,2012-07-01,13,111,309,420,5531,13:00 - 14:59
fall,2012-07-01,14,98,346,444,5531,13:00 - 14:59
fall,2012-07-01,15,101,244,345,5531,15:00 - 16:59
fall,2012-07-01,16,85,228,313,5531,15:00 - 16:59
fall,2012-07-01,17,90,323,413,5531,17:00 - 18:59
fall,2012-07-01,18,95,275,370,5531,17:00 - 18:59
fall,2012-07-01,19,103,279,382,5531,19:00 - 20:59
fall,2012-07-01,20,88,244,332,5531,19:00 - 20:59
fall,2012-07-01,21,77,181,258,5531,21:00 - 22:59
fall,2012-07-01,22,41,110,151,5531,21:00 - 22:59
fall,2012-07-01,23,22,88,110,5531,23:00 - 24:59
fall,2012-07-02,0,12,31,43,6227,
fall,2012-07-02,1,3,14,17,6227,01:00 - 02:59
fall,2012-07-02,2,1,14,15,6227,01:00 - 02:59
fall,2012-07-02,3,0,5,5,6227,03:00 - 04:59
fall,2012-07-02,4,2,10,12,6227,03:00 - 04:59
fall,2012-07-02,5,3,37,40,6227,05:00 - 06:59
fall,2012-07-02,6,4,132,136,6227,05:00 - 06:59
fall,2012-07-02,7,8,390,398,6227,07:00 - 08:59
fall,2012-07-02,8,20,548,568,6227,07:00 - 08:59
fall,2012-07-02,9,56,239,295,6227,09:00 - 10:59
fall,2012-07-02,10,70,104,174,6227,09:00 - 10:59
fall,2012-07-02,11,67,134,201,6227,11:00 - 12:59
fall,2012-07-02,12,74,183,257,6227,11:00 - 12:59
fall,2012-07-02,13,74,162,236,6227,13:00 - 14:59
fall,2012-07-02,14,79,151,230,6227,13:00 - 14:59
fall,2012-07-02,15,59,175,234,6227,15:00 - 16:59
fall,2012-07-02,16,61,304,365,6227,15:00 - 16:59
fall,2012-07-02,17,82,665,747,6227,17:00 - 18:59
fall,2012-07-02,18,72,658,730,6227,17:00 - 18:59
fall,2012-07-02,19,71,510,581,6227,19:00 - 20:59
fall,2012-07-02,20,38,357,395,6227,19:00 - 20:59
fall,2012-07-02,21,17,241,258,6227,21:00 - 22:59
fall,2012-07-02,22,19,169,188,6227,21:00 - 22:59
fall,2012-07-02,23,12,90,102,6227,23:00 - 24:59
fall,2012-07-03,0,9,44,53,6660,
fall,2012-07-03,1,5,9,14,6660,01:00 - 02:59
fall,2012-07-03,2,2,8,10,6660,01:00 - 02:59
fall,2012-07-03,3,0,2,2,6660,03:00 - 04:59
fall,2012-07-03,4,0,6,6,6660,03:00 - 04:59
fall,2012-07-03,5,2,33,35,6660,05:00 - 06:59
fall,2012-07-03,6,5,149,154,6660,05:00 - 06:59
fall,2012-07-03,7,21,462,483,6660,07:00 - 08:59
fall,2012-07-03,8,42,604,646,6660,07:00 - 08:59
fall,2012-07-03,9,46,226,272,6660,09:00 - 10:59
fall,2012-07-03,10,56,153,209,6660,09:00 - 10:59
fall,2012-07-03,11,66,151,217,6660,11:00 - 12:59
fall,2012-07-03,12,74,198,272,6660,11:00 - 12:59
fall,2012-07-03,13,80,203,283,6660,13:00 - 14:59
fall,2012-07-03,14,69,241,310,6660,13:00 - 14:59
fall,2012-07-03,15,71,330,401,6660,15:00 - 16:59
fall,2012-07-03,16,90,437,527,6660,15:00 - 16:59
fall,2012-07-03,17,102,620,722,6660,17:00 - 18:59
fall,2012-07-03,18,85,542,627,6660,17:00 - 18:59
fall,2012-07-03,19,66,431,497,6660,19:00 - 20:59
fall,2012-07-03,20,80,296,376,6660,19:00 - 20:59
fall,2012-07-03,21,36,160,196,6660,21:00 - 22:59
fall,2012-07-03,22,26,151,177,6660,21:00 - 22:59
fall,2012-07-03,23,19,152,171,6660,23:00 - 24:59
fall,2012-07-04,0,19,140,159,7403,
fall,2012-07-04,1,27,96,123,7403,01:00 - 02:59
fall,2012-07-04,2,27,66,93,7403,01:00 - 02:59
fall,2012-07-04,3,9,23,32,7403,03:00 - 04:59
fall,2012-07-04,4,5,11,16,7403,03:00 - 04:59
fall,2012-07-04,5,5,14,19,7403,05:00 - 06:59
fall,2012-07-04,6,9,23,32,7403,05:00 - 06:59
fall,2012-07-04,7,10,62,72,7403,07:00 - 08:59
fall,2012-07-04,8,43,110,153,7403,07:00 - 08:59
fall,2012-07-04,9,90,203,293,7403,09:00 - 10:59
fall,2012-07-04,10,143,304,447,7403,09:00 - 10:59
fall,2012-07-04,11,164,321,485,7403,11:00 - 12:59
fall,2012-07-04,12,164,330,494,7403,11:00 - 12:59
fall,2012-07-04,13,177,322,499,7403,13:00 - 14:59
fall,2012-07-04,14,190,357,547,7403,13:00 - 14:59
fall,2012-07-04,15,155,299,454,7403,15:00 - 16:59
fall,2012-07-04,16,163,226,389,7403,15:00 - 16:59
fall,2012-07-04,17,161,253,414,7403,17:00 - 18:59
fall,2012-07-04,18,159,271,430,7403,17:00 - 18:59
fall,2012-07-04,19,177,255,432,7403,19:00 - 20:59
fall,2012-07-04,20,237,314,551,7403,19:00 - 20:59
fall,2012-07-04,21,222,362,584,7403,21:00 - 22:59
fall,2012-07-04,22,175,327,502,7403,21:00 - 22:59
fall,2012-07-04,23,31,152,183,7403,23:00 - 24:59
fall,2012-07-05,0,17,71,88,6241,
fall,2012-07-05,1,6,24,30,6241,01:00 - 02:59
fall,2012-07-05,2,4,14,18,6241,01:00 - 02:59
fall,2012-07-05,3,2,5,7,6241,03:00 - 04:59
fall,2012-07-05,4,0,7,7,6241,03:00 - 04:59
fall,2012-07-05,5,1,28,29,6241,05:00 - 06:59
fall,2012-07-05,6,3,130,133,6241,05:00 - 06:59
fall,2012-07-05,7,27,316,343,6241,07:00 - 08:59
fall,2012-07-05,8,36,514,550,6241,07:00 - 08:59
fall,2012-07-05,9,47,246,293,6241,09:00 - 10:59
fall,2012-07-05,10,69,117,186,6241,09:00 - 10:59
fall,2012-07-05,11,107,137,244,6241,11:00 - 12:59
fall,2012-07-05,12,88,188,276,6241,11:00 - 12:59
fall,2012-07-05,13,129,181,310,6241,13:00 - 14:59
fall,2012-07-05,14,87,154,241,6241,13:00 - 14:59
fall,2012-07-05,15,71,183,254,6241,15:00 - 16:59
fall,2012-07-05,16,109,324,433,6241,15:00 - 16:59
fall,2012-07-05,17,114,575,689,6241,17:00 - 18:59
fall,2012-07-05,18,96,511,607,6241,17:00 - 18:59
fall,2012-07-05,19,128,375,503,6241,19:00 - 20:59
fall,2012-07-05,20,78,243,321,6241,19:00 - 20:59
fall,2012-07-05,21,91,232,323,6241,21:00 - 22:59
fall,2012-07-05,22,63,162,225,6241,21:00 - 22:59
fall,2012-07-05,23,32,99,131,6241,23:00 - 24:59
fall,2012-07-06,0,39,63,102,6207,
fall,2012-07-06,1,7,22,29,6207,01:00 - 02:59
fall,2012-07-06,2,4,13,17,6207,01:00 - 02:59
fall,2012-07-06,3,1,6,7,6207,03:00 - 04:59
fall,2012-07-06,4,2,4,6,6207,03:00 - 04:59
fall,2012-07-06,5,4,31,35,6207,05:00 - 06:59
fall,2012-07-06,6,4,127,131,6207,05:00 - 06:59
fall,2012-07-06,7,20,333,353,6207,07:00 - 08:59
fall,2012-07-06,8,28,557,585,6207,07:00 - 08:59
fall,2012-07-06,9,55,249,304,6207,09:00 - 10:59
fall,2012-07-06,10,80,130,210,6207,09:00 - 10:59
fall,2012-07-06,11,92,141,233,6207,11:00 - 12:59
fall,2012-07-06,12,111,220,331,6207,11:00 - 12:59
fall,2012-07-06,13,99,194,293,6207,13:00 - 14:59
fall,2012-07-06,14,91,184,275,6207,13:00 - 14:59
fall,2012-07-06,15,79,206,285,6207,15:00 - 16:59
fall,2012-07-06,16,69,300,369,6207,15:00 - 16:59
fall,2012-07-06,17,90,486,576,6207,17:00 - 18:59
fall,2012-07-06,18,106,454,560,6207,17:00 - 18:59
fall,2012-07-06,19,112,306,418,6207,19:00 - 20:59
fall,2012-07-06,20,91,245,336,6207,19:00 - 20:59
fall,2012-07-06,21,77,223,300,6207,21:00 - 22:59
fall,2012-07-06,22,78,210,288,6207,21:00 - 22:59
fall,2012-07-06,23,27,137,164,6207,23:00 - 24:59
fall,2012-07-07,0,35,115,150,4840,
fall,2012-07-07,1,16,55,71,4840,01:00 - 02:59
fall,2012-07-07,2,11,47,58,4840,01:00 - 02:59
fall,2012-07-07,3,12,19,31,4840,03:00 - 04:59
fall,2012-07-07,4,3,13,16,4840,03:00 - 04:59
fall,2012-07-07,5,2,12,14,4840,05:00 - 06:59
fall,2012-07-07,6,4,27,31,4840,05:00 - 06:59
fall,2012-07-07,7,8,63,71,4840,07:00 - 08:59
fall,2012-07-07,8,32,120,152,4840,07:00 - 08:59
fall,2012-07-07,9,69,187,256,4840,09:00 - 10:59
fall,2012-07-07,10,100,225,325,4840,09:00 - 10:59
fall,2012-07-07,11,122,245,367,4840,11:00 - 12:59
fall,2012-07-07,12,124,218,342,4840,11:00 - 12:59
fall,2012-07-07,13,116,244,360,4840,13:00 - 14:59
fall,2012-07-07,14,105,203,308,4840,13:00 - 14:59
fall,2012-07-07,15,113,193,306,4840,15:00 - 16:59
fall,2012-07-07,16,102,192,294,4840,15:00 - 16:59
fall,2012-07-07,17,103,176,279,4840,17:00 - 18:59
fall,2012-07-07,18,83,194,277,4840,17:00 - 18:59
fall,2012-07-07,19,68,219,287,4840,19:00 - 20:59
fall,2012-07-07,20,79,197,276,4840,19:00 - 20:59
fall,2012-07-07,21,51,150,201,4840,21:00 - 22:59
fall,2012-07-07,22,56,164,220,4840,21:00 - 22:59
fall,2012-07-07,23,34,114,148,4840,23:00 - 24:59
fall,2012-07-08,0,22,125,147,4672,
fall,2012-07-08,1,25,99,124,4672,01:00 - 02:59
fall,2012-07-08,2,11,59,70,4672,01:00 - 02:59
fall,2012-07-08,3,1,34,35,4672,03:00 - 04:59
fall,2012-07-08,4,2,11,13,4672,03:00 - 04:59
fall,2012-07-08,5,1,5,6,4672,05:00 - 06:59
fall,2012-07-08,6,5,16,21,4672,05:00 - 06:59
fall,2012-07-08,7,19,33,52,4672,07:00 - 08:59
fall,2012-07-08,8,35,95,130,4672,07:00 - 08:59
fall,2012-07-08,9,70,172,242,4672,09:00 - 10:59
fall,2012-07-08,10,85,234,319,4672,09:00 - 10:59
fall,2012-07-08,11,120,269,389,4672,11:00 - 12:59
fall,2012-07-08,12,105,271,376,4672,11:00 - 12:59
fall,2012-07-08,13,118,219,337,4672,13:00 - 14:59
fall,2012-07-08,14,77,235,312,4672,13:00 - 14:59
fall,2012-07-08,15,80,218,298,4672,15:00 - 16:59
fall,2012-07-08,16,65,226,291,4672,15:00 - 16:59
fall,2012-07-08,17,68,202,270,4672,17:00 - 18:59
fall,2012-07-08,18,54,199,253,4672,17:00 - 18:59
fall,2012-07-08,19,66,184,250,4672,19:00 - 20:59
fall,2012-07-08,20,79,206,285,4672,19:00 - 20:59
fall,2012-07-08,21,58,149,207,4672,21:00 - 22:59
fall,2012-07-08,22,12,110,122,4672,21:00 - 22:59
fall,2012-07-08,23,25,98,123,4672,23:00 - 24:59
fall,2012-07-09,0,6,33,39,6569,
fall,2012-07-09,1,5,13,18,6569,01:00 - 02:59
fall,2012-07-09,2,1,4,5,6569,01:00 - 02:59
fall,2012-07-09,3,0,5,5,6569,03:00 - 04:59
fall,2012-07-09,4,1,1,2,6569,03:00 - 04:59
fall,2012-07-09,5,1,27,28,6569,05:00 - 06:59
fall,2012-07-09,6,6,86,92,6569,05:00 - 06:59
fall,2012-07-09,7,7,223,230,6569,07:00 - 08:59
fall,2012-07-09,8,26,429,455,6569,07:00 - 08:59
fall,2012-07-09,9,38,325,363,6569,09:00 - 10:59
fall,2012-07-09,10,58,117,175,6569,09:00 - 10:59
fall,2012-07-09,11,72,144,216,6569,11:00 - 12:59
fall,2012-07-09,12,61,205,266,6569,11:00 - 12:59
fall,2012-07-09,13,67,188,255,6569,13:00 - 14:59
fall,2012-07-09,14,58,184,242,6569,13:00 - 14:59
fall,2012-07-09,15,66,214,280,6569,15:00 - 16:59
fall,2012-07-09,16,88,325,413,6569,15:00 - 16:59
fall,2012-07-09,17,108,741,849,6569,17:00 - 18:59
fall,2012-07-09,18,82,790,872,6569,17:00 - 18:59
fall,2012-07-09,19,88,543,631,6569,19:00 - 20:59
fall,2012-07-09,20,69,378,447,6569,19:00 - 20:59
fall,2012-07-09,21,33,298,331,6569,21:00 - 22:59
fall,2012-07-09,22,35,189,224,6569,21:00 - 22:59
fall,2012-07-09,23,22,109,131,6569,23:00 - 24:59
fall,2012-07-10,0,16,53,69,6290,
fall,2012-07-10,1,0,15,15,6290,01:00 - 02:59
fall,2012-07-10,2,1,15,16,6290,01:00 - 02:59
fall,2012-07-10,3,0,3,3,6290,03:00 - 04:59
fall,2012-07-10,4,0,4,4,6290,03:00 - 04:59
fall,2012-07-10,5,3,39,42,6290,05:00 - 06:59
fall,2012-07-10,6,4,183,187,6290,05:00 - 06:59
fall,2012-07-10,7,31,489,520,6290,07:00 - 08:59
fall,2012-07-10,8,34,615,649,6290,07:00 - 08:59
fall,2012-07-10,9,47,284,331,6290,09:00 - 10:59
fall,2012-07-10,10,56,134,190,6290,09:00 - 10:59
fall,2012-07-10,11,92,157,249,6290,11:00 - 12:59
fall,2012-07-10,12,69,203,272,6290,11:00 - 12:59
fall,2012-07-10,13,77,203,280,6290,13:00 - 14:59
fall,2012-07-10,14,71,171,242,6290,13:00 - 14:59
fall,2012-07-10,15,77,188,265,6290,15:00 - 16:59
fall,2012-07-10,16,89,346,435,6290,15:00 - 16:59
fall,2012-07-10,17,103,769,872,6290,17:00 - 18:59
fall,2012-07-10,18,70,749,819,6290,17:00 - 18:59
fall,2012-07-10,19,55,359,414,6290,19:00 - 20:59
fall,2012-07-10,20,9,75,84,6290,19:00 - 20:59
fall,2012-07-10,21,7,83,90,6290,21:00 - 22:59
fall,2012-07-10,22,14,125,139,6290,21:00 - 22:59
fall,2012-07-10,23,29,74,103,6290,23:00 - 24:59
fall,2012-07-11,0,6,38,44,7264,
fall,2012-07-11,1,3,11,14,7264,01:00 - 02:59
fall,2012-07-11,2,0,5,5,7264,01:00 - 02:59
fall,2012-07-11,3,0,5,5,7264,03:00 - 04:59
fall,2012-07-11,4,1,6,7,7264,03:00 - 04:59
fall,2012-07-11,5,5,36,41,7264,05:00 - 06:59
fall,2012-07-11,6,17,168,185,7264,05:00 - 06:59
fall,2012-07-11,7,26,471,497,7264,07:00 - 08:59
fall,2012-07-11,8,30,644,674,7264,07:00 - 08:59
fall,2012-07-11,9,30,298,328,7264,09:00 - 10:59
fall,2012-07-11,10,47,148,195,7264,09:00 - 10:59
fall,2012-07-11,11,56,173,229,7264,11:00 - 12:59
fall,2012-07-11,12,69,223,292,7264,11:00 - 12:59
fall,2012-07-11,13,65,208,273,7264,13:00 - 14:59
fall,2012-07-11,14,66,175,241,7264,13:00 - 14:59
fall,2012-07-11,15,56,220,276,7264,15:00 - 16:59
fall,2012-07-11,16,53,358,411,7264,15:00 - 16:59
fall,2012-07-11,17,90,740,830,7264,17:00 - 18:59
fall,2012-07-11,18,79,735,814,7264,17:00 - 18:59
fall,2012-07-11,19,73,560,633,7264,19:00 - 20:59
fall,2012-07-11,20,73,410,483,7264,19:00 - 20:59
fall,2012-07-11,21,69,322,391,7264,21:00 - 22:59
fall,2012-07-11,22,41,203,244,7264,21:00 - 22:59
fall,2012-07-11,23,20,132,152,7264,23:00 - 24:59
fall,2012-07-12,0,1,55,56,7446,
fall,2012-07-12,1,0,21,21,7446,01:00 - 02:59
fall,2012-07-12,2,0,9,9,7446,01:00 - 02:59
fall,2012-07-12,3,0,10,10,7446,03:00 - 04:59
fall,2012-07-12,4,0,5,5,7446,03:00 - 04:59
fall,2012-07-12,5,4,40,44,7446,05:00 - 06:59
fall,2012-07-12,6,7,171,178,7446,05:00 - 06:59
fall,2012-07-12,7,32,480,512,7446,07:00 - 08:59
fall,2012-07-12,8,49,653,702,7446,07:00 - 08:59
fall,2012-07-12,9,42,285,327,7446,09:00 - 10:59
fall,2012-07-12,10,69,145,214,7446,09:00 - 10:59
fall,2012-07-12,11,49,166,215,7446,11:00 - 12:59
fall,2012-07-12,12,71,221,292,7446,11:00 - 12:59
fall,2012-07-12,13,52,225,277,7446,13:00 - 14:59
fall,2012-07-12,14,42,167,209,7446,13:00 - 14:59
fall,2012-07-12,15,63,208,271,7446,15:00 - 16:59
fall,2012-07-12,16,69,370,439,7446,15:00 - 16:59
fall,2012-07-12,17,91,704,795,7446,17:00 - 18:59
fall,2012-07-12,18,86,739,825,7446,17:00 - 18:59
fall,2012-07-12,19,97,532,629,7446,19:00 - 20:59
fall,2012-07-12,20,75,439,514,7446,19:00 - 20:59
fall,2012-07-12,21,44,329,373,7446,21:00 - 22:59
fall,2012-07-12,22,56,262,318,7446,21:00 - 22:59
fall,2012-07-12,23,33,178,211,7446,23:00 - 24:59
fall,2012-07-13,0,19,76,95,7499,
fall,2012-07-13,1,17,42,59,7499,01:00 - 02:59
fall,2012-07-13,2,2,15,17,7499,01:00 - 02:59
fall,2012-07-13,3,2,7,9,7499,03:00 - 04:59
fall,2012-07-13,4,0,11,11,7499,03:00 - 04:59
fall,2012-07-13,5,4,30,34,7499,05:00 - 06:59
fall,2012-07-13,6,7,120,127,7499,05:00 - 06:59
fall,2012-07-13,7,27,353,380,7499,07:00 - 08:59
fall,2012-07-13,8,53,660,713,7499,07:00 - 08:59
fall,2012-07-13,9,70,344,414,7499,09:00 - 10:59
fall,2012-07-13,10,78,190,268,7499,09:00 - 10:59
fall,2012-07-13,11,68,220,288,7499,11:00 - 12:59
fall,2012-07-13,12,125,254,379,7499,11:00 - 12:59
fall,2012-07-13,13,100,274,374,7499,13:00 - 14:59
fall,2012-07-13,14,120,249,369,7499,13:00 - 14:59
fall,2012-07-13,15,92,261,353,7499,15:00 - 16:59
fall,2012-07-13,16,111,381,492,7499,15:00 - 16:59
fall,2012-07-13,17,138,697,835,7499,17:00 - 18:59
fall,2012-07-13,18,108,523,631,7499,17:00 - 18:59
fall,2012-07-13,19,103,385,488,7499,19:00 - 20:59
fall,2012-07-13,20,95,294,389,7499,19:00 - 20:59
fall,2012-07-13,21,76,223,299,7499,21:00 - 22:59
fall,2012-07-13,22,59,204,263,7499,21:00 - 22:59
fall,2012-07-13,23,37,175,212,7499,23:00 - 24:59
fall,2012-07-14,0,35,156,191,6969,
fall,2012-07-14,1,13,105,118,6969,01:00 - 02:59
fall,2012-07-14,2,10,91,101,6969,01:00 - 02:59
fall,2012-07-14,3,9,31,40,6969,03:00 - 04:59
fall,2012-07-14,4,3,6,9,6969,03:00 - 04:59
fall,2012-07-14,5,0,5,5,6969,05:00 - 06:59
fall,2012-07-14,6,6,29,35,6969,05:00 - 06:59
fall,2012-07-14,7,7,41,48,6969,07:00 - 08:59
fall,2012-07-14,8,33,118,151,6969,07:00 - 08:59
fall,2012-07-14,9,82,200,282,6969,09:00 - 10:59
fall,2012-07-14,10,123,278,401,6969,09:00 - 10:59
fall,2012-07-14,11,143,296,439,6969,11:00 - 12:59
fall,2012-07-14,12,181,318,499,6969,11:00 - 12:59
fall,2012-07-14,13,219,372,591,6969,13:00 - 14:59
fall,2012-07-14,14,269,363,632,6969,13:00 - 14:59
fall,2012-07-14,15,243,317,560,6969,15:00 - 16:59
fall,2012-07-14,16,226,340,566,6969,15:00 - 16:59
fall,2012-07-14,17,199,259,458,6969,17:00 - 18:59
fall,2012-07-14,18,108,243,351,6969,17:00 - 18:59
fall,2012-07-14,19,156,275,431,6969,19:00 - 20:59
fall,2012-07-14,20,101,255,356,6969,19:00 - 20:59
fall,2012-07-14,21,69,200,269,6969,21:00 - 22:59
fall,2012-07-14,22,65,160,225,6969,21:00 - 22:59
fall,2012-07-14,23,55,156,211,6969,23:00 - 24:59
fall,2012-07-15,0,40,147,187,6031,
fall,2012-07-15,1,49,119,168,6031,01:00 - 02:59
fall,2012-07-15,2,29,86,115,6031,01:00 - 02:59
fall,2012-07-15,3,15,42,57,6031,03:00 - 04:59
fall,2012-07-15,4,8,11,19,6031,03:00 - 04:59
fall,2012-07-15,5,2,7,9,6031,05:00 - 06:59
fall,2012-07-15,6,6,9,15,6031,05:00 - 06:59
fall,2012-07-15,7,17,30,47,6031,07:00 - 08:59
fall,2012-07-15,8,37,96,133,6031,07:00 - 08:59
fall,2012-07-15,9,58,163,221,6031,09:00 - 10:59
fall,2012-07-15,10,141,241,382,6031,09:00 - 10:59
fall,2012-07-15,11,170,281,451,6031,11:00 - 12:59
fall,2012-07-15,12,153,336,489,6031,11:00 - 12:59
fall,2012-07-15,13,171,309,480,6031,13:00 - 14:59
fall,2012-07-15,14,162,314,476,6031,13:00 - 14:59
fall,2012-07-15,15,182,307,489,6031,15:00 - 16:59
fall,2012-07-15,16,152,343,495,6031,15:00 - 16:59
fall,2012-07-15,17,122,314,436,6031,17:00 - 18:59
fall,2012-07-15,18,84,228,312,6031,17:00 - 18:59
fall,2012-07-15,19,109,203,312,6031,19:00 - 20:59
fall,2012-07-15,20,95,199,294,6031,19:00 - 20:59
fall,2012-07-15,21,59,164,223,6031,21:00 - 22:59
fall,2012-07-15,22,34,96,130,6031,21:00 - 22:59
fall,2012-07-15,23,25,66,91,6031,23:00 - 24:59
fall,2012-07-16,0,11,32,43,6830,
fall,2012-07-16,1,1,10,11,6830,01:00 - 02:59
fall,2012-07-16,2,4,11,15,6830,01:00 - 02:59
fall,2012-07-16,3,2,4,6,6830,03:00 - 04:59
fall,2012-07-16,4,1,11,12,6830,03:00 - 04:59
fall,2012-07-16,5,10,40,50,6830,05:00 - 06:59
fall,2012-07-16,6,8,132,140,6830,05:00 - 06:59
fall,2012-07-16,7,24,459,483,6830,07:00 - 08:59
fall,2012-07-16,8,48,619,667,6830,07:00 - 08:59
fall,2012-07-16,9,51,297,348,6830,09:00 - 10:59
fall,2012-07-16,10,69,117,186,6830,09:00 - 10:59
fall,2012-07-16,11,57,125,182,6830,11:00 - 12:59
fall,2012-07-16,12,79,158,237,6830,11:00 - 12:59
fall,2012-07-16,13,63,176,239,6830,13:00 - 14:59
fall,2012-07-16,14,53,159,212,6830,13:00 - 14:59
fall,2012-07-16,15,61,176,237,6830,15:00 - 16:59
fall,2012-07-16,16,77,309,386,6830,15:00 - 16:59
fall,2012-07-16,17,86,669,755,6830,17:00 - 18:59
fall,2012-07-16,18,97,697,794,6830,17:00 - 18:59
fall,2012-07-16,19,92,503,595,6830,19:00 - 20:59
fall,2012-07-16,20,66,388,454,6830,19:00 - 20:59
fall,2012-07-16,21,45,283,328,6830,21:00 - 22:59
fall,2012-07-16,22,56,228,284,6830,21:00 - 22:59
fall,2012-07-16,23,27,139,166,6830,23:00 - 24:59
fall,2012-07-17,0,10,43,53,6786,
fall,2012-07-17,1,4,21,25,6786,01:00 - 02:59
fall,2012-07-17,2,1,6,7,6786,01:00 - 02:59
fall,2012-07-17,3,0,3,3,6786,03:00 - 04:59
fall,2012-07-17,4,0,7,7,6786,03:00 - 04:59
fall,2012-07-17,5,7,31,38,6786,05:00 - 06:59
fall,2012-07-17,6,16,197,213,6786,05:00 - 06:59
fall,2012-07-17,7,26,500,526,6786,07:00 - 08:59
fall,2012-07-17,8,43,618,661,6786,07:00 - 08:59
fall,2012-07-17,9,32,288,320,6786,09:00 - 10:59
fall,2012-07-17,10,37,122,159,6786,09:00 - 10:59
fall,2012-07-17,11,60,146,206,6786,11:00 - 12:59
fall,2012-07-17,12,80,174,254,6786,11:00 - 12:59
fall,2012-07-17,13,53,168,221,6786,13:00 - 14:59
fall,2012-07-17,14,54,160,214,6786,13:00 - 14:59
fall,2012-07-17,15,57,187,244,6786,15:00 - 16:59
fall,2012-07-17,16,64,317,381,6786,15:00 - 16:59
fall,2012-07-17,17,95,675,770,6786,17:00 - 18:59
fall,2012-07-17,18,60,712,772,6786,17:00 - 18:59
fall,2012-07-17,19,69,478,547,6786,19:00 - 20:59
fall,2012-07-17,20,52,375,427,6786,19:00 - 20:59
fall,2012-07-17,21,50,283,333,6786,21:00 - 22:59
fall,2012-07-17,22,29,215,244,6786,21:00 - 22:59
fall,2012-07-17,23,22,139,161,6786,23:00 - 24:59
fall,2012-07-18,0,8,45,53,5713,
fall,2012-07-18,1,2,14,16,5713,01:00 - 02:59
fall,2012-07-18,2,3,5,8,5713,01:00 - 02:59
fall,2012-07-18,3,2,2,4,5713,03:00 - 04:59
fall,2012-07-18,4,0,6,6,5713,03:00 - 04:59
fall,2012-07-18,5,5,41,46,5713,05:00 - 06:59
fall,2012-07-18,6,10,152,162,5713,05:00 - 06:59
fall,2012-07-18,7,23,472,495,5713,07:00 - 08:59
fall,2012-07-18,8,55,624,679,5713,07:00 - 08:59
fall,2012-07-18,9,44,253,297,5713,09:00 - 10:59
fall,2012-07-18,10,39,99,138,5713,09:00 - 10:59
fall,2012-07-18,11,47,136,183,5713,11:00 - 12:59
fall,2012-07-18,12,36,166,202,5713,11:00 - 12:59
fall,2012-07-18,13,49,154,203,5713,13:00 - 14:59
fall,2012-07-18,14,54,116,170,5713,13:00 - 14:59
fall,2012-07-18,15,42,152,194,5713,15:00 - 16:59
fall,2012-07-18,16,34,190,224,5713,15:00 - 16:59
fall,2012-07-18,17,35,335,370,5713,17:00 - 18:59
fall,2012-07-18,18,63,580,643,5713,17:00 - 18:59
fall,2012-07-18,19,78,438,516,5713,19:00 - 20:59
fall,2012-07-18,20,56,310,366,5713,19:00 - 20:59
fall,2012-07-18,21,53,266,319,5713,21:00 - 22:59
fall,2012-07-18,22,42,246,288,5713,21:00 - 22:59
fall,2012-07-18,23,19,112,131,5713,23:00 - 24:59
fall,2012-07-19,0,16,50,66,6591,
fall,2012-07-19,1,6,19,25,6591,01:00 - 02:59
fall,2012-07-19,2,0,7,7,6591,01:00 - 02:59
fall,2012-07-19,3,1,4,5,6591,03:00 - 04:59
fall,2012-07-19,4,0,8,8,6591,03:00 - 04:59
fall,2012-07-19,5,5,35,40,6591,05:00 - 06:59
fall,2012-07-19,6,8,144,152,6591,05:00 - 06:59
fall,2012-07-19,7,23,450,473,6591,07:00 - 08:59
fall,2012-07-19,8,32,625,657,6591,07:00 - 08:59
fall,2012-07-19,9,36,282,318,6591,09:00 - 10:59
fall,2012-07-19,10,41,157,198,6591,09:00 - 10:59
fall,2012-07-19,11,54,162,216,6591,11:00 - 12:59
fall,2012-07-19,12,59,215,274,6591,11:00 - 12:59
fall,2012-07-19,13,74,180,254,6591,13:00 - 14:59
fall,2012-07-19,14,46,151,197,6591,13:00 - 14:59
fall,2012-07-19,15,66,226,292,6591,15:00 - 16:59
fall,2012-07-19,16,70,288,358,6591,15:00 - 16:59
fall,2012-07-19,17,93,678,771,6591,17:00 - 18:59
fall,2012-07-19,18,93,684,777,6591,17:00 - 18:59
fall,2012-07-19,19,53,480,533,6591,19:00 - 20:59
fall,2012-07-19,20,65,440,505,6591,19:00 - 20:59
fall,2012-07-19,21,38,294,332,6591,21:00 - 22:59
fall,2012-07-19,22,6,62,68,6591,21:00 - 22:59
fall,2012-07-19,23,3,62,65,6591,23:00 - 24:59
fall,2012-07-20,0,2,32,34,5870,
fall,2012-07-20,1,2,9,11,5870,01:00 - 02:59
fall,2012-07-20,2,5,14,19,5870,01:00 - 02:59
fall,2012-07-20,3,7,29,36,5870,03:00 - 04:59
fall,2012-07-20,4,3,6,9,5870,03:00 - 04:59
fall,2012-07-20,5,2,40,42,5870,05:00 - 06:59
fall,2012-07-20,6,3,123,126,5870,05:00 - 06:59
fall,2012-07-20,7,14,346,360,5870,07:00 - 08:59
fall,2012-07-20,8,39,652,691,5870,07:00 - 08:59
fall,2012-07-20,9,45,328,373,5870,09:00 - 10:59
fall,2012-07-20,10,51,182,233,5870,09:00 - 10:59
fall,2012-07-20,11,51,161,212,5870,11:00 - 12:59
fall,2012-07-20,12,41,233,274,5870,11:00 - 12:59
fall,2012-07-20,13,20,136,156,5870,13:00 - 14:59
fall,2012-07-20,14,53,176,229,5870,13:00 - 14:59
fall,2012-07-20,15,47,169,216,5870,15:00 - 16:59
fall,2012-07-20,16,70,366,436,5870,15:00 - 16:59
fall,2012-07-20,17,95,620,715,5870,17:00 - 18:59
fall,2012-07-20,18,73,549,622,5870,17:00 - 18:59
fall,2012-07-20,19,44,358,402,5870,19:00 - 20:59
fall,2012-07-20,20,35,216,251,5870,19:00 - 20:59
fall,2012-07-20,21,14,108,122,5870,21:00 - 22:59
fall,2012-07-20,22,13,122,135,5870,21:00 - 22:59
fall,2012-07-20,23,18,148,166,5870,23:00 - 24:59
fall,2012-07-21,0,11,92,103,4459,
fall,2012-07-21,1,10,62,72,4459,01:00 - 02:59
fall,2012-07-21,2,5,55,60,4459,01:00 - 02:59
fall,2012-07-21,3,7,18,25,4459,03:00 - 04:59
fall,2012-07-21,4,11,5,16,4459,03:00 - 04:59
fall,2012-07-21,5,7,10,17,4459,05:00 - 06:59
fall,2012-07-21,6,3,12,15,4459,05:00 - 06:59
fall,2012-07-21,7,8,29,37,4459,07:00 - 08:59
fall,2012-07-21,8,18,94,112,4459,07:00 - 08:59
fall,2012-07-21,9,32,175,207,4459,09:00 - 10:59
fall,2012-07-21,10,49,219,268,4459,09:00 - 10:59
fall,2012-07-21,11,80,225,305,4459,11:00 - 12:59
fall,2012-07-21,12,156,301,457,4459,11:00 - 12:59
fall,2012-07-21,13,106,248,354,4459,13:00 - 14:59
fall,2012-07-21,14,121,222,343,4459,13:00 - 14:59
fall,2012-07-21,15,148,232,380,4459,15:00 - 16:59
fall,2012-07-21,16,130,196,326,4459,15:00 - 16:59
fall,2012-07-21,17,92,149,241,4459,17:00 - 18:59
fall,2012-07-21,18,51,126,177,4459,17:00 - 18:59
fall,2012-07-21,19,67,171,238,4459,19:00 - 20:59
fall,2012-07-21,20,51,163,214,4459,19:00 - 20:59
fall,2012-07-21,21,29,134,163,4459,21:00 - 22:59
fall,2012-07-21,22,40,140,180,4459,21:00 - 22:59
fall,2012-07-21,23,32,117,149,4459,23:00 - 24:59
fall,2012-07-22,0,17,96,113,7410,
fall,2012-07-22,1,31,99,130,7410,01:00 - 02:59
fall,2012-07-22,2,32,90,122,7410,01:00 - 02:59
fall,2012-07-22,3,13,30,43,7410,03:00 - 04:59
fall,2012-07-22,4,6,10,16,7410,03:00 - 04:59
fall,2012-07-22,5,0,6,6,7410,05:00 - 06:59
fall,2012-07-22,6,5,14,19,7410,05:00 - 06:59
fall,2012-07-22,7,13,25,38,7410,07:00 - 08:59
fall,2012-07-22,8,31,122,153,7410,07:00 - 08:59
fall,2012-07-22,9,79,179,258,7410,09:00 - 10:59
fall,2012-07-22,10,114,265,379,7410,09:00 - 10:59
fall,2012-07-22,11,191,314,505,7410,11:00 - 12:59
fall,2012-07-22,12,178,326,504,7410,11:00 - 12:59
fall,2012-07-22,13,238,388,626,7410,13:00 - 14:59
fall,2012-07-22,14,256,360,616,7410,13:00 - 14:59
fall,2012-07-22,15,254,370,624,7410,15:00 - 16:59
fall,2012-07-22,16,245,383,628,7410,15:00 - 16:59
fall,2012-07-22,17,188,368,556,7410,17:00 - 18:59
fall,2012-07-22,18,173,342,515,7410,17:00 - 18:59
fall,2012-07-22,19,180,342,522,7410,19:00 - 20:59
fall,2012-07-22,20,124,254,378,7410,19:00 - 20:59
fall,2012-07-22,21,88,257,345,7410,21:00 - 22:59
fall,2012-07-22,22,55,136,191,7410,21:00 - 22:59
fall,2012-07-22,23,33,90,123,7410,23:00 - 24:59
fall,2012-07-23,0,11,36,47,6966,
fall,2012-07-23,1,7,20,27,6966,01:00 - 02:59
fall,2012-07-23,2,3,14,17,6966,01:00 - 02:59
fall,2012-07-23,3,0,2,2,6966,03:00 - 04:59
fall,2012-07-23,4,0,8,8,6966,03:00 - 04:59
fall,2012-07-23,5,3,48,51,6966,05:00 - 06:59
fall,2012-07-23,6,9,148,157,6966,05:00 - 06:59
fall,2012-07-23,7,17,404,421,6966,07:00 - 08:59
fall,2012-07-23,8,47,691,738,6966,07:00 - 08:59
fall,2012-07-23,9,57,288,345,6966,09:00 - 10:59
fall,2012-07-23,10,63,137,200,6966,09:00 - 10:59
fall,2012-07-23,11,69,129,198,6966,11:00 - 12:59
fall,2012-07-23,12,109,205,314,6966,11:00 - 12:59
fall,2012-07-23,13,64,176,240,6966,13:00 - 14:59
fall,2012-07-23,14,82,189,271,6966,13:00 - 14:59
fall,2012-07-23,15,76,205,281,6966,15:00 - 16:59
fall,2012-07-23,16,111,346,457,6966,15:00 - 16:59
fall,2012-07-23,17,87,760,847,6966,17:00 - 18:59
fall,2012-07-23,18,69,672,741,6966,17:00 - 18:59
fall,2012-07-23,19,94,488,582,6966,19:00 - 20:59
fall,2012-07-23,20,56,347,403,6966,19:00 - 20:59
fall,2012-07-23,21,45,251,296,6966,21:00 - 22:59
fall,2012-07-23,22,40,169,209,6966,21:00 - 22:59
fall,2012-07-23,23,16,98,114,6966,23:00 - 24:59
fall,2012-07-24,0,12,52,64,7592,
fall,2012-07-24,1,7,10,17,7592,01:00 - 02:59
fall,2012-07-24,2,6,10,16,7592,01:00 - 02:59
fall,2012-07-24,3,1,5,6,7592,03:00 - 04:59
fall,2012-07-24,4,0,6,6,7592,03:00 - 04:59
fall,2012-07-24,5,5,45,50,7592,05:00 - 06:59
fall,2012-07-24,6,17,173,190,7592,05:00 - 06:59
fall,2012-07-24,7,24,492,516,7592,07:00 - 08:59
fall,2012-07-24,8,49,694,743,7592,07:00 - 08:59
fall,2012-07-24,9,40,299,339,7592,09:00 - 10:59
fall,2012-07-24,10,62,156,218,7592,09:00 - 10:59
fall,2012-07-24,11,45,156,201,7592,11:00 - 12:59
fall,2012-07-24,12,60,169,229,7592,11:00 - 12:59
fall,2012-07-24,13,73,200,273,7592,13:00 - 14:59
fall,2012-07-24,14,48,196,244,7592,13:00 - 14:59
fall,2012-07-24,15,73,212,285,7592,15:00 - 16:59
fall,2012-07-24,16,86,369,455,7592,15:00 - 16:59
fall,2012-07-24,17,94,775,869,7592,17:00 - 18:59
fall,2012-07-24,18,110,767,877,7592,17:00 - 18:59
fall,2012-07-24,19,109,523,632,7592,19:00 - 20:59
fall,2012-07-24,20,85,438,523,7592,19:00 - 20:59
fall,2012-07-24,21,53,325,378,7592,21:00 - 22:59
fall,2012-07-24,22,43,226,269,7592,21:00 - 22:59
fall,2012-07-24,23,38,154,192,7592,23:00 - 24:59
fall,2012-07-25,0,9,57,66,8173,
fall,2012-07-25,1,2,26,28,8173,01:00 - 02:59
fall,2012-07-25,2,1,11,12,8173,01:00 - 02:59
fall,2012-07-25,3,1,11,12,8173,03:00 - 04:59
fall,2012-07-25,4,0,4,4,8173,03:00 - 04:59
fall,2012-07-25,5,5,54,59,8173,05:00 - 06:59
fall,2012-07-25,6,11,179,190,8173,05:00 - 06:59
fall,2012-07-25,7,34,473,507,8173,07:00 - 08:59
fall,2012-07-25,8,43,745,788,8173,07:00 - 08:59
fall,2012-07-25,9,65,277,342,8173,09:00 - 10:59
fall,2012-07-25,10,68,163,231,8173,09:00 - 10:59
fall,2012-07-25,11,79,202,281,8173,11:00 - 12:59
fall,2012-07-25,12,77,233,310,8173,11:00 - 12:59
fall,2012-07-25,13,81,231,312,8173,13:00 - 14:59
fall,2012-07-25,14,88,159,247,8173,13:00 - 14:59
fall,2012-07-25,15,94,223,317,8173,15:00 - 16:59
fall,2012-07-25,16,91,393,484,8173,15:00 - 16:59
fall,2012-07-25,17,130,783,913,8173,17:00 - 18:59
fall,2012-07-25,18,104,787,891,8173,17:00 - 18:59
fall,2012-07-25,19,116,582,698,8173,19:00 - 20:59
fall,2012-07-25,20,106,461,567,8173,19:00 - 20:59
fall,2012-07-25,21,71,326,397,8173,21:00 - 22:59
fall,2012-07-25,22,55,223,278,8173,21:00 - 22:59
fall,2012-07-25,23,52,187,239,8173,23:00 - 24:59
fall,2012-07-26,0,27,65,92,6861,
fall,2012-07-26,1,6,23,29,6861,01:00 - 02:59
fall,2012-07-26,2,5,16,21,6861,01:00 - 02:59
fall,2012-07-26,3,0,8,8,6861,03:00 - 04:59
fall,2012-07-26,4,0,4,4,6861,03:00 - 04:59
fall,2012-07-26,5,2,40,42,6861,05:00 - 06:59
fall,2012-07-26,6,16,165,181,6861,05:00 - 06:59
fall,2012-07-26,7,17,478,495,6861,07:00 - 08:59
fall,2012-07-26,8,49,680,729,6861,07:00 - 08:59
fall,2012-07-26,9,55,289,344,6861,09:00 - 10:59
fall,2012-07-26,10,79,143,222,6861,09:00 - 10:59
fall,2012-07-26,11,69,143,212,6861,11:00 - 12:59
fall,2012-07-26,12,73,206,279,6861,11:00 - 12:59
fall,2012-07-26,13,53,189,242,6861,13:00 - 14:59
fall,2012-07-26,14,62,151,213,6861,13:00 - 14:59
fall,2012-07-26,15,65,173,238,6861,15:00 - 16:59
fall,2012-07-26,16,62,312,374,6861,15:00 - 16:59
fall,2012-07-26,17,110,628,738,6861,17:00 - 18:59
fall,2012-07-26,18,73,615,688,6861,17:00 - 18:59
fall,2012-07-26,19,80,534,614,6861,19:00 - 20:59
fall,2012-07-26,20,47,399,446,6861,19:00 - 20:59
fall,2012-07-26,21,35,236,271,6861,21:00 - 22:59
fall,2012-07-26,22,33,201,234,6861,21:00 - 22:59
fall,2012-07-26,23,18,127,145,6861,23:00 - 24:59
fall,2012-07-27,0,14,83,97,6904,
fall,2012-07-27,1,12,42,54,6904,01:00 - 02:59
fall,2012-07-27,2,8,18,26,6904,01:00 - 02:59
fall,2012-07-27,3,3,9,12,6904,03:00 - 04:59
fall,2012-07-27,4,3,5,8,6904,03:00 - 04:59
fall,2012-07-27,5,3,34,37,6904,05:00 - 06:59
fall,2012-07-27,6,10,129,139,6904,05:00 - 06:59
fall,2012-07-27,7,13,397,410,6904,07:00 - 08:59
fall,2012-07-27,8,34,642,676,6904,07:00 - 08:59
fall,2012-07-27,9,34,329,363,6904,09:00 - 10:59
fall,2012-07-27,10,85,146,231,6904,09:00 - 10:59
fall,2012-07-27,11,67,184,251,6904,11:00 - 12:59
fall,2012-07-27,12,92,207,299,6904,11:00 - 12:59
fall,2012-07-27,13,83,231,314,6904,13:00 - 14:59
fall,2012-07-27,14,105,221,326,6904,13:00 - 14:59
fall,2012-07-27,15,81,242,323,6904,15:00 - 16:59
fall,2012-07-27,16,80,419,499,6904,15:00 - 16:59
fall,2012-07-27,17,101,598,699,6904,17:00 - 18:59
fall,2012-07-27,18,100,522,622,6904,17:00 - 18:59
fall,2012-07-27,19,93,423,516,6904,19:00 - 20:59
fall,2012-07-27,20,85,269,354,6904,19:00 - 20:59
fall,2012-07-27,21,71,189,260,6904,21:00 - 22:59
fall,2012-07-27,22,48,151,199,6904,21:00 - 22:59
fall,2012-07-27,23,34,155,189,6904,23:00 - 24:59
fall,2012-07-28,0,21,170,191,6685,
fall,2012-07-28,1,11,69,80,6685,01:00 - 02:59
fall,2012-07-28,2,14,76,90,6685,01:00 - 02:59
fall,2012-07-28,3,10,33,43,6685,03:00 - 04:59
fall,2012-07-28,4,1,10,11,6685,03:00 - 04:59
fall,2012-07-28,5,4,10,14,6685,05:00 - 06:59
fall,2012-07-28,6,10,40,50,6685,05:00 - 06:59
fall,2012-07-28,7,18,58,76,6685,07:00 - 08:59
fall,2012-07-28,8,36,127,163,6685,07:00 - 08:59
fall,2012-07-28,9,110,227,337,6685,09:00 - 10:59
fall,2012-07-28,10,129,266,395,6685,09:00 - 10:59
fall,2012-07-28,11,162,295,457,6685,11:00 - 12:59
fall,2012-07-28,12,157,330,487,6685,11:00 - 12:59
fall,2012-07-28,13,173,325,498,6685,13:00 - 14:59
fall,2012-07-28,14,186,308,494,6685,13:00 - 14:59
fall,2012-07-28,15,206,291,497,6685,15:00 - 16:59
fall,2012-07-28,16,208,279,487,6685,15:00 - 16:59
fall,2012-07-28,17,199,280,479,6685,17:00 - 18:59
fall,2012-07-28,18,151,330,481,6685,17:00 - 18:59
fall,2012-07-28,19,115,223,338,6685,19:00 - 20:59
fall,2012-07-28,20,79,154,233,6685,19:00 - 20:59
fall,2012-07-28,21,94,206,300,6685,21:00 - 22:59
fall,2012-07-28,22,88,188,276,6685,21:00 - 22:59
fall,2012-07-28,23,52,156,208,6685,23:00 - 24:59
fall,2012-07-29,0,59,129,188,6597,
fall,2012-07-29,1,49,109,158,6597,01:00 - 02:59
fall,2012-07-29,2,33,79,112,6597,01:00 - 02:59
fall,2012-07-29,3,18,37,55,6597,03:00 - 04:59
fall,2012-07-29,4,2,11,13,6597,03:00 - 04:59
fall,2012-07-29,5,3,14,17,6597,05:00 - 06:59
fall,2012-07-29,6,6,12,18,6597,05:00 - 06:59
fall,2012-07-29,7,4,36,40,6597,07:00 - 08:59
fall,2012-07-29,8,37,90,127,6597,07:00 - 08:59
fall,2012-07-29,9,64,162,226,6597,09:00 - 10:59
fall,2012-07-29,10,123,258,381,6597,09:00 - 10:59
fall,2012-07-29,11,183,326,509,6597,11:00 - 12:59
fall,2012-07-29,12,154,357,511,6597,11:00 - 12:59
fall,2012-07-29,13,181,302,483,6597,13:00 - 14:59
fall,2012-07-29,14,231,291,522,6597,13:00 - 14:59
fall,2012-07-29,15,195,306,501,6597,15:00 - 16:59
fall,2012-07-29,16,191,330,521,6597,15:00 - 16:59
fall,2012-07-29,17,164,367,531,6597,17:00 - 18:59
fall,2012-07-29,18,117,302,419,6597,17:00 - 18:59
fall,2012-07-29,19,143,300,443,6597,19:00 - 20:59
fall,2012-07-29,20,75,228,303,6597,19:00 - 20:59
fall,2012-07-29,21,72,199,271,6597,21:00 - 22:59
fall,2012-07-29,22,31,117,148,6597,21:00 - 22:59
fall,2012-07-29,23,18,82,100,6597,23:00 - 24:59
fall,2012-07-30,0,12,46,58,7105,
fall,2012-07-30,1,4,15,19,7105,01:00 - 02:59
fall,2012-07-30,2,2,6,8,7105,01:00 - 02:59
fall,2012-07-30,3,0,3,3,7105,03:00 - 04:59
fall,2012-07-30,4,0,5,5,7105,03:00 - 04:59
fall,2012-07-30,5,4,43,47,7105,05:00 - 06:59
fall,2012-07-30,6,6,155,161,7105,05:00 - 06:59
fall,2012-07-30,7,14,455,469,7105,07:00 - 08:59
fall,2012-07-30,8,31,720,751,7105,07:00 - 08:59
fall,2012-07-30,9,34,259,293,7105,09:00 - 10:59
fall,2012-07-30,10,54,135,189,7105,09:00 - 10:59
fall,2012-07-30,11,69,146,215,7105,11:00 - 12:59
fall,2012-07-30,12,77,201,278,7105,11:00 - 12:59
fall,2012-07-30,13,57,169,226,7105,13:00 - 14:59
fall,2012-07-30,14,87,167,254,7105,13:00 - 14:59
fall,2012-07-30,15,51,185,236,7105,15:00 - 16:59
fall,2012-07-30,16,88,337,425,7105,15:00 - 16:59
fall,2012-07-30,17,62,765,827,7105,17:00 - 18:59
fall,2012-07-30,18,77,735,812,7105,17:00 - 18:59
fall,2012-07-30,19,81,584,665,7105,19:00 - 20:59
fall,2012-07-30,20,78,384,462,7105,19:00 - 20:59
fall,2012-07-30,21,71,251,322,7105,21:00 - 22:59
fall,2012-07-30,22,47,183,230,7105,21:00 - 22:59
fall,2012-07-30,23,34,116,150,7105,23:00 - 24:59
fall,2012-07-31,0,11,27,38,7216,
fall,2012-07-31,1,3,18,21,7216,01:00 - 02:59
fall,2012-07-31,2,0,8,8,7216,01:00 - 02:59
fall,2012-07-31,3,1,5,6,7216,03:00 - 04:59
fall,2012-07-31,4,0,6,6,7216,03:00 - 04:59
fall,2012-07-31,5,5,40,45,7216,05:00 - 06:59
fall,2012-07-31,6,2,192,194,7216,05:00 - 06:59
fall,2012-07-31,7,21,492,513,7216,07:00 - 08:59
fall,2012-07-31,8,30,730,760,7216,07:00 - 08:59
fall,2012-07-31,9,31,302,333,7216,09:00 - 10:59
fall,2012-07-31,10,73,154,227,7216,09:00 - 10:59
fall,2012-07-31,11,54,170,224,7216,11:00 - 12:59
fall,2012-07-31,12,50,198,248,7216,11:00 - 12:59
fall,2012-07-31,13,69,219,288,7216,13:00 - 14:59
fall,2012-07-31,14,72,188,260,7216,13:00 - 14:59
fall,2012-07-31,15,29,115,144,7216,15:00 - 16:59
fall,2012-07-31,16,66,336,402,7216,15:00 - 16:59
fall,2012-07-31,17,94,726,820,7216,17:00 - 18:59
fall,2012-07-31,18,99,758,857,7216,17:00 - 18:59
fall,2012-07-31,19,90,524,614,7216,19:00 - 20:59
fall,2012-07-31,20,55,397,452,7216,19:00 - 20:59
fall,2012-07-31,21,60,292,352,7216,21:00 - 22:59
fall,2012-07-31,22,33,224,257,7216,21:00 - 22:59
fall,2012-07-31,23,20,127,147,7216,23:00 - 24:59
fall,2012-08-01,0,3,44,47,7580,
fall,2012-08-01,1,5,28,33,7580,01:00 - 02:59
fall,2012-08-01,2,0,13,13,7580,01:00 - 02:59
fall,2012-08-01,3,0,7,7,7580,03:00 - 04:59
fall,2012-08-01,4,1,3,4,7580,03:00 - 04:59
fall,2012-08-01,5,3,46,49,7580,05:00 - 06:59
fall,2012-08-01,6,6,179,185,7580,05:00 - 06:59
fall,2012-08-01,7,19,468,487,7580,07:00 - 08:59
fall,2012-08-01,8,32,649,681,7580,07:00 - 08:59
fall,2012-08-01,9,34,316,350,7580,09:00 - 10:59
fall,2012-08-01,10,61,175,236,7580,09:00 - 10:59
fall,2012-08-01,11,54,180,234,7580,11:00 - 12:59
fall,2012-08-01,12,75,209,284,7580,11:00 - 12:59
fall,2012-08-01,13,59,221,280,7580,13:00 - 14:59
fall,2012-08-01,14,88,175,263,7580,13:00 - 14:59
fall,2012-08-01,15,89,206,295,7580,15:00 - 16:59
fall,2012-08-01,16,93,386,479,7580,15:00 - 16:59
fall,2012-08-01,17,103,734,837,7580,17:00 - 18:59
fall,2012-08-01,18,105,786,891,7580,17:00 - 18:59
fall,2012-08-01,19,88,564,652,7580,19:00 - 20:59
fall,2012-08-01,20,65,448,513,7580,19:00 - 20:59
fall,2012-08-01,21,36,284,320,7580,21:00 - 22:59
fall,2012-08-01,22,37,251,288,7580,21:00 - 22:59
fall,2012-08-01,23,18,134,152,7580,23:00 - 24:59
fall,2012-08-02,0,8,55,63,7261,
fall,2012-08-02,1,6,36,42,7261,01:00 - 02:59
fall,2012-08-02,2,3,8,11,7261,01:00 - 02:59
fall,2012-08-02,3,0,6,6,7261,03:00 - 04:59
fall,2012-08-02,4,0,9,9,7261,03:00 - 04:59
fall,2012-08-02,5,4,37,41,7261,05:00 - 06:59
fall,2012-08-02,6,6,177,183,7261,05:00 - 06:59
fall,2012-08-02,7,21,452,473,7261,07:00 - 08:59
fall,2012-08-02,8,21,718,739,7261,07:00 - 08:59
fall,2012-08-02,9,31,312,343,7261,09:00 - 10:59
fall,2012-08-02,10,51,130,181,7261,09:00 - 10:59
fall,2012-08-02,11,59,167,226,7261,11:00 - 12:59
fall,2012-08-02,12,56,230,286,7261,11:00 - 12:59
fall,2012-08-02,13,98,212,310,7261,13:00 - 14:59
fall,2012-08-02,14,54,171,225,7261,13:00 - 14:59
fall,2012-08-02,15,68,202,270,7261,15:00 - 16:59
fall,2012-08-02,16,71,335,406,7261,15:00 - 16:59
fall,2012-08-02,17,90,775,865,7261,17:00 - 18:59
fall,2012-08-02,18,86,681,767,7261,17:00 - 18:59
fall,2012-08-02,19,98,509,607,7261,19:00 - 20:59
fall,2012-08-02,20,51,376,427,7261,19:00 - 20:59
fall,2012-08-02,21,41,301,342,7261,21:00 - 22:59
fall,2012-08-02,22,35,227,262,7261,21:00 - 22:59
fall,2012-08-02,23,25,152,177,7261,23:00 - 24:59
fall,2012-08-03,0,15,56,71,7175,
fall,2012-08-03,1,11,32,43,7175,01:00 - 02:59
fall,2012-08-03,2,0,14,14,7175,01:00 - 02:59
fall,2012-08-03,3,1,5,6,7175,03:00 - 04:59
fall,2012-08-03,4,1,11,12,7175,03:00 - 04:59
fall,2012-08-03,5,2,35,37,7175,05:00 - 06:59
fall,2012-08-03,6,5,158,163,7175,05:00 - 06:59
fall,2012-08-03,7,25,396,421,7175,07:00 - 08:59
fall,2012-08-03,8,32,636,668,7175,07:00 - 08:59
fall,2012-08-03,9,69,327,396,7175,09:00 - 10:59
fall,2012-08-03,10,82,167,249,7175,09:00 - 10:59
fall,2012-08-03,11,77,186,263,7175,11:00 - 12:59
fall,2012-08-03,12,95,243,338,7175,11:00 - 12:59
fall,2012-08-03,13,98,247,345,7175,13:00 - 14:59
fall,2012-08-03,14,102,229,331,7175,13:00 - 14:59
fall,2012-08-03,15,112,268,380,7175,15:00 - 16:59
fall,2012-08-03,16,112,380,492,7175,15:00 - 16:59
fall,2012-08-03,17,95,646,741,7175,17:00 - 18:59
fall,2012-08-03,18,98,573,671,7175,17:00 - 18:59
fall,2012-08-03,19,81,388,469,7175,19:00 - 20:59
fall,2012-08-03,20,89,300,389,7175,19:00 - 20:59
fall,2012-08-03,21,54,224,278,7175,21:00 - 22:59
fall,2012-08-03,22,46,156,202,7175,21:00 - 22:59
fall,2012-08-03,23,26,170,196,7175,23:00 - 24:59
fall,2012-08-04,0,24,137,161,6824,
fall,2012-08-04,1,23,99,122,6824,01:00 - 02:59
fall,2012-08-04,2,20,64,84,6824,01:00 - 02:59
fall,2012-08-04,3,11,19,30,6824,03:00 - 04:59
fall,2012-08-04,4,2,11,13,6824,03:00 - 04:59
fall,2012-08-04,5,1,16,17,6824,05:00 - 06:59
fall,2012-08-04,6,12,37,49,6824,05:00 - 06:59
fall,2012-08-04,7,18,49,67,6824,07:00 - 08:59
fall,2012-08-04,8,49,132,181,6824,07:00 - 08:59
fall,2012-08-04,9,61,217,278,6824,09:00 - 10:59
fall,2012-08-04,10,108,288,396,6824,09:00 - 10:59
fall,2012-08-04,11,155,315,470,6824,11:00 - 12:59
fall,2012-08-04,12,222,325,547,6824,11:00 - 12:59
fall,2012-08-04,13,195,332,527,6824,13:00 - 14:59
fall,2012-08-04,14,183,289,472,6824,13:00 - 14:59
fall,2012-08-04,15,205,284,489,6824,15:00 - 16:59
fall,2012-08-04,16,197,253,450,6824,15:00 - 16:59
fall,2012-08-04,17,179,313,492,6824,17:00 - 18:59
fall,2012-08-04,18,169,321,490,6824,17:00 - 18:59
fall,2012-08-04,19,133,264,397,6824,19:00 - 20:59
fall,2012-08-04,20,117,195,312,6824,19:00 - 20:59
fall,2012-08-04,21,96,193,289,6824,21:00 - 22:59
fall,2012-08-04,22,104,165,269,6824,21:00 - 22:59
fall,2012-08-04,23,61,161,222,6824,23:00 - 24:59
fall,2012-08-05,0,32,121,153,5464,
fall,2012-08-05,1,8,79,87,5464,01:00 - 02:59
fall,2012-08-05,2,5,68,73,5464,01:00 - 02:59
fall,2012-08-05,3,9,32,41,5464,03:00 - 04:59
fall,2012-08-05,4,3,11,14,5464,03:00 - 04:59
fall,2012-08-05,5,1,18,19,5464,05:00 - 06:59
fall,2012-08-05,6,7,12,19,5464,05:00 - 06:59
fall,2012-08-05,7,18,50,68,5464,07:00 - 08:59
fall,2012-08-05,8,27,81,108,5464,07:00 - 08:59
fall,2012-08-05,9,61,168,229,5464,09:00 - 10:59
fall,2012-08-05,10,111,253,364,5464,09:00 - 10:59
fall,2012-08-05,11,155,282,437,5464,11:00 - 12:59
fall,2012-08-05,12,161,330,491,5464,11:00 - 12:59
fall,2012-08-05,13,208,315,523,5464,13:00 - 14:59
fall,2012-08-05,14,161,365,526,5464,13:00 - 14:59
fall,2012-08-05,15,164,286,450,5464,15:00 - 16:59
fall,2012-08-05,16,143,278,421,5464,15:00 - 16:59
fall,2012-08-05,17,122,260,382,5464,17:00 - 18:59
fall,2012-08-05,18,75,154,229,5464,17:00 - 18:59
fall,2012-08-05,19,46,139,185,5464,19:00 - 20:59
fall,2012-08-05,20,53,140,193,5464,19:00 - 20:59
fall,2012-08-05,21,51,157,208,5464,21:00 - 22:59
fall,2012-08-05,22,57,100,157,5464,21:00 - 22:59
fall,2012-08-05,23,29,58,87,5464,23:00 - 24:59
fall,2012-08-06,0,9,24,33,7013,
fall,2012-08-06,1,1,10,11,7013,01:00 - 02:59
fall,2012-08-06,2,0,5,5,7013,01:00 - 02:59
fall,2012-08-06,3,0,5,5,7013,03:00 - 04:59
fall,2012-08-06,4,3,8,11,7013,03:00 - 04:59
fall,2012-08-06,5,2,23,25,7013,05:00 - 06:59
fall,2012-08-06,6,4,137,141,7013,05:00 - 06:59
fall,2012-08-06,7,14,393,407,7013,07:00 - 08:59
fall,2012-08-06,8,27,578,605,7013,07:00 - 08:59
fall,2012-08-06,9,28,248,276,7013,09:00 - 10:59
fall,2012-08-06,10,54,159,213,7013,09:00 - 10:59
fall,2012-08-06,11,108,152,260,7013,11:00 - 12:59
fall,2012-08-06,12,72,213,285,7013,11:00 - 12:59
fall,2012-08-06,13,85,204,289,7013,13:00 - 14:59
fall,2012-08-06,14,99,188,287,7013,13:00 - 14:59
fall,2012-08-06,15,91,183,274,7013,15:00 - 16:59
fall,2012-08-06,16,88,363,451,7013,15:00 - 16:59
fall,2012-08-06,17,112,746,858,7013,17:00 - 18:59
fall,2012-08-06,18,100,743,843,7013,17:00 - 18:59
fall,2012-08-06,19,109,531,640,7013,19:00 - 20:59
fall,2012-08-06,20,89,368,457,7013,19:00 - 20:59
fall,2012-08-06,21,72,245,317,7013,21:00 - 22:59
fall,2012-08-06,22,50,157,207,7013,21:00 - 22:59
fall,2012-08-06,23,16,97,113,7013,23:00 - 24:59
fall,2012-08-07,0,15,32,47,7273,
fall,2012-08-07,1,2,16,18,7273,01:00 - 02:59
fall,2012-08-07,2,6,7,13,7273,01:00 - 02:59
fall,2012-08-07,3,0,6,6,7273,03:00 - 04:59
fall,2012-08-07,4,2,7,9,7273,03:00 - 04:59
fall,2012-08-07,5,3,33,36,7273,05:00 - 06:59
fall,2012-08-07,6,3,176,179,7273,05:00 - 06:59
fall,2012-08-07,7,21,481,502,7273,07:00 - 08:59
fall,2012-08-07,8,41,664,705,7273,07:00 - 08:59
fall,2012-08-07,9,44,283,327,7273,09:00 - 10:59
fall,2012-08-07,10,89,161,250,7273,09:00 - 10:59
fall,2012-08-07,11,84,130,214,7273,11:00 - 12:59
fall,2012-08-07,12,86,197,283,7273,11:00 - 12:59
fall,2012-08-07,13,68,185,253,7273,13:00 - 14:59
fall,2012-08-07,14,76,185,261,7273,13:00 - 14:59
fall,2012-08-07,15,100,206,306,7273,15:00 - 16:59
fall,2012-08-07,16,101,344,445,7273,15:00 - 16:59
fall,2012-08-07,17,125,743,868,7273,17:00 - 18:59
fall,2012-08-07,18,103,711,814,7273,17:00 - 18:59
fall,2012-08-07,19,104,506,610,7273,19:00 - 20:59
fall,2012-08-07,20,74,374,448,7273,19:00 - 20:59
fall,2012-08-07,21,70,247,317,7273,21:00 - 22:59
fall,2012-08-07,22,43,181,224,7273,21:00 - 22:59
fall,2012-08-07,23,18,120,138,7273,23:00 - 24:59
fall,2012-08-08,0,12,46,58,7534,
fall,2012-08-08,1,3,20,23,7534,01:00 - 02:59
fall,2012-08-08,2,1,5,6,7534,01:00 - 02:59
fall,2012-08-08,3,1,6,7,7534,03:00 - 04:59
fall,2012-08-08,4,1,6,7,7534,03:00 - 04:59
fall,2012-08-08,5,3,40,43,7534,05:00 - 06:59
fall,2012-08-08,6,4,169,173,7534,05:00 - 06:59
fall,2012-08-08,7,24,458,482,7534,07:00 - 08:59
fall,2012-08-08,8,48,689,737,7534,07:00 - 08:59
fall,2012-08-08,9,33,308,341,7534,09:00 - 10:59
fall,2012-08-08,10,63,151,214,7534,09:00 - 10:59
fall,2012-08-08,11,80,159,239,7534,11:00 - 12:59
fall,2012-08-08,12,63,217,280,7534,11:00 - 12:59
fall,2012-08-08,13,101,212,313,7534,13:00 - 14:59
fall,2012-08-08,14,63,173,236,7534,13:00 - 14:59
fall,2012-08-08,15,110,168,278,7534,15:00 - 16:59
fall,2012-08-08,16,113,328,441,7534,15:00 - 16:59
fall,2012-08-08,17,107,751,858,7534,17:00 - 18:59
fall,2012-08-08,18,117,745,862,7534,17:00 - 18:59
fall,2012-08-08,19,119,567,686,7534,19:00 - 20:59
fall,2012-08-08,20,76,424,500,7534,19:00 - 20:59
fall,2012-08-08,21,70,311,381,7534,21:00 - 22:59
fall,2012-08-08,22,35,198,233,7534,21:00 - 22:59
fall,2012-08-08,23,16,120,136,7534,23:00 - 24:59
fall,2012-08-09,0,16,51,67,7286,
fall,2012-08-09,1,5,23,28,7286,01:00 - 02:59
fall,2012-08-09,2,2,12,14,7286,01:00 - 02:59
fall,2012-08-09,3,1,5,6,7286,03:00 - 04:59
fall,2012-08-09,4,0,10,10,7286,03:00 - 04:59
fall,2012-08-09,5,4,37,41,7286,05:00 - 06:59
fall,2012-08-09,6,5,162,167,7286,05:00 - 06:59
fall,2012-08-09,7,24,451,475,7286,07:00 - 08:59
fall,2012-08-09,8,28,670,698,7286,07:00 - 08:59
fall,2012-08-09,9,54,299,353,7286,09:00 - 10:59
fall,2012-08-09,10,72,133,205,7286,09:00 - 10:59
fall,2012-08-09,11,94,166,260,7286,11:00 - 12:59
fall,2012-08-09,12,85,192,277,7286,11:00 - 12:59
fall,2012-08-09,13,80,201,281,7286,13:00 - 14:59
fall,2012-08-09,14,86,161,247,7286,13:00 - 14:59
fall,2012-08-09,15,63,204,267,7286,15:00 - 16:59
fall,2012-08-09,16,97,320,417,7286,15:00 - 16:59
fall,2012-08-09,17,111,699,810,7286,17:00 - 18:59
fall,2012-08-09,18,78,733,811,7286,17:00 - 18:59
fall,2012-08-09,19,90,533,623,7286,19:00 - 20:59
fall,2012-08-09,20,91,387,478,7286,19:00 - 20:59
fall,2012-08-09,21,50,286,336,7286,21:00 - 22:59
fall,2012-08-09,22,41,218,259,7286,21:00 - 22:59
fall,2012-08-09,23,19,137,156,7286,23:00 - 24:59
fall,2012-08-10,0,17,68,85,5786,
fall,2012-08-10,1,6,35,41,5786,01:00 - 02:59
fall,2012-08-10,2,6,14,20,5786,01:00 - 02:59
fall,2012-08-10,3,3,6,9,5786,03:00 - 04:59
fall,2012-08-10,4,0,7,7,5786,03:00 - 04:59
fall,2012-08-10,5,4,29,33,5786,05:00 - 06:59
fall,2012-08-10,6,3,41,44,5786,05:00 - 06:59
fall,2012-08-10,7,5,128,133,5786,07:00 - 08:59
fall,2012-08-10,8,7,112,119,5786,07:00 - 08:59
fall,2012-08-10,9,21,199,220,5786,09:00 - 10:59
fall,2012-08-10,10,27,166,193,5786,09:00 - 10:59
fall,2012-08-10,11,73,178,251,5786,11:00 - 12:59
fall,2012-08-10,12,75,240,315,5786,11:00 - 12:59
fall,2012-08-10,13,66,224,290,5786,13:00 - 14:59
fall,2012-08-10,14,71,236,307,5786,13:00 - 14:59
fall,2012-08-10,15,100,224,324,5786,15:00 - 16:59
fall,2012-08-10,16,96,371,467,5786,15:00 - 16:59
fall,2012-08-10,17,111,619,730,5786,17:00 - 18:59
fall,2012-08-10,18,88,552,640,5786,17:00 - 18:59
fall,2012-08-10,19,98,394,492,5786,19:00 - 20:59
fall,2012-08-10,20,55,315,370,5786,19:00 - 20:59
fall,2012-08-10,21,50,236,286,5786,21:00 - 22:59
fall,2012-08-10,22,50,168,218,5786,21:00 - 22:59
fall,2012-08-10,23,33,159,192,5786,23:00 - 24:59
fall,2012-08-11,0,38,142,180,6299,
fall,2012-08-11,1,32,84,116,6299,01:00 - 02:59
fall,2012-08-11,2,19,66,85,6299,01:00 - 02:59
fall,2012-08-11,3,2,19,21,6299,03:00 - 04:59
fall,2012-08-11,4,3,7,10,6299,03:00 - 04:59
fall,2012-08-11,5,2,9,11,6299,05:00 - 06:59
fall,2012-08-11,6,5,18,23,6299,05:00 - 06:59
fall,2012-08-11,7,8,54,62,6299,07:00 - 08:59
fall,2012-08-11,8,30,132,162,6299,07:00 - 08:59
fall,2012-08-11,9,54,217,271,6299,09:00 - 10:59
fall,2012-08-11,10,125,282,407,6299,09:00 - 10:59
fall,2012-08-11,11,203,296,499,6299,11:00 - 12:59
fall,2012-08-11,12,214,332,546,6299,11:00 - 12:59
fall,2012-08-11,13,228,341,569,6299,13:00 - 14:59
fall,2012-08-11,14,248,290,538,6299,13:00 - 14:59
fall,2012-08-11,15,246,316,562,6299,15:00 - 16:59
fall,2012-08-11,16,227,304,531,6299,15:00 - 16:59
fall,2012-08-11,17,220,292,512,6299,17:00 - 18:59
fall,2012-08-11,18,107,193,300,6299,17:00 - 18:59
fall,2012-08-11,19,97,178,275,6299,19:00 - 20:59
fall,2012-08-11,20,31,129,160,6299,19:00 - 20:59
fall,2012-08-11,21,26,102,128,6299,21:00 - 22:59
fall,2012-08-11,22,40,128,168,6299,21:00 - 22:59
fall,2012-08-11,23,42,121,163,6299,23:00 - 24:59
fall,2012-08-12,0,24,96,120,6544,
fall,2012-08-12,1,21,92,113,6544,01:00 - 02:59
fall,2012-08-12,2,19,67,86,6544,01:00 - 02:59
fall,2012-08-12,3,11,37,48,6544,03:00 - 04:59
fall,2012-08-12,4,2,8,10,6544,03:00 - 04:59
fall,2012-08-12,5,1,9,10,6544,05:00 - 06:59
fall,2012-08-12,6,2,14,16,6544,05:00 - 06:59
fall,2012-08-12,7,9,30,39,6544,07:00 - 08:59
fall,2012-08-12,8,35,84,119,6544,07:00 - 08:59
fall,2012-08-12,9,64,153,217,6544,09:00 - 10:59
fall,2012-08-12,10,88,240,328,6544,09:00 - 10:59
fall,2012-08-12,11,167,282,449,6544,11:00 - 12:59
fall,2012-08-12,12,163,342,505,6544,11:00 - 12:59
fall,2012-08-12,13,178,365,543,6544,13:00 - 14:59
fall,2012-08-12,14,213,366,579,6544,13:00 - 14:59
fall,2012-08-12,15,235,342,577,6544,15:00 - 16:59
fall,2012-08-12,16,213,300,513,6544,15:00 - 16:59
fall,2012-08-12,17,186,319,505,6544,17:00 - 18:59
fall,2012-08-12,18,164,327,491,6544,17:00 - 18:59
fall,2012-08-12,19,148,317,465,6544,19:00 - 20:59
fall,2012-08-12,20,96,204,300,6544,19:00 - 20:59
fall,2012-08-12,21,78,142,220,6544,21:00 - 22:59
fall,2012-08-12,22,40,141,181,6544,21:00 - 22:59
fall,2012-08-12,23,25,85,110,6544,23:00 - 24:59
fall,2012-08-13,0,14,33,47,6883,
fall,2012-08-13,1,3,11,14,6883,01:00 - 02:59
fall,2012-08-13,2,1,8,9,6883,01:00 - 02:59
fall,2012-08-13,3,1,5,6,6883,03:00 - 04:59
fall,2012-08-13,4,0,11,11,6883,03:00 - 04:59
fall,2012-08-13,5,3,33,36,6883,05:00 - 06:59
fall,2012-08-13,6,4,155,159,6883,05:00 - 06:59
fall,2012-08-13,7,11,425,436,6883,07:00 - 08:59
fall,2012-08-13,8,25,648,673,6883,07:00 - 08:59
fall,2012-08-13,9,40,265,305,6883,09:00 - 10:59
fall,2012-08-13,10,88,111,199,6883,09:00 - 10:59
fall,2012-08-13,11,94,151,245,6883,11:00 - 12:59
fall,2012-08-13,12,96,180,276,6883,11:00 - 12:59
fall,2012-08-13,13,79,175,254,6883,13:00 - 14:59
fall,2012-08-13,14,85,163,248,6883,13:00 - 14:59
fall,2012-08-13,15,80,194,274,6883,15:00 - 16:59
fall,2012-08-13,16,116,348,464,6883,15:00 - 16:59
fall,2012-08-13,17,102,716,818,6883,17:00 - 18:59
fall,2012-08-13,18,103,709,812,6883,17:00 - 18:59
fall,2012-08-13,19,88,467,555,6883,19:00 - 20:59
fall,2012-08-13,20,58,374,432,6883,19:00 - 20:59
fall,2012-08-13,21,44,246,290,6883,21:00 - 22:59
fall,2012-08-13,22,44,148,192,6883,21:00 - 22:59
fall,2012-08-13,23,28,100,128,6883,23:00 - 24:59
fall,2012-08-14,0,12,48,60,6784,
fall,2012-08-14,1,8,19,27,6784,01:00 - 02:59
fall,2012-08-14,2,2,9,11,6784,01:00 - 02:59
fall,2012-08-14,3,0,3,3,6784,03:00 - 04:59
fall,2012-08-14,4,0,5,5,6784,03:00 - 04:59
fall,2012-08-14,5,1,35,36,6784,05:00 - 06:59
fall,2012-08-14,6,1,63,64,6784,05:00 - 06:59
fall,2012-08-14,7,1,178,179,6784,07:00 - 08:59
fall,2012-08-14,8,27,591,618,6784,07:00 - 08:59
fall,2012-08-14,9,48,354,402,6784,09:00 - 10:59
fall,2012-08-14,10,53,155,208,6784,09:00 - 10:59
fall,2012-08-14,11,69,127,196,6784,11:00 - 12:59
fall,2012-08-14,12,93,207,300,6784,11:00 - 12:59
fall,2012-08-14,13,83,203,286,6784,13:00 - 14:59
fall,2012-08-14,14,80,175,255,6784,13:00 - 14:59
fall,2012-08-14,15,84,199,283,6784,15:00 - 16:59
fall,2012-08-14,16,95,363,458,6784,15:00 - 16:59
fall,2012-08-14,17,78,734,812,6784,17:00 - 18:59
fall,2012-08-14,18,97,757,854,6784,17:00 - 18:59
fall,2012-08-14,19,94,533,627,6784,19:00 - 20:59
fall,2012-08-14,20,65,371,436,6784,19:00 - 20:59
fall,2012-08-14,21,56,252,308,6784,21:00 - 22:59
fall,2012-08-14,22,28,161,189,6784,21:00 - 22:59
fall,2012-08-14,23,53,114,167,6784,23:00 - 24:59
fall,2012-08-15,0,8,52,60,7347,
fall,2012-08-15,1,6,31,37,7347,01:00 - 02:59
fall,2012-08-15,2,1,7,8,7347,01:00 - 02:59
fall,2012-08-15,3,1,10,11,7347,03:00 - 04:59
fall,2012-08-15,4,0,4,4,7347,03:00 - 04:59
fall,2012-08-15,5,4,35,39,7347,05:00 - 06:59
fall,2012-08-15,6,12,160,172,7347,05:00 - 06:59
fall,2012-08-15,7,25,467,492,7347,07:00 - 08:59
fall,2012-08-15,8,40,642,682,7347,07:00 - 08:59
fall,2012-08-15,9,57,310,367,7347,09:00 - 10:59
fall,2012-08-15,10,70,163,233,7347,09:00 - 10:59
fall,2012-08-15,11,80,155,235,7347,11:00 - 12:59
fall,2012-08-15,12,77,230,307,7347,11:00 - 12:59
fall,2012-08-15,13,88,206,294,7347,13:00 - 14:59
fall,2012-08-15,14,94,161,255,7347,13:00 - 14:59
fall,2012-08-15,15,70,196,266,7347,15:00 - 16:59
fall,2012-08-15,16,91,340,431,7347,15:00 - 16:59
fall,2012-08-15,17,102,749,851,7347,17:00 - 18:59
fall,2012-08-15,18,80,768,848,7347,17:00 - 18:59
fall,2012-08-15,19,124,525,649,7347,19:00 - 20:59
fall,2012-08-15,20,72,355,427,7347,19:00 - 20:59
fall,2012-08-15,21,49,266,315,7347,21:00 - 22:59
fall,2012-08-15,22,29,197,226,7347,21:00 - 22:59
fall,2012-08-15,23,18,120,138,7347,23:00 - 24:59
fall,2012-08-16,0,13,63,76,7605,
fall,2012-08-16,1,3,18,21,7605,01:00 - 02:59
fall,2012-08-16,2,0,15,15,7605,01:00 - 02:59
fall,2012-08-16,3,0,4,4,7605,03:00 - 04:59
fall,2012-08-16,4,2,3,5,7605,03:00 - 04:59
fall,2012-08-16,5,7,30,37,7605,05:00 - 06:59
fall,2012-08-16,6,3,162,165,7605,05:00 - 06:59
fall,2012-08-16,7,16,448,464,7605,07:00 - 08:59
fall,2012-08-16,8,33,649,682,7605,07:00 - 08:59
fall,2012-08-16,9,41,296,337,7605,09:00 - 10:59
fall,2012-08-16,10,78,121,199,7605,09:00 - 10:59
fall,2012-08-16,11,83,191,274,7605,11:00 - 12:59
fall,2012-08-16,12,96,247,343,7605,11:00 - 12:59
fall,2012-08-16,13,81,219,300,7605,13:00 - 14:59
fall,2012-08-16,14,72,176,248,7605,13:00 - 14:59
fall,2012-08-16,15,63,197,260,7605,15:00 - 16:59
fall,2012-08-16,16,79,340,419,7605,15:00 - 16:59
fall,2012-08-16,17,130,767,897,7605,17:00 - 18:59
fall,2012-08-16,18,109,723,832,7605,17:00 - 18:59
fall,2012-08-16,19,119,558,677,7605,19:00 - 20:59
fall,2012-08-16,20,100,414,514,7605,19:00 - 20:59
fall,2012-08-16,21,83,273,356,7605,21:00 - 22:59
fall,2012-08-16,22,69,185,254,7605,21:00 - 22:59
fall,2012-08-16,23,58,168,226,7605,23:00 - 24:59
fall,2012-08-17,0,21,67,88,7148,
fall,2012-08-17,1,16,38,54,7148,01:00 - 02:59
fall,2012-08-17,2,4,15,19,7148,01:00 - 02:59
fall,2012-08-17,3,0,6,6,7148,03:00 - 04:59
fall,2012-08-17,4,0,9,9,7148,03:00 - 04:59
fall,2012-08-17,5,2,34,36,7148,05:00 - 06:59
fall,2012-08-17,6,6,151,157,7148,05:00 - 06:59
fall,2012-08-17,7,11,368,379,7148,07:00 - 08:59
fall,2012-08-17,8,43,625,668,7148,07:00 - 08:59
fall,2012-08-17,9,58,320,378,7148,09:00 - 10:59
fall,2012-08-17,10,82,149,231,7148,09:00 - 10:59
fall,2012-08-17,11,98,205,303,7148,11:00 - 12:59
fall,2012-08-17,12,110,255,365,7148,11:00 - 12:59
fall,2012-08-17,13,103,254,357,7148,13:00 - 14:59
fall,2012-08-17,14,128,200,328,7148,13:00 - 14:59
fall,2012-08-17,15,127,256,383,7148,15:00 - 16:59
fall,2012-08-17,16,116,372,488,7148,15:00 - 16:59
fall,2012-08-17,17,144,647,791,7148,17:00 - 18:59
fall,2012-08-17,18,108,561,669,7148,17:00 - 18:59
fall,2012-08-17,19,88,403,491,7148,19:00 - 20:59
fall,2012-08-17,20,97,262,359,7148,19:00 - 20:59
fall,2012-08-17,21,57,198,255,7148,21:00 - 22:59
fall,2012-08-17,22,43,170,213,7148,21:00 - 22:59
fall,2012-08-17,23,21,100,121,7148,23:00 - 24:59
fall,2012-08-18,0,6,99,105,7865,
fall,2012-08-18,1,14,78,92,7865,01:00 - 02:59
fall,2012-08-18,2,4,39,43,7865,01:00 - 02:59
fall,2012-08-18,3,7,23,30,7865,03:00 - 04:59
fall,2012-08-18,4,5,8,13,7865,03:00 - 04:59
fall,2012-08-18,5,2,7,9,7865,05:00 - 06:59
fall,2012-08-18,6,4,23,27,7865,05:00 - 06:59
fall,2012-08-18,7,12,52,64,7865,07:00 - 08:59
fall,2012-08-18,8,28,161,189,7865,07:00 - 08:59
fall,2012-08-18,9,81,211,292,7865,09:00 - 10:59
fall,2012-08-18,10,166,314,480,7865,09:00 - 10:59
fall,2012-08-18,11,180,356,536,7865,11:00 - 12:59
fall,2012-08-18,12,266,388,654,7865,11:00 - 12:59
fall,2012-08-18,13,289,355,644,7865,13:00 - 14:59
fall,2012-08-18,14,242,356,598,7865,13:00 - 14:59
fall,2012-08-18,15,250,346,596,7865,15:00 - 16:59
fall,2012-08-18,16,287,354,641,7865,15:00 - 16:59
fall,2012-08-18,17,256,379,635,7865,17:00 - 18:59
fall,2012-08-18,18,225,329,554,7865,17:00 - 18:59
fall,2012-08-18,19,164,324,488,7865,19:00 - 20:59
fall,2012-08-18,20,99,242,341,7865,19:00 - 20:59
fall,2012-08-18,21,90,248,338,7865,21:00 - 22:59
fall,2012-08-18,22,90,171,261,7865,21:00 - 22:59
fall,2012-08-18,23,60,175,235,7865,23:00 - 24:59
fall,2012-08-19,0,44,143,187,4549,
fall,2012-08-19,1,29,102,131,4549,01:00 - 02:59
fall,2012-08-19,2,16,103,119,4549,01:00 - 02:59
fall,2012-08-19,3,21,34,55,4549,03:00 - 04:59
fall,2012-08-19,4,4,22,26,4549,03:00 - 04:59
fall,2012-08-19,5,3,8,11,4549,05:00 - 06:59
fall,2012-08-19,6,5,15,20,4549,05:00 - 06:59
fall,2012-08-19,7,12,29,41,4549,07:00 - 08:59
fall,2012-08-19,8,34,90,124,4549,07:00 - 08:59
fall,2012-08-19,9,86,184,270,4549,09:00 - 10:59
fall,2012-08-19,10,138,287,425,4549,09:00 - 10:59
fall,2012-08-19,11,83,189,272,4549,11:00 - 12:59
fall,2012-08-19,12,112,186,298,4549,11:00 - 12:59
fall,2012-08-19,13,50,112,162,4549,13:00 - 14:59
fall,2012-08-19,14,41,108,149,4549,13:00 - 14:59
fall,2012-08-19,15,89,187,276,4549,15:00 - 16:59
fall,2012-08-19,16,97,259,356,4549,15:00 - 16:59
fall,2012-08-19,17,76,267,343,4549,17:00 - 18:59
fall,2012-08-19,18,86,291,377,4549,17:00 - 18:59
fall,2012-08-19,19,72,269,341,4549,19:00 - 20:59
fall,2012-08-19,20,61,213,274,4549,19:00 - 20:59
fall,2012-08-19,21,36,154,190,4549,21:00 - 22:59
fall,2012-08-19,22,6,50,56,4549,21:00 - 22:59
fall,2012-08-19,23,7,39,46,4549,23:00 - 24:59
fall,2012-08-20,0,1,25,26,6530,
fall,2012-08-20,1,0,10,10,6530,01:00 - 02:59
fall,2012-08-20,2,0,5,5,6530,01:00 - 02:59
fall,2012-08-20,3,0,3,3,6530,03:00 - 04:59
fall,2012-08-20,4,0,7,7,6530,03:00 - 04:59
fall,2012-08-20,5,2,35,37,6530,05:00 - 06:59
fall,2012-08-20,6,6,155,161,6530,05:00 - 06:59
fall,2012-08-20,7,15,427,442,6530,07:00 - 08:59
fall,2012-08-20,8,37,618,655,6530,07:00 - 08:59
fall,2012-08-20,9,55,302,357,6530,09:00 - 10:59
fall,2012-08-20,10,69,124,193,6530,09:00 - 10:59
fall,2012-08-20,11,90,151,241,6530,11:00 - 12:59
fall,2012-08-20,12,66,216,282,6530,11:00 - 12:59
fall,2012-08-20,13,97,194,291,6530,13:00 - 14:59
fall,2012-08-20,14,87,188,275,6530,13:00 - 14:59
fall,2012-08-20,15,102,207,309,6530,15:00 - 16:59
fall,2012-08-20,16,103,357,460,6530,15:00 - 16:59
fall,2012-08-20,17,83,810,893,6530,17:00 - 18:59
fall,2012-08-20,18,89,726,815,6530,17:00 - 18:59
fall,2012-08-20,19,33,266,299,6530,19:00 - 20:59
fall,2012-08-20,20,30,231,261,6530,19:00 - 20:59
fall,2012-08-20,21,26,219,245,6530,21:00 - 22:59
fall,2012-08-20,22,25,136,161,6530,21:00 - 22:59
fall,2012-08-20,23,10,92,102,6530,23:00 - 24:59
fall,2012-08-21,0,7,52,59,7006,
fall,2012-08-21,1,11,22,33,7006,01:00 - 02:59
fall,2012-08-21,2,1,7,8,7006,01:00 - 02:59
fall,2012-08-21,3,0,3,3,7006,03:00 - 04:59
fall,2012-08-21,4,0,4,4,7006,03:00 - 04:59
fall,2012-08-21,5,4,30,34,7006,05:00 - 06:59
fall,2012-08-21,6,5,164,169,7006,05:00 - 06:59
fall,2012-08-21,7,19,500,519,7006,07:00 - 08:59
fall,2012-08-21,8,27,696,723,7006,07:00 - 08:59
fall,2012-08-21,9,47,281,328,7006,09:00 - 10:59
fall,2012-08-21,10,58,120,178,7006,09:00 - 10:59
fall,2012-08-21,11,61,195,256,7006,11:00 - 12:59
fall,2012-08-21,12,79,226,305,7006,11:00 - 12:59
fall,2012-08-21,13,76,255,331,7006,13:00 - 14:59
fall,2012-08-21,14,110,192,302,7006,13:00 - 14:59
fall,2012-08-21,15,76,226,302,7006,15:00 - 16:59
fall,2012-08-21,16,109,358,467,7006,15:00 - 16:59
fall,2012-08-21,17,92,786,878,7006,17:00 - 18:59
fall,2012-08-21,18,93,532,625,7006,17:00 - 18:59
fall,2012-08-21,19,56,420,476,7006,19:00 - 20:59
fall,2012-08-21,20,62,296,358,7006,19:00 - 20:59
fall,2012-08-21,21,41,239,280,7006,21:00 - 22:59
fall,2012-08-21,22,24,208,232,7006,21:00 - 22:59
fall,2012-08-21,23,23,113,136,7006,23:00 - 24:59
fall,2012-08-22,0,9,46,55,7375,
fall,2012-08-22,1,1,20,21,7375,01:00 - 02:59
fall,2012-08-22,2,7,10,17,7375,01:00 - 02:59
fall,2012-08-22,3,0,7,7,7375,03:00 - 04:59
fall,2012-08-22,4,1,7,8,7375,03:00 - 04:59
fall,2012-08-22,5,2,38,40,7375,05:00 - 06:59
fall,2012-08-22,6,12,175,187,7375,05:00 - 06:59
fall,2012-08-22,7,16,537,553,7375,07:00 - 08:59
fall,2012-08-22,8,37,703,740,7375,07:00 - 08:59
fall,2012-08-22,9,41,335,376,7375,09:00 - 10:59
fall,2012-08-22,10,66,159,225,7375,09:00 - 10:59
fall,2012-08-22,11,71,196,267,7375,11:00 - 12:59
fall,2012-08-22,12,59,253,312,7375,11:00 - 12:59
fall,2012-08-22,13,74,242,316,7375,13:00 - 14:59
fall,2012-08-22,14,82,184,266,7375,13:00 - 14:59
fall,2012-08-22,15,94,222,316,7375,15:00 - 16:59
fall,2012-08-22,16,102,358,460,7375,15:00 - 16:59
fall,2012-08-22,17,72,711,783,7375,17:00 - 18:59
fall,2012-08-22,18,91,592,683,7375,17:00 - 18:59
fall,2012-08-22,19,56,524,580,7375,19:00 - 20:59
fall,2012-08-22,20,59,332,391,7375,19:00 - 20:59
fall,2012-08-22,21,60,291,351,7375,21:00 - 22:59
fall,2012-08-22,22,55,226,281,7375,21:00 - 22:59
fall,2012-08-22,23,27,113,140,7375,23:00 - 24:59
fall,2012-08-23,0,9,51,60,7765,
fall,2012-08-23,1,10,15,25,7765,01:00 - 02:59
fall,2012-08-23,2,9,11,20,7765,01:00 - 02:59
fall,2012-08-23,3,3,6,9,7765,03:00 - 04:59
fall,2012-08-23,4,0,6,6,7765,03:00 - 04:59
fall,2012-08-23,5,1,36,37,7765,05:00 - 06:59
fall,2012-08-23,6,14,178,192,7765,05:00 - 06:59
fall,2012-08-23,7,18,463,481,7765,07:00 - 08:59
fall,2012-08-23,8,45,662,707,7765,07:00 - 08:59
fall,2012-08-23,9,58,354,412,7765,09:00 - 10:59
fall,2012-08-23,10,76,157,233,7765,09:00 - 10:59
fall,2012-08-23,11,86,192,278,7765,11:00 - 12:59
fall,2012-08-23,12,97,235,332,7765,11:00 - 12:59
fall,2012-08-23,13,93,253,346,7765,13:00 - 14:59
fall,2012-08-23,14,114,191,305,7765,13:00 - 14:59
fall,2012-08-23,15,104,201,305,7765,15:00 - 16:59
fall,2012-08-23,16,121,344,465,7765,15:00 - 16:59
fall,2012-08-23,17,111,709,820,7765,17:00 - 18:59
fall,2012-08-23,18,130,811,941,7765,17:00 - 18:59
fall,2012-08-23,19,96,537,633,7765,19:00 - 20:59
fall,2012-08-23,20,70,404,474,7765,19:00 - 20:59
fall,2012-08-23,21,53,276,329,7765,21:00 - 22:59
fall,2012-08-23,22,21,177,198,7765,21:00 - 22:59
fall,2012-08-23,23,24,133,157,7765,23:00 - 24:59
fall,2012-08-24,0,27,84,111,7582,
fall,2012-08-24,1,5,37,42,7582,01:00 - 02:59
fall,2012-08-24,2,1,15,16,7582,01:00 - 02:59
fall,2012-08-24,3,2,6,8,7582,03:00 - 04:59
fall,2012-08-24,4,2,6,8,7582,03:00 - 04:59
fall,2012-08-24,5,1,37,38,7582,05:00 - 06:59
fall,2012-08-24,6,9,142,151,7582,05:00 - 06:59
fall,2012-08-24,7,13,412,425,7582,07:00 - 08:59
fall,2012-08-24,8,41,703,744,7582,07:00 - 08:59
fall,2012-08-24,9,58,331,389,7582,09:00 - 10:59
fall,2012-08-24,10,78,184,262,7582,09:00 - 10:59
fall,2012-08-24,11,69,212,281,7582,11:00 - 12:59
fall,2012-08-24,12,95,276,371,7582,11:00 - 12:59
fall,2012-08-24,13,79,272,351,7582,13:00 - 14:59
fall,2012-08-24,14,109,229,338,7582,13:00 - 14:59
fall,2012-08-24,15,99,251,350,7582,15:00 - 16:59
fall,2012-08-24,16,101,414,515,7582,15:00 - 16:59
fall,2012-08-24,17,117,695,812,7582,17:00 - 18:59
fall,2012-08-24,18,109,627,736,7582,17:00 - 18:59
fall,2012-08-24,19,106,430,536,7582,19:00 - 20:59
fall,2012-08-24,20,66,297,363,7582,19:00 - 20:59
fall,2012-08-24,21,58,248,306,7582,21:00 - 22:59
fall,2012-08-24,22,42,209,251,7582,21:00 - 22:59
fall,2012-08-24,23,38,140,178,7582,23:00 - 24:59
fall,2012-08-25,0,21,114,135,6053,
fall,2012-08-25,1,15,100,115,6053,01:00 - 02:59
fall,2012-08-25,2,18,61,79,6053,01:00 - 02:59
fall,2012-08-25,3,7,31,38,6053,03:00 - 04:59
fall,2012-08-25,4,3,9,12,6053,03:00 - 04:59
fall,2012-08-25,5,4,10,14,6053,05:00 - 06:59
fall,2012-08-25,6,5,25,30,6053,05:00 - 06:59
fall,2012-08-25,7,14,88,102,6053,07:00 - 08:59
fall,2012-08-25,8,29,133,162,6053,07:00 - 08:59
fall,2012-08-25,9,60,228,288,6053,09:00 - 10:59
fall,2012-08-25,10,148,294,442,6053,09:00 - 10:59
fall,2012-08-25,11,143,314,457,6053,11:00 - 12:59
fall,2012-08-25,12,217,367,584,6053,11:00 - 12:59
fall,2012-08-25,13,186,331,517,6053,13:00 - 14:59
fall,2012-08-25,14,150,332,482,6053,13:00 - 14:59
fall,2012-08-25,15,79,154,233,6053,15:00 - 16:59
fall,2012-08-25,16,174,260,434,6053,15:00 - 16:59
fall,2012-08-25,17,132,271,403,6053,17:00 - 18:59
fall,2012-08-25,18,122,261,383,6053,17:00 - 18:59
fall,2012-08-25,19,97,257,354,6053,19:00 - 20:59
fall,2012-08-25,20,65,176,241,6053,19:00 - 20:59
fall,2012-08-25,21,60,148,208,6053,21:00 - 22:59
fall,2012-08-25,22,46,136,182,6053,21:00 - 22:59
fall,2012-08-25,23,34,124,158,6053,23:00 - 24:59
fall,2012-08-26,0,23,111,134,5255,
fall,2012-08-26,1,18,116,134,5255,01:00 - 02:59
fall,2012-08-26,2,12,104,116,5255,01:00 - 02:59
fall,2012-08-26,3,11,42,53,5255,03:00 - 04:59
fall,2012-08-26,4,5,11,16,5255,03:00 - 04:59
fall,2012-08-26,5,3,13,16,5255,05:00 - 06:59
fall,2012-08-26,6,5,16,21,5255,05:00 - 06:59
fall,2012-08-26,7,11,23,34,5255,07:00 - 08:59
fall,2012-08-26,8,21,112,133,5255,07:00 - 08:59
fall,2012-08-26,9,67,196,263,5255,09:00 - 10:59
fall,2012-08-26,10,127,258,385,5255,09:00 - 10:59
fall,2012-08-26,11,150,332,482,5255,11:00 - 12:59
fall,2012-08-26,12,225,401,626,5255,11:00 - 12:59
fall,2012-08-26,13,166,375,541,5255,13:00 - 14:59
fall,2012-08-26,14,125,252,377,5255,13:00 - 14:59
fall,2012-08-26,15,132,259,391,5255,15:00 - 16:59
fall,2012-08-26,16,57,116,173,5255,15:00 - 16:59
fall,2012-08-26,17,61,172,233,5255,17:00 - 18:59
fall,2012-08-26,18,77,187,264,5255,17:00 - 18:59
fall,2012-08-26,19,80,212,292,5255,19:00 - 20:59
fall,2012-08-26,20,40,171,211,5255,19:00 - 20:59
fall,2012-08-26,21,26,140,166,5255,21:00 - 22:59
fall,2012-08-26,22,20,94,114,5255,21:00 - 22:59
fall,2012-08-26,23,21,59,80,5255,23:00 - 24:59
fall,2012-08-27,0,4,28,32,6917,
fall,2012-08-27,1,3,4,7,6917,01:00 - 02:59
fall,2012-08-27,2,0,8,8,6917,01:00 - 02:59
fall,2012-08-27,3,1,3,4,6917,03:00 - 04:59
fall,2012-08-27,4,1,11,12,6917,03:00 - 04:59
fall,2012-08-27,5,4,32,36,6917,05:00 - 06:59
fall,2012-08-27,6,4,141,145,6917,05:00 - 06:59
fall,2012-08-27,7,15,418,433,6917,07:00 - 08:59
fall,2012-08-27,8,29,670,699,6917,07:00 - 08:59
fall,2012-08-27,9,40,302,342,6917,09:00 - 10:59
fall,2012-08-27,10,63,143,206,6917,09:00 - 10:59
fall,2012-08-27,11,47,182,229,6917,11:00 - 12:59
fall,2012-08-27,12,69,214,283,6917,11:00 - 12:59
fall,2012-08-27,13,77,211,288,6917,13:00 - 14:59
fall,2012-08-27,14,66,180,246,6917,13:00 - 14:59
fall,2012-08-27,15,77,205,282,6917,15:00 - 16:59
fall,2012-08-27,16,77,367,444,6917,15:00 - 16:59
fall,2012-08-27,17,101,744,845,6917,17:00 - 18:59
fall,2012-08-27,18,83,751,834,6917,17:00 - 18:59
fall,2012-08-27,19,74,499,573,6917,19:00 - 20:59
fall,2012-08-27,20,50,366,416,6917,19:00 - 20:59
fall,2012-08-27,21,39,239,278,6917,21:00 - 22:59
fall,2012-08-27,22,30,131,161,6917,21:00 - 22:59
fall,2012-08-27,23,35,79,114,6917,23:00 - 24:59
fall,2012-08-28,0,9,29,38,7040,
fall,2012-08-28,1,4,17,21,7040,01:00 - 02:59
fall,2012-08-28,2,2,13,15,7040,01:00 - 02:59
fall,2012-08-28,3,0,4,4,7040,03:00 - 04:59
fall,2012-08-28,4,2,6,8,7040,03:00 - 04:59
fall,2012-08-28,5,3,39,42,7040,05:00 - 06:59
fall,2012-08-28,6,3,144,147,7040,05:00 - 06:59
fall,2012-08-28,7,14,255,269,7040,07:00 - 08:59
fall,2012-08-28,8,25,668,693,7040,07:00 - 08:59
fall,2012-08-28,9,44,351,395,7040,09:00 - 10:59
fall,2012-08-28,10,39,165,204,7040,09:00 - 10:59
fall,2012-08-28,11,47,171,218,7040,11:00 - 12:59
fall,2012-08-28,12,56,241,297,7040,11:00 - 12:59
fall,2012-08-28,13,56,232,288,7040,13:00 - 14:59
fall,2012-08-28,14,72,179,251,7040,13:00 - 14:59
fall,2012-08-28,15,59,258,317,7040,15:00 - 16:59
fall,2012-08-28,16,84,396,480,7040,15:00 - 16:59
fall,2012-08-28,17,90,774,864,7040,17:00 - 18:59
fall,2012-08-28,18,82,736,818,7040,17:00 - 18:59
fall,2012-08-28,19,82,515,597,7040,19:00 - 20:59
fall,2012-08-28,20,87,348,435,7040,19:00 - 20:59
fall,2012-08-28,21,38,276,314,7040,21:00 - 22:59
fall,2012-08-28,22,20,196,216,7040,21:00 - 22:59
fall,2012-08-28,23,17,92,109,7040,23:00 - 24:59
fall,2012-08-29,0,8,39,47,7697,
fall,2012-08-29,1,2,12,14,7697,01:00 - 02:59
fall,2012-08-29,2,2,4,6,7697,01:00 - 02:59
fall,2012-08-29,3,0,9,9,7697,03:00 - 04:59
fall,2012-08-29,4,2,8,10,7697,03:00 - 04:59
fall,2012-08-29,5,3,37,40,7697,05:00 - 06:59
fall,2012-08-29,6,6,175,181,7697,05:00 - 06:59
fall,2012-08-29,7,23,531,554,7697,07:00 - 08:59
fall,2012-08-29,8,28,780,808,7697,07:00 - 08:59
fall,2012-08-29,9,40,308,348,7697,09:00 - 10:59
fall,2012-08-29,10,34,144,178,7697,09:00 - 10:59
fall,2012-08-29,11,67,186,253,7697,11:00 - 12:59
fall,2012-08-29,12,79,281,360,7697,11:00 - 12:59
fall,2012-08-29,13,68,232,300,7697,13:00 - 14:59
fall,2012-08-29,14,87,214,301,7697,13:00 - 14:59
fall,2012-08-29,15,96,242,338,7697,15:00 - 16:59
fall,2012-08-29,16,104,389,493,7697,15:00 - 16:59
fall,2012-08-29,17,108,762,870,7697,17:00 - 18:59
fall,2012-08-29,18,119,693,812,7697,17:00 - 18:59
fall,2012-08-29,19,120,523,643,7697,19:00 - 20:59
fall,2012-08-29,20,49,378,427,7697,19:00 - 20:59
fall,2012-08-29,21,48,265,313,7697,21:00 - 22:59
fall,2012-08-29,22,50,185,235,7697,21:00 - 22:59
fall,2012-08-29,23,34,123,157,7697,23:00 - 24:59
fall,2012-08-30,0,14,51,65,7713,
fall,2012-08-30,1,6,17,23,7713,01:00 - 02:59
fall,2012-08-30,2,3,14,17,7713,01:00 - 02:59
fall,2012-08-30,3,0,5,5,7713,03:00 - 04:59
fall,2012-08-30,4,4,4,8,7713,03:00 - 04:59
fall,2012-08-30,5,2,33,35,7713,05:00 - 06:59
fall,2012-08-30,6,8,155,163,7713,05:00 - 06:59
fall,2012-08-30,7,31,501,532,7713,07:00 - 08:59
fall,2012-08-30,8,53,701,754,7713,07:00 - 08:59
fall,2012-08-30,9,57,339,396,7713,09:00 - 10:59
fall,2012-08-30,10,73,161,234,7713,09:00 - 10:59
fall,2012-08-30,11,85,191,276,7713,11:00 - 12:59
fall,2012-08-30,12,73,221,294,7713,11:00 - 12:59
fall,2012-08-30,13,76,214,290,7713,13:00 - 14:59
fall,2012-08-30,14,74,199,273,7713,13:00 - 14:59
fall,2012-08-30,15,99,239,338,7713,15:00 - 16:59
fall,2012-08-30,16,77,405,482,7713,15:00 - 16:59
fall,2012-08-30,17,93,751,844,7713,17:00 - 18:59
fall,2012-08-30,18,109,744,853,7713,17:00 - 18:59
fall,2012-08-30,19,78,532,610,7713,19:00 - 20:59
fall,2012-08-30,20,68,403,471,7713,19:00 - 20:59
fall,2012-08-30,21,32,275,307,7713,21:00 - 22:59
fall,2012-08-30,22,38,253,291,7713,21:00 - 22:59
fall,2012-08-30,23,19,133,152,7713,23:00 - 24:59
fall,2012-08-31,0,13,69,82,7350,
fall,2012-08-31,1,8,24,32,7350,01:00 - 02:59
fall,2012-08-31,2,9,11,20,7350,01:00 - 02:59
fall,2012-08-31,3,3,2,5,7350,03:00 - 04:59
fall,2012-08-31,4,0,7,7,7350,03:00 - 04:59
fall,2012-08-31,5,2,27,29,7350,05:00 - 06:59
fall,2012-08-31,6,7,101,108,7350,05:00 - 06:59
fall,2012-08-31,7,21,400,421,7350,07:00 - 08:59
fall,2012-08-31,8,36,654,690,7350,07:00 - 08:59
fall,2012-08-31,9,61,337,398,7350,09:00 - 10:59
fall,2012-08-31,10,59,197,256,7350,09:00 - 10:59
fall,2012-08-31,11,88,221,309,7350,11:00 - 12:59
fall,2012-08-31,12,120,290,410,7350,11:00 - 12:59
fall,2012-08-31,13,97,271,368,7350,13:00 - 14:59
fall,2012-08-31,14,112,324,436,7350,13:00 - 14:59
fall,2012-08-31,15,109,417,526,7350,15:00 - 16:59
fall,2012-08-31,16,111,417,528,7350,15:00 - 16:59
fall,2012-08-31,17,129,488,617,7350,17:00 - 18:59
fall,2012-08-31,18,87,459,546,7350,17:00 - 18:59
fall,2012-08-31,19,91,361,452,7350,19:00 - 20:59
fall,2012-08-31,20,102,254,356,7350,19:00 - 20:59
fall,2012-08-31,21,71,232,303,7350,21:00 - 22:59
fall,2012-08-31,22,65,212,277,7350,21:00 - 22:59
fall,2012-08-31,23,32,142,174,7350,23:00 - 24:59
fall,2012-09-01,0,22,146,168,6140,
fall,2012-09-01,1,11,68,79,6140,01:00 - 02:59
fall,2012-09-01,2,8,61,69,6140,01:00 - 02:59
fall,2012-09-01,3,6,29,35,6140,03:00 - 04:59
fall,2012-09-01,4,3,9,12,6140,03:00 - 04:59
fall,2012-09-01,5,2,20,22,6140,05:00 - 06:59
fall,2012-09-01,6,13,23,36,6140,05:00 - 06:59
fall,2012-09-01,7,8,58,66,6140,07:00 - 08:59
fall,2012-09-01,8,28,134,162,6140,07:00 - 08:59
fall,2012-09-01,9,62,175,237,6140,09:00 - 10:59
fall,2012-09-01,10,128,289,417,6140,09:00 - 10:59
fall,2012-09-01,11,219,273,492,6140,11:00 - 12:59
fall,2012-09-01,12,187,284,471,6140,11:00 - 12:59
fall,2012-09-01,13,237,267,504,6140,13:00 - 14:59
fall,2012-09-01,14,240,274,514,6140,13:00 - 14:59
fall,2012-09-01,15,257,306,563,6140,15:00 - 16:59
fall,2012-09-01,16,209,253,462,6140,15:00 - 16:59
fall,2012-09-01,17,205,258,463,6140,17:00 - 18:59
fall,2012-09-01,18,184,258,442,6140,17:00 - 18:59
fall,2012-09-01,19,157,235,392,6140,19:00 - 20:59
fall,2012-09-01,20,67,140,207,6140,19:00 - 20:59
fall,2012-09-01,21,21,83,104,6140,21:00 - 22:59
fall,2012-09-01,22,21,57,78,6140,21:00 - 22:59
fall,2012-09-01,23,57,88,145,6140,23:00 - 24:59
fall,2012-09-02,0,27,72,99,5810,
fall,2012-09-02,1,15,58,73,5810,01:00 - 02:59
fall,2012-09-02,2,28,56,84,5810,01:00 - 02:59
fall,2012-09-02,3,9,33,42,5810,03:00 - 04:59
fall,2012-09-02,4,7,15,22,5810,03:00 - 04:59
fall,2012-09-02,5,2,10,12,5810,05:00 - 06:59
fall,2012-09-02,6,2,13,15,5810,05:00 - 06:59
fall,2012-09-02,7,13,29,42,5810,07:00 - 08:59
fall,2012-09-02,8,30,99,129,5810,07:00 - 08:59
fall,2012-09-02,9,88,144,232,5810,09:00 - 10:59
fall,2012-09-02,10,158,230,388,5810,09:00 - 10:59
fall,2012-09-02,11,226,263,489,5810,11:00 - 12:59
fall,2012-09-02,12,248,297,545,5810,11:00 - 12:59
fall,2012-09-02,13,263,230,493,5810,13:00 - 14:59
fall,2012-09-02,14,249,208,457,5810,13:00 - 14:59
fall,2012-09-02,15,179,176,355,5810,15:00 - 16:59
fall,2012-09-02,16,222,252,474,5810,15:00 - 16:59
fall,2012-09-02,17,219,284,503,5810,17:00 - 18:59
fall,2012-09-02,18,227,273,500,5810,17:00 - 18:59
fall,2012-09-02,19,140,152,292,5810,19:00 - 20:59
fall,2012-09-02,20,63,41,104,5810,19:00 - 20:59
fall,2012-09-02,21,79,92,171,5810,21:00 - 22:59
fall,2012-09-02,22,66,100,166,5810,21:00 - 22:59
fall,2012-09-02,23,53,70,123,5810,23:00 - 24:59
fall,2012-09-03,0,42,62,104,6034,
fall,2012-09-03,1,18,37,55,6034,01:00 - 02:59
fall,2012-09-03,2,10,30,40,6034,01:00 - 02:59
fall,2012-09-03,3,6,22,28,6034,03:00 - 04:59
fall,2012-09-03,4,6,5,11,6034,03:00 - 04:59
fall,2012-09-03,5,1,3,4,6034,05:00 - 06:59
fall,2012-09-03,6,3,12,15,6034,05:00 - 06:59
fall,2012-09-03,7,6,37,43,6034,07:00 - 08:59
fall,2012-09-03,8,36,91,127,6034,07:00 - 08:59
fall,2012-09-03,9,71,158,229,6034,09:00 - 10:59
fall,2012-09-03,10,135,224,359,6034,09:00 - 10:59
fall,2012-09-03,11,187,272,459,6034,11:00 - 12:59
fall,2012-09-03,12,191,352,543,6034,11:00 - 12:59
fall,2012-09-03,13,209,357,566,6034,13:00 - 14:59
fall,2012-09-03,14,163,349,512,6034,13:00 - 14:59
fall,2012-09-03,15,168,281,449,6034,15:00 - 16:59
fall,2012-09-03,16,165,335,500,6034,15:00 - 16:59
fall,2012-09-03,17,181,317,498,6034,17:00 - 18:59
fall,2012-09-03,18,145,337,482,6034,17:00 - 18:59
fall,2012-09-03,19,73,301,374,6034,19:00 - 20:59
fall,2012-09-03,20,78,183,261,6034,19:00 - 20:59
fall,2012-09-03,21,42,142,184,6034,21:00 - 22:59
fall,2012-09-03,22,17,104,121,6034,21:00 - 22:59
fall,2012-09-03,23,12,58,70,6034,23:00 - 24:59
fall,2012-09-04,0,10,19,29,6864,
fall,2012-09-04,1,15,9,24,6864,01:00 - 02:59
fall,2012-09-04,2,1,4,5,6864,01:00 - 02:59
fall,2012-09-04,3,1,9,10,6864,03:00 - 04:59
fall,2012-09-04,4,0,8,8,6864,03:00 - 04:59
fall,2012-09-04,5,1,37,38,6864,05:00 - 06:59
fall,2012-09-04,6,7,165,172,6864,05:00 - 06:59
fall,2012-09-04,7,13,480,493,6864,07:00 - 08:59
fall,2012-09-04,8,15,617,632,6864,07:00 - 08:59
fall,2012-09-04,9,30,293,323,6864,09:00 - 10:59
fall,2012-09-04,10,42,130,172,6864,09:00 - 10:59
fall,2012-09-04,11,39,159,198,6864,11:00 - 12:59
fall,2012-09-04,12,54,233,287,6864,11:00 - 12:59
fall,2012-09-04,13,72,203,275,6864,13:00 - 14:59
fall,2012-09-04,14,72,202,274,6864,13:00 - 14:59
fall,2012-09-04,15,68,224,292,6864,15:00 - 16:59
fall,2012-09-04,16,61,397,458,6864,15:00 - 16:59
fall,2012-09-04,17,110,746,856,6864,17:00 - 18:59
fall,2012-09-04,18,94,745,839,6864,17:00 - 18:59
fall,2012-09-04,19,50,502,552,6864,19:00 - 20:59
fall,2012-09-04,20,47,338,385,6864,19:00 - 20:59
fall,2012-09-04,21,28,240,268,6864,21:00 - 22:59
fall,2012-09-04,22,25,154,179,6864,21:00 - 22:59
fall,2012-09-04,23,12,83,95,6864,23:00 - 24:59
fall,2012-09-05,0,10,27,37,7112,
fall,2012-09-05,1,2,11,13,7112,01:00 - 02:59
fall,2012-09-05,2,0,9,9,7112,01:00 - 02:59
fall,2012-09-05,3,0,4,4,7112,03:00 - 04:59
fall,2012-09-05,4,2,3,5,7112,03:00 - 04:59
fall,2012-09-05,5,1,39,40,7112,05:00 - 06:59
fall,2012-09-05,6,7,203,210,7112,05:00 - 06:59
fall,2012-09-05,7,11,489,500,7112,07:00 - 08:59
fall,2012-09-05,8,33,692,725,7112,07:00 - 08:59
fall,2012-09-05,9,27,263,290,7112,09:00 - 10:59
fall,2012-09-05,10,54,181,235,7112,09:00 - 10:59
fall,2012-09-05,11,61,156,217,7112,11:00 - 12:59
fall,2012-09-05,12,49,217,266,7112,11:00 - 12:59
fall,2012-09-05,13,50,184,234,7112,13:00 - 14:59
fall,2012-09-05,14,34,177,211,7112,13:00 - 14:59
fall,2012-09-05,15,41,204,245,7112,15:00 - 16:59
fall,2012-09-05,16,86,344,430,7112,15:00 - 16:59
fall,2012-09-05,17,83,780,863,7112,17:00 - 18:59
fall,2012-09-05,18,82,757,839,7112,17:00 - 18:59
fall,2012-09-05,19,64,598,662,7112,19:00 - 20:59
fall,2012-09-05,20,55,357,412,7112,19:00 - 20:59
fall,2012-09-05,21,18,278,296,7112,21:00 - 22:59
fall,2012-09-05,22,38,181,219,7112,21:00 - 22:59
fall,2012-09-05,23,24,126,150,7112,23:00 - 24:59
fall,2012-09-06,0,30,35,65,6203,
fall,2012-09-06,1,2,16,18,6203,01:00 - 02:59
fall,2012-09-06,2,1,7,8,6203,01:00 - 02:59
fall,2012-09-06,3,0,9,9,6203,03:00 - 04:59
fall,2012-09-06,4,0,8,8,6203,03:00 - 04:59
fall,2012-09-06,5,3,35,38,6203,05:00 - 06:59
fall,2012-09-06,6,11,189,200,6203,05:00 - 06:59
fall,2012-09-06,7,21,461,482,6203,07:00 - 08:59
fall,2012-09-06,8,24,622,646,6203,07:00 - 08:59
fall,2012-09-06,9,8,115,123,6203,09:00 - 10:59
fall,2012-09-06,10,9,40,49,6203,09:00 - 10:59
fall,2012-09-06,11,10,52,62,6203,11:00 - 12:59
fall,2012-09-06,12,11,126,137,6203,11:00 - 12:59
fall,2012-09-06,13,39,152,191,6203,13:00 - 14:59
fall,2012-09-06,14,38,178,216,6203,13:00 - 14:59
fall,2012-09-06,15,42,228,270,6203,15:00 - 16:59
fall,2012-09-06,16,42,374,416,6203,15:00 - 16:59
fall,2012-09-06,17,67,741,808,6203,17:00 - 18:59
fall,2012-09-06,18,74,761,835,6203,17:00 - 18:59
fall,2012-09-06,19,54,504,558,6203,19:00 - 20:59
fall,2012-09-06,20,50,356,406,6203,19:00 - 20:59
fall,2012-09-06,21,32,240,272,6203,21:00 - 22:59
fall,2012-09-06,22,24,193,217,6203,21:00 - 22:59
fall,2012-09-06,23,19,150,169,6203,23:00 - 24:59
fall,2012-09-07,0,17,79,96,7504,
fall,2012-09-07,1,10,19,29,7504,01:00 - 02:59
fall,2012-09-07,2,1,10,11,7504,01:00 - 02:59
fall,2012-09-07,3,0,9,9,7504,03:00 - 04:59
fall,2012-09-07,4,1,7,8,7504,03:00 - 04:59
fall,2012-09-07,5,1,39,40,7504,05:00 - 06:59
fall,2012-09-07,6,5,135,140,7504,05:00 - 06:59
fall,2012-09-07,7,21,465,486,7504,07:00 - 08:59
fall,2012-09-07,8,29,690,719,7504,07:00 - 08:59
fall,2012-09-07,9,33,311,344,7504,09:00 - 10:59
fall,2012-09-07,10,53,171,224,7504,09:00 - 10:59
fall,2012-09-07,11,81,215,296,7504,11:00 - 12:59
fall,2012-09-07,12,76,247,323,7504,11:00 - 12:59
fall,2012-09-07,13,71,283,354,7504,13:00 - 14:59
fall,2012-09-07,14,66,187,253,7504,13:00 - 14:59
fall,2012-09-07,15,66,265,331,7504,15:00 - 16:59
fall,2012-09-07,16,75,395,470,7504,15:00 - 16:59
fall,2012-09-07,17,88,684,772,7504,17:00 - 18:59
fall,2012-09-07,18,95,697,792,7504,17:00 - 18:59
fall,2012-09-07,19,70,498,568,7504,19:00 - 20:59
fall,2012-09-07,20,51,340,391,7504,19:00 - 20:59
fall,2012-09-07,21,55,246,301,7504,21:00 - 22:59
fall,2012-09-07,22,52,247,299,7504,21:00 - 22:59
fall,2012-09-07,23,28,220,248,7504,23:00 - 24:59
fall,2012-09-08,0,20,130,150,5976,
fall,2012-09-08,1,10,107,117,5976,01:00 - 02:59
fall,2012-09-08,2,9,68,77,5976,01:00 - 02:59
fall,2012-09-08,3,3,40,43,5976,03:00 - 04:59
fall,2012-09-08,4,3,8,11,5976,03:00 - 04:59
fall,2012-09-08,5,2,13,15,5976,05:00 - 06:59
fall,2012-09-08,6,8,26,34,5976,05:00 - 06:59
fall,2012-09-08,7,11,71,82,5976,07:00 - 08:59
fall,2012-09-08,8,33,197,230,5976,07:00 - 08:59
fall,2012-09-08,9,87,261,348,5976,09:00 - 10:59
fall,2012-09-08,10,100,322,422,5976,09:00 - 10:59
fall,2012-09-08,11,173,405,578,5976,11:00 - 12:59
fall,2012-09-08,12,220,474,694,5976,11:00 - 12:59
fall,2012-09-08,13,233,435,668,5976,13:00 - 14:59
fall,2012-09-08,14,260,366,626,5976,13:00 - 14:59
fall,2012-09-08,15,175,337,512,5976,15:00 - 16:59
fall,2012-09-08,16,19,95,114,5976,15:00 - 16:59
fall,2012-09-08,17,52,119,171,5976,17:00 - 18:59
fall,2012-09-08,18,27,140,167,5976,17:00 - 18:59
fall,2012-09-08,19,28,187,215,5976,19:00 - 20:59
fall,2012-09-08,20,28,166,194,5976,19:00 - 20:59
fall,2012-09-08,21,26,155,181,5976,21:00 - 22:59
fall,2012-09-08,22,18,176,194,5976,21:00 - 22:59
fall,2012-09-08,23,12,121,133,5976,23:00 - 24:59
fall,2012-09-09,0,18,106,124,8227,
fall,2012-09-09,1,20,104,124,8227,01:00 - 02:59
fall,2012-09-09,2,15,81,96,8227,01:00 - 02:59
fall,2012-09-09,3,14,32,46,8227,03:00 - 04:59
fall,2012-09-09,4,12,16,28,8227,03:00 - 04:59
fall,2012-09-09,5,16,39,55,8227,05:00 - 06:59
fall,2012-09-09,6,11,24,35,8227,05:00 - 06:59
fall,2012-09-09,7,20,50,70,8227,07:00 - 08:59
fall,2012-09-09,8,27,143,170,8227,07:00 - 08:59
fall,2012-09-09,9,85,214,299,8227,09:00 - 10:59
fall,2012-09-09,10,172,323,495,8227,09:00 - 10:59
fall,2012-09-09,11,194,391,585,8227,11:00 - 12:59
fall,2012-09-09,12,247,510,757,8227,11:00 - 12:59
fall,2012-09-09,13,238,491,729,8227,13:00 - 14:59
fall,2012-09-09,14,232,415,647,8227,13:00 - 14:59
fall,2012-09-09,15,284,412,696,8227,15:00 - 16:59
fall,2012-09-09,16,228,473,701,8227,15:00 - 16:59
fall,2012-09-09,17,213,458,671,8227,17:00 - 18:59
fall,2012-09-09,18,156,404,560,8227,17:00 - 18:59
fall,2012-09-09,19,134,362,496,8227,19:00 - 20:59
fall,2012-09-09,20,91,265,356,8227,19:00 - 20:59
fall,2012-09-09,21,57,149,206,8227,21:00 - 22:59
fall,2012-09-09,22,64,125,189,8227,21:00 - 22:59
fall,2012-09-09,23,22,70,92,8227,23:00 - 24:59
fall,2012-09-10,0,6,35,41,7525,
fall,2012-09-10,1,7,11,18,7525,01:00 - 02:59
fall,2012-09-10,2,11,6,17,7525,01:00 - 02:59
fall,2012-09-10,3,5,7,12,7525,03:00 - 04:59
fall,2012-09-10,4,1,4,5,7525,03:00 - 04:59
fall,2012-09-10,5,4,36,40,7525,05:00 - 06:59
fall,2012-09-10,6,8,172,180,7525,05:00 - 06:59
fall,2012-09-10,7,20,427,447,7525,07:00 - 08:59
fall,2012-09-10,8,33,697,730,7525,07:00 - 08:59
fall,2012-09-10,9,40,321,361,7525,09:00 - 10:59
fall,2012-09-10,10,42,168,210,7525,09:00 - 10:59
fall,2012-09-10,11,69,167,236,7525,11:00 - 12:59
fall,2012-09-10,12,76,256,332,7525,11:00 - 12:59
fall,2012-09-10,13,72,251,323,7525,13:00 - 14:59
fall,2012-09-10,14,107,233,340,7525,13:00 - 14:59
fall,2012-09-10,15,115,231,346,7525,15:00 - 16:59
fall,2012-09-10,16,108,380,488,7525,15:00 - 16:59
fall,2012-09-10,17,127,744,871,7525,17:00 - 18:59
fall,2012-09-10,18,111,857,968,7525,17:00 - 18:59
fall,2012-09-10,19,71,562,633,7525,19:00 - 20:59
fall,2012-09-10,20,34,356,390,7525,19:00 - 20:59
fall,2012-09-10,21,29,256,285,7525,21:00 - 22:59
fall,2012-09-10,22,15,144,159,7525,21:00 - 22:59
fall,2012-09-10,23,7,86,93,7525,23:00 - 24:59
fall,2012-09-11,0,5,27,32,7767,
fall,2012-09-11,1,0,10,10,7767,01:00 - 02:59
fall,2012-09-11,2,1,5,6,7767,01:00 - 02:59
fall,2012-09-11,3,1,7,8,7767,03:00 - 04:59
fall,2012-09-11,4,1,8,9,7767,03:00 - 04:59
fall,2012-09-11,5,3,41,44,7767,05:00 - 06:59
fall,2012-09-11,6,11,200,211,7767,05:00 - 06:59
fall,2012-09-11,7,24,572,596,7767,07:00 - 08:59
fall,2012-09-11,8,48,702,750,7767,07:00 - 08:59
fall,2012-09-11,9,35,323,358,7767,09:00 - 10:59
fall,2012-09-11,10,54,142,196,7767,09:00 - 10:59
fall,2012-09-11,11,60,187,247,7767,11:00 - 12:59
fall,2012-09-11,12,62,254,316,7767,11:00 - 12:59
fall,2012-09-11,13,72,256,328,7767,13:00 - 14:59
fall,2012-09-11,14,74,181,255,7767,13:00 - 14:59
fall,2012-09-11,15,73,253,326,7767,15:00 - 16:59
fall,2012-09-11,16,99,437,536,7767,15:00 - 16:59
fall,2012-09-11,17,168,802,970,7767,17:00 - 18:59
fall,2012-09-11,18,110,767,877,7767,17:00 - 18:59
fall,2012-09-11,19,56,540,596,7767,19:00 - 20:59
fall,2012-09-11,20,40,421,461,7767,19:00 - 20:59
fall,2012-09-11,21,28,282,310,7767,21:00 - 22:59
fall,2012-09-11,22,27,189,216,7767,21:00 - 22:59
fall,2012-09-11,23,18,91,109,7767,23:00 - 24:59
fall,2012-09-12,0,8,41,49,7870,
fall,2012-09-12,1,2,19,21,7870,01:00 - 02:59
fall,2012-09-12,2,2,9,11,7870,01:00 - 02:59
fall,2012-09-12,3,0,7,7,7870,03:00 - 04:59
fall,2012-09-12,4,0,5,5,7870,03:00 - 04:59
fall,2012-09-12,5,4,44,48,7870,05:00 - 06:59
fall,2012-09-12,6,6,199,205,7870,05:00 - 06:59
fall,2012-09-12,7,24,533,557,7870,07:00 - 08:59
fall,2012-09-12,8,43,727,770,7870,07:00 - 08:59
fall,2012-09-12,9,50,278,328,7870,09:00 - 10:59
fall,2012-09-12,10,57,148,205,7870,09:00 - 10:59
fall,2012-09-12,11,51,181,232,7870,11:00 - 12:59
fall,2012-09-12,12,88,264,352,7870,11:00 - 12:59
fall,2012-09-12,13,85,238,323,7870,13:00 - 14:59
fall,2012-09-12,14,78,200,278,7870,13:00 - 14:59
fall,2012-09-12,15,75,243,318,7870,15:00 - 16:59
fall,2012-09-12,16,90,419,509,7870,15:00 - 16:59
fall,2012-09-12,17,114,811,925,7870,17:00 - 18:59
fall,2012-09-12,18,91,886,977,7870,17:00 - 18:59
fall,2012-09-12,19,78,557,635,7870,19:00 - 20:59
fall,2012-09-12,20,38,432,470,7870,19:00 - 20:59
fall,2012-09-12,21,27,279,306,7870,21:00 - 22:59
fall,2012-09-12,22,23,189,212,7870,21:00 - 22:59
fall,2012-09-12,23,16,111,127,7870,23:00 - 24:59
fall,2012-09-13,0,11,46,57,7804,
fall,2012-09-13,1,6,22,28,7804,01:00 - 02:59
fall,2012-09-13,2,0,9,9,7804,01:00 - 02:59
fall,2012-09-13,3,2,9,11,7804,03:00 - 04:59
fall,2012-09-13,4,0,6,6,7804,03:00 - 04:59
fall,2012-09-13,5,3,54,57,7804,05:00 - 06:59
fall,2012-09-13,6,9,186,195,7804,05:00 - 06:59
fall,2012-09-13,7,22,549,571,7804,07:00 - 08:59
fall,2012-09-13,8,33,725,758,7804,07:00 - 08:59
fall,2012-09-13,9,46,292,338,7804,09:00 - 10:59
fall,2012-09-13,10,63,149,212,7804,09:00 - 10:59
fall,2012-09-13,11,71,183,254,7804,11:00 - 12:59
fall,2012-09-13,12,57,240,297,7804,11:00 - 12:59
fall,2012-09-13,13,60,223,283,7804,13:00 - 14:59
fall,2012-09-13,14,60,214,274,7804,13:00 - 14:59
fall,2012-09-13,15,99,253,352,7804,15:00 - 16:59
fall,2012-09-13,16,85,406,491,7804,15:00 - 16:59
fall,2012-09-13,17,97,787,884,7804,17:00 - 18:59
fall,2012-09-13,18,108,744,852,7804,17:00 - 18:59
fall,2012-09-13,19,80,594,674,7804,19:00 - 20:59
fall,2012-09-13,20,55,408,463,7804,19:00 - 20:59
fall,2012-09-13,21,26,291,317,7804,21:00 - 22:59
fall,2012-09-13,22,28,223,251,7804,21:00 - 22:59
fall,2012-09-13,23,33,137,170,7804,23:00 - 24:59
fall,2012-09-14,0,24,63,87,8009,
fall,2012-09-14,1,6,35,41,8009,01:00 - 02:59
fall,2012-09-14,2,7,23,30,8009,01:00 - 02:59
fall,2012-09-14,3,5,9,14,8009,03:00 - 04:59
fall,2012-09-14,4,1,11,12,8009,03:00 - 04:59
fall,2012-09-14,5,1,40,41,8009,05:00 - 06:59
fall,2012-09-14,6,8,144,152,8009,05:00 - 06:59
fall,2012-09-14,7,17,437,454,8009,07:00 - 08:59
fall,2012-09-14,8,51,715,766,8009,07:00 - 08:59
fall,2012-09-14,9,46,301,347,8009,09:00 - 10:59
fall,2012-09-14,10,75,171,246,8009,09:00 - 10:59
fall,2012-09-14,11,84,196,280,8009,11:00 - 12:59
fall,2012-09-14,12,119,290,409,8009,11:00 - 12:59
fall,2012-09-14,13,107,301,408,8009,13:00 - 14:59
fall,2012-09-14,14,113,258,371,8009,13:00 - 14:59
fall,2012-09-14,15,94,273,367,8009,15:00 - 16:59
fall,2012-09-14,16,109,454,563,8009,15:00 - 16:59
fall,2012-09-14,17,137,757,894,8009,17:00 - 18:59
fall,2012-09-14,18,116,692,808,8009,17:00 - 18:59
fall,2012-09-14,19,83,496,579,8009,19:00 - 20:59
fall,2012-09-14,20,67,337,404,8009,19:00 - 20:59
fall,2012-09-14,21,42,270,312,8009,21:00 - 22:59
fall,2012-09-14,22,40,189,229,8009,21:00 - 22:59
fall,2012-09-14,23,27,168,195,8009,23:00 - 24:59
fall,2012-09-15,0,38,169,207,8714,
fall,2012-09-15,1,8,101,109,8714,01:00 - 02:59
fall,2012-09-15,2,18,75,93,8714,01:00 - 02:59
fall,2012-09-15,3,6,31,37,8714,03:00 - 04:59
fall,2012-09-15,4,3,3,6,8714,03:00 - 04:59
fall,2012-09-15,5,1,15,16,8714,05:00 - 06:59
fall,2012-09-15,6,6,27,33,8714,05:00 - 06:59
fall,2012-09-15,7,10,63,73,8714,07:00 - 08:59
fall,2012-09-15,8,43,169,212,8714,07:00 - 08:59
fall,2012-09-15,9,79,263,342,8714,09:00 - 10:59
fall,2012-09-15,10,119,323,442,8714,09:00 - 10:59
fall,2012-09-15,11,228,399,627,8714,11:00 - 12:59
fall,2012-09-15,12,287,419,706,8714,11:00 - 12:59
fall,2012-09-15,13,327,377,704,8714,13:00 - 14:59
fall,2012-09-15,14,325,390,715,8714,13:00 - 14:59
fall,2012-09-15,15,312,342,654,8714,15:00 - 16:59
fall,2012-09-15,16,350,433,783,8714,15:00 - 16:59
fall,2012-09-15,17,295,434,729,8714,17:00 - 18:59
fall,2012-09-15,18,232,382,614,8714,17:00 - 18:59
fall,2012-09-15,19,169,309,478,8714,19:00 - 20:59
fall,2012-09-15,20,89,241,330,8714,19:00 - 20:59
fall,2012-09-15,21,86,210,296,8714,21:00 - 22:59
fall,2012-09-15,22,82,197,279,8714,21:00 - 22:59
fall,2012-09-15,23,47,182,229,8714,23:00 - 24:59
fall,2012-09-16,0,28,123,151,7333,
fall,2012-09-16,1,35,82,117,7333,01:00 - 02:59
fall,2012-09-16,2,27,62,89,7333,01:00 - 02:59
fall,2012-09-16,3,10,38,48,7333,03:00 - 04:59
fall,2012-09-16,4,2,6,8,7333,03:00 - 04:59
fall,2012-09-16,5,3,10,13,7333,05:00 - 06:59
fall,2012-09-16,6,9,26,35,7333,05:00 - 06:59
fall,2012-09-16,7,28,43,71,7333,07:00 - 08:59
fall,2012-09-16,8,34,94,128,7333,07:00 - 08:59
fall,2012-09-16,9,70,226,296,7333,09:00 - 10:59
fall,2012-09-16,10,160,330,490,7333,09:00 - 10:59
fall,2012-09-16,11,183,376,559,7333,11:00 - 12:59
fall,2012-09-16,12,188,468,656,7333,11:00 - 12:59
fall,2012-09-16,13,240,454,694,7333,13:00 - 14:59
fall,2012-09-16,14,225,410,635,7333,13:00 - 14:59
fall,2012-09-16,15,215,342,557,7333,15:00 - 16:59
fall,2012-09-16,16,194,402,596,7333,15:00 - 16:59
fall,2012-09-16,17,177,393,570,7333,17:00 - 18:59
fall,2012-09-16,18,120,361,481,7333,17:00 - 18:59
fall,2012-09-16,19,91,312,403,7333,19:00 - 20:59
fall,2012-09-16,20,57,267,324,7333,19:00 - 20:59
fall,2012-09-16,21,43,148,191,7333,21:00 - 22:59
fall,2012-09-16,22,18,109,127,7333,21:00 - 22:59
fall,2012-09-16,23,9,85,94,7333,23:00 - 24:59
fall,2012-09-17,0,14,31,45,6869,
fall,2012-09-17,1,9,12,21,6869,01:00 - 02:59
fall,2012-09-17,2,5,8,13,6869,01:00 - 02:59
fall,2012-09-17,3,0,7,7,6869,03:00 - 04:59
fall,2012-09-17,4,2,9,11,6869,03:00 - 04:59
fall,2012-09-17,5,1,44,45,6869,05:00 - 06:59
fall,2012-09-17,6,7,157,164,6869,05:00 - 06:59
fall,2012-09-17,7,18,474,492,6869,07:00 - 08:59
fall,2012-09-17,8,36,647,683,6869,07:00 - 08:59
fall,2012-09-17,9,34,265,299,6869,09:00 - 10:59
fall,2012-09-17,10,73,129,202,6869,09:00 - 10:59
fall,2012-09-17,11,61,191,252,6869,11:00 - 12:59
fall,2012-09-17,12,62,233,295,6869,11:00 - 12:59
fall,2012-09-17,13,112,231,343,6869,13:00 - 14:59
fall,2012-09-17,14,129,203,332,6869,13:00 - 14:59
fall,2012-09-17,15,82,256,338,6869,15:00 - 16:59
fall,2012-09-17,16,74,379,453,6869,15:00 - 16:59
fall,2012-09-17,17,102,740,842,6869,17:00 - 18:59
fall,2012-09-17,18,66,708,774,6869,17:00 - 18:59
fall,2012-09-17,19,51,435,486,6869,19:00 - 20:59
fall,2012-09-17,20,32,308,340,6869,19:00 - 20:59
fall,2012-09-17,21,28,205,233,6869,21:00 - 22:59
fall,2012-09-17,22,20,109,129,6869,21:00 - 22:59
fall,2012-09-17,23,4,66,70,6869,23:00 - 24:59
fall,2012-09-18,0,2,11,13,4073,
fall,2012-09-18,1,0,5,5,4073,01:00 - 02:59
fall,2012-09-18,2,0,4,4,4073,01:00 - 02:59
fall,2012-09-18,3,0,6,6,4073,03:00 - 04:59
fall,2012-09-18,4,2,5,7,4073,03:00 - 04:59
fall,2012-09-18,5,3,45,48,4073,05:00 - 06:59
fall,2012-09-18,6,4,163,167,4073,05:00 - 06:59
fall,2012-09-18,7,13,343,356,4073,07:00 - 08:59
fall,2012-09-18,8,32,640,672,4073,07:00 - 08:59
fall,2012-09-18,9,27,266,293,4073,09:00 - 10:59
fall,2012-09-18,10,30,130,160,4073,09:00 - 10:59
fall,2012-09-18,11,36,115,151,4073,11:00 - 12:59
fall,2012-09-18,12,16,72,88,4073,11:00 - 12:59
fall,2012-09-18,13,17,97,114,4073,13:00 - 14:59
fall,2012-09-18,14,27,116,143,4073,13:00 - 14:59
fall,2012-09-18,15,1,35,36,4073,15:00 - 16:59
fall,2012-09-18,16,19,122,141,4073,15:00 - 16:59
fall,2012-09-18,17,36,302,338,4073,17:00 - 18:59
fall,2012-09-18,18,19,262,281,4073,17:00 - 18:59
fall,2012-09-18,19,22,302,324,4073,19:00 - 20:59
fall,2012-09-18,20,19,271,290,4073,19:00 - 20:59
fall,2012-09-18,21,21,186,207,4073,21:00 - 22:59
fall,2012-09-18,22,14,137,151,4073,21:00 - 22:59
fall,2012-09-18,23,11,67,78,4073,23:00 - 24:59
fall,2012-09-19,0,3,23,26,7591,
fall,2012-09-19,1,0,12,12,7591,01:00 - 02:59
fall,2012-09-19,2,0,3,3,7591,01:00 - 02:59
fall,2012-09-19,3,1,4,5,7591,03:00 - 04:59
fall,2012-09-19,4,0,10,10,7591,03:00 - 04:59
fall,2012-09-19,5,2,54,56,7591,05:00 - 06:59
fall,2012-09-19,6,6,166,172,7591,05:00 - 06:59
fall,2012-09-19,7,16,529,545,7591,07:00 - 08:59
fall,2012-09-19,8,39,758,797,7591,07:00 - 08:59
fall,2012-09-19,9,26,336,362,7591,09:00 - 10:59
fall,2012-09-19,10,23,169,192,7591,09:00 - 10:59
fall,2012-09-19,11,44,203,247,7591,11:00 - 12:59
fall,2012-09-19,12,53,260,313,7591,11:00 - 12:59
fall,2012-09-19,13,55,234,289,7591,13:00 - 14:59
fall,2012-09-19,14,59,227,286,7591,13:00 - 14:59
fall,2012-09-19,15,57,254,311,7591,15:00 - 16:59
fall,2012-09-19,16,69,397,466,7591,15:00 - 16:59
fall,2012-09-19,17,74,812,886,7591,17:00 - 18:59
fall,2012-09-19,18,85,807,892,7591,17:00 - 18:59
fall,2012-09-19,19,72,539,611,7591,19:00 - 20:59
fall,2012-09-19,20,31,378,409,7591,19:00 - 20:59
fall,2012-09-19,21,25,324,349,7591,21:00 - 22:59
fall,2012-09-19,22,31,198,229,7591,21:00 - 22:59
fall,2012-09-19,23,17,106,123,7591,23:00 - 24:59
fall,2012-09-20,0,12,46,58,7720,
fall,2012-09-20,1,4,14,18,7720,01:00 - 02:59
fall,2012-09-20,2,2,9,11,7720,01:00 - 02:59
fall,2012-09-20,3,0,6,6,7720,03:00 - 04:59
fall,2012-09-20,4,0,6,6,7720,03:00 - 04:59
fall,2012-09-20,5,4,52,56,7720,05:00 - 06:59
fall,2012-09-20,6,9,161,170,7720,05:00 - 06:59
fall,2012-09-20,7,20,514,534,7720,07:00 - 08:59
fall,2012-09-20,8,44,746,790,7720,07:00 - 08:59
fall,2012-09-20,9,25,330,355,7720,09:00 - 10:59
fall,2012-09-20,10,33,157,190,7720,09:00 - 10:59
fall,2012-09-20,11,37,206,243,7720,11:00 - 12:59
fall,2012-09-20,12,57,233,290,7720,11:00 - 12:59
fall,2012-09-20,13,68,268,336,7720,13:00 - 14:59
fall,2012-09-20,14,76,222,298,7720,13:00 - 14:59
fall,2012-09-20,15,60,231,291,7720,15:00 - 16:59
fall,2012-09-20,16,72,385,457,7720,15:00 - 16:59
fall,2012-09-20,17,91,885,976,7720,17:00 - 18:59
fall,2012-09-20,18,119,781,900,7720,17:00 - 18:59
fall,2012-09-20,19,69,534,603,7720,19:00 - 20:59
fall,2012-09-20,20,57,360,417,7720,19:00 - 20:59
fall,2012-09-20,21,28,246,274,7720,21:00 - 22:59
fall,2012-09-20,22,35,252,287,7720,21:00 - 22:59
fall,2012-09-20,23,17,137,154,7720,23:00 - 24:59
fall,2012-09-21,0,13,53,66,8167,
fall,2012-09-21,1,11,38,49,8167,01:00 - 02:59
fall,2012-09-21,2,6,8,14,8167,01:00 - 02:59
fall,2012-09-21,3,1,11,12,8167,03:00 - 04:59
fall,2012-09-21,4,1,9,10,8167,03:00 - 04:59
fall,2012-09-21,5,2,47,49,8167,05:00 - 06:59
fall,2012-09-21,6,19,146,165,8167,05:00 - 06:59
fall,2012-09-21,7,35,468,503,8167,07:00 - 08:59
fall,2012-09-21,8,31,726,757,8167,07:00 - 08:59
fall,2012-09-21,9,35,348,383,8167,09:00 - 10:59
fall,2012-09-21,10,44,181,225,8167,09:00 - 10:59
fall,2012-09-21,11,79,242,321,8167,11:00 - 12:59
fall,2012-09-21,12,84,305,389,8167,11:00 - 12:59
fall,2012-09-21,13,105,316,421,8167,13:00 - 14:59
fall,2012-09-21,14,113,299,412,8167,13:00 - 14:59
fall,2012-09-21,15,90,333,423,8167,15:00 - 16:59
fall,2012-09-21,16,103,464,567,8167,15:00 - 16:59
fall,2012-09-21,17,107,739,846,8167,17:00 - 18:59
fall,2012-09-21,18,106,699,805,8167,17:00 - 18:59
fall,2012-09-21,19,95,493,588,8167,19:00 - 20:59
fall,2012-09-21,20,54,315,369,8167,19:00 - 20:59
fall,2012-09-21,21,46,266,312,8167,21:00 - 22:59
fall,2012-09-21,22,47,248,295,8167,21:00 - 22:59
fall,2012-09-21,23,23,163,186,8167,23:00 - 24:59
fall,2012-09-22,0,32,140,172,8395,
fall,2012-09-22,1,18,106,124,8395,01:00 - 02:59
fall,2012-09-22,2,10,73,83,8395,01:00 - 02:59
fall,2012-09-22,3,6,39,45,8395,03:00 - 04:59
fall,2012-09-22,4,5,10,15,8395,03:00 - 04:59
fall,2012-09-22,5,2,15,17,8395,05:00 - 06:59
fall,2012-09-22,6,6,35,41,8395,05:00 - 06:59
fall,2012-09-22,7,7,70,77,8395,07:00 - 08:59
fall,2012-09-22,8,21,197,218,8395,07:00 - 08:59
fall,2012-09-22,9,88,289,377,8395,09:00 - 10:59
fall,2012-09-22,10,124,350,474,8395,09:00 - 10:59
fall,2012-09-22,11,189,437,626,8395,11:00 - 12:59
fall,2012-09-22,12,228,460,688,8395,11:00 - 12:59
fall,2012-09-22,13,273,434,707,8395,13:00 - 14:59
fall,2012-09-22,14,250,404,654,8395,13:00 - 14:59
fall,2012-09-22,15,307,443,750,8395,15:00 - 16:59
fall,2012-09-22,16,253,427,680,8395,15:00 - 16:59
fall,2012-09-22,17,195,451,646,8395,17:00 - 18:59
fall,2012-09-22,18,171,427,598,8395,17:00 - 18:59
fall,2012-09-22,19,99,308,407,8395,19:00 - 20:59
fall,2012-09-22,20,76,249,325,8395,19:00 - 20:59
fall,2012-09-22,21,59,202,261,8395,21:00 - 22:59
fall,2012-09-22,22,59,180,239,8395,21:00 - 22:59
fall,2012-09-22,23,34,137,171,8395,23:00 - 24:59
winter,2012-09-23,0,34,146,180,7907,
winter,2012-09-23,1,23,119,142,7907,01:00 - 02:59
winter,2012-09-23,2,18,77,95,7907,01:00 - 02:59
winter,2012-09-23,3,13,41,54,7907,03:00 - 04:59
winter,2012-09-23,4,1,9,10,7907,03:00 - 04:59
winter,2012-09-23,5,1,5,6,7907,05:00 - 06:59
winter,2012-09-23,6,5,11,16,7907,05:00 - 06:59
winter,2012-09-23,7,9,48,57,7907,07:00 - 08:59
winter,2012-09-23,8,38,137,175,7907,07:00 - 08:59
winter,2012-09-23,9,71,205,276,7907,09:00 - 10:59
winter,2012-09-23,10,138,351,489,7907,09:00 - 10:59
winter,2012-09-23,11,186,384,570,7907,11:00 - 12:59
winter,2012-09-23,12,250,526,776,7907,11:00 - 12:59
winter,2012-09-23,13,257,445,702,7907,13:00 - 14:59
winter,2012-09-23,14,266,400,666,7907,13:00 - 14:59
winter,2012-09-23,15,265,375,640,7907,15:00 - 16:59
winter,2012-09-23,16,254,437,691,7907,15:00 - 16:59
winter,2012-09-23,17,227,496,723,7907,17:00 - 18:59
winter,2012-09-23,18,135,405,540,7907,17:00 - 18:59
winter,2012-09-23,19,82,331,413,7907,19:00 - 20:59
winter,2012-09-23,20,60,192,252,7907,19:00 - 20:59
winter,2012-09-23,21,51,145,196,7907,21:00 - 22:59
winter,2012-09-23,22,40,98,138,7907,21:00 - 22:59
winter,2012-09-23,23,30,70,100,7907,23:00 - 24:59
winter,2012-09-24,0,10,54,64,7436,
winter,2012-09-24,1,6,12,18,7436,01:00 - 02:59
winter,2012-09-24,2,0,8,8,7436,01:00 - 02:59
winter,2012-09-24,3,0,5,5,7436,03:00 - 04:59
winter,2012-09-24,4,0,8,8,7436,03:00 - 04:59
winter,2012-09-24,5,2,35,37,7436,05:00 - 06:59
winter,2012-09-24,6,6,162,168,7436,05:00 - 06:59
winter,2012-09-24,7,17,513,530,7436,07:00 - 08:59
winter,2012-09-24,8,31,719,750,7436,07:00 - 08:59
winter,2012-09-24,9,42,286,328,7436,09:00 - 10:59
winter,2012-09-24,10,52,146,198,7436,09:00 - 10:59
winter,2012-09-24,11,71,167,238,7436,11:00 - 12:59
winter,2012-09-24,12,77,265,342,7436,11:00 - 12:59
winter,2012-09-24,13,80,248,328,7436,13:00 - 14:59
winter,2012-09-24,14,77,226,303,7436,13:00 - 14:59
winter,2012-09-24,15,84,216,300,7436,15:00 - 16:59
winter,2012-09-24,16,99,417,516,7436,15:00 - 16:59
winter,2012-09-24,17,89,809,898,7436,17:00 - 18:59
winter,2012-09-24,18,95,758,853,7436,17:00 - 18:59
winter,2012-09-24,19,56,534,590,7436,19:00 - 20:59
winter,2012-09-24,20,52,380,432,7436,19:00 - 20:59
winter,2012-09-24,21,26,230,256,7436,21:00 - 22:59
winter,2012-09-24,22,18,154,172,7436,21:00 - 22:59
winter,2012-09-24,23,11,83,94,7436,23:00 - 24:59
winter,2012-09-25,0,8,56,64,7538,
winter,2012-09-25,1,2,11,13,7538,01:00 - 02:59
winter,2012-09-25,2,5,9,14,7538,01:00 - 02:59
winter,2012-09-25,3,2,3,5,7538,03:00 - 04:59
winter,2012-09-25,4,2,7,9,7538,03:00 - 04:59
winter,2012-09-25,5,1,46,47,7538,05:00 - 06:59
winter,2012-09-25,6,5,189,194,7538,05:00 - 06:59
winter,2012-09-25,7,17,539,556,7538,07:00 - 08:59
winter,2012-09-25,8,41,764,805,7538,07:00 - 08:59
winter,2012-09-25,9,28,381,409,7538,09:00 - 10:59
winter,2012-09-25,10,45,125,170,7538,09:00 - 10:59
winter,2012-09-25,11,63,155,218,7538,11:00 - 12:59
winter,2012-09-25,12,69,233,302,7538,11:00 - 12:59
winter,2012-09-25,13,48,257,305,7538,13:00 - 14:59
winter,2012-09-25,14,80,213,293,7538,13:00 - 14:59
winter,2012-09-25,15,56,247,303,7538,15:00 - 16:59
winter,2012-09-25,16,59,436,495,7538,15:00 - 16:59
winter,2012-09-25,17,107,860,967,7538,17:00 - 18:59
winter,2012-09-25,18,64,758,822,7538,17:00 - 18:59
winter,2012-09-25,19,49,490,539,7538,19:00 - 20:59
winter,2012-09-25,20,37,388,425,7538,19:00 - 20:59
winter,2012-09-25,21,34,263,297,7538,21:00 - 22:59
winter,2012-09-25,22,14,174,188,7538,21:00 - 22:59
winter,2012-09-25,23,9,89,98,7538,23:00 - 24:59
winter,2012-09-26,0,6,34,40,7733,
winter,2012-09-26,1,10,19,29,7733,01:00 - 02:59
winter,2012-09-26,2,2,15,17,7733,01:00 - 02:59
winter,2012-09-26,3,4,6,10,7733,03:00 - 04:59
winter,2012-09-26,4,2,12,14,7733,03:00 - 04:59
winter,2012-09-26,5,1,35,36,7733,05:00 - 06:59
winter,2012-09-26,6,3,179,182,7733,05:00 - 06:59
winter,2012-09-26,7,9,523,532,7733,07:00 - 08:59
winter,2012-09-26,8,30,808,838,7733,07:00 - 08:59
winter,2012-09-26,9,27,307,334,7733,09:00 - 10:59
winter,2012-09-26,10,29,156,185,7733,09:00 - 10:59
winter,2012-09-26,11,46,181,227,7733,11:00 - 12:59
winter,2012-09-26,12,56,260,316,7733,11:00 - 12:59
winter,2012-09-26,13,67,273,340,7733,13:00 - 14:59
winter,2012-09-26,14,60,217,277,7733,13:00 - 14:59
winter,2012-09-26,15,69,231,300,7733,15:00 - 16:59
winter,2012-09-26,16,71,397,468,7733,15:00 - 16:59
winter,2012-09-26,17,77,876,953,7733,17:00 - 18:59
winter,2012-09-26,18,69,815,884,7733,17:00 - 18:59
winter,2012-09-26,19,38,589,627,7733,19:00 - 20:59
winter,2012-09-26,20,45,389,434,7733,19:00 - 20:59
winter,2012-09-26,21,32,328,360,7733,21:00 - 22:59
winter,2012-09-26,22,21,194,215,7733,21:00 - 22:59
winter,2012-09-26,23,13,102,115,7733,23:00 - 24:59
winter,2012-09-27,0,5,60,65,7393,
winter,2012-09-27,1,5,16,21,7393,01:00 - 02:59
winter,2012-09-27,2,3,13,16,7393,01:00 - 02:59
winter,2012-09-27,3,0,7,7,7393,03:00 - 04:59
winter,2012-09-27,4,2,6,8,7393,03:00 - 04:59
winter,2012-09-27,5,2,64,66,7393,05:00 - 06:59
winter,2012-09-27,6,5,164,169,7393,05:00 - 06:59
winter,2012-09-27,7,12,546,558,7393,07:00 - 08:59
winter,2012-09-27,8,20,774,794,7393,07:00 - 08:59
winter,2012-09-27,9,30,305,335,7393,09:00 - 10:59
winter,2012-09-27,10,40,168,208,7393,09:00 - 10:59
winter,2012-09-27,11,67,227,294,7393,11:00 - 12:59
winter,2012-09-27,12,63,272,335,7393,11:00 - 12:59
winter,2012-09-27,13,61,265,326,7393,13:00 - 14:59
winter,2012-09-27,14,44,214,258,7393,13:00 - 14:59
winter,2012-09-27,15,41,255,296,7393,15:00 - 16:59
winter,2012-09-27,16,73,399,472,7393,15:00 - 16:59
winter,2012-09-27,17,87,818,905,7393,17:00 - 18:59
winter,2012-09-27,18,77,822,899,7393,17:00 - 18:59
winter,2012-09-27,19,48,511,559,7393,19:00 - 20:59
winter,2012-09-27,20,45,412,457,7393,19:00 - 20:59
winter,2012-09-27,21,18,235,253,7393,21:00 - 22:59
winter,2012-09-27,22,2,45,47,7393,21:00 - 22:59
winter,2012-09-27,23,1,44,45,7393,23:00 - 24:59
winter,2012-09-28,0,2,15,17,7415,
winter,2012-09-28,1,0,13,13,7415,01:00 - 02:59
winter,2012-09-28,2,1,9,10,7415,01:00 - 02:59
winter,2012-09-28,3,0,7,7,7415,03:00 - 04:59
winter,2012-09-28,4,2,10,12,7415,03:00 - 04:59
winter,2012-09-28,5,1,37,38,7415,05:00 - 06:59
winter,2012-09-28,6,2,136,138,7415,05:00 - 06:59
winter,2012-09-28,7,10,384,394,7415,07:00 - 08:59
winter,2012-09-28,8,31,674,705,7415,07:00 - 08:59
winter,2012-09-28,9,27,399,426,7415,09:00 - 10:59
winter,2012-09-28,10,51,194,245,7415,09:00 - 10:59
winter,2012-09-28,11,109,252,361,7415,11:00 - 12:59
winter,2012-09-28,12,94,286,380,7415,11:00 - 12:59
winter,2012-09-28,13,106,304,410,7415,13:00 - 14:59
winter,2012-09-28,14,105,294,399,7415,13:00 - 14:59
winter,2012-09-28,15,104,288,392,7415,15:00 - 16:59
winter,2012-09-28,16,83,419,502,7415,15:00 - 16:59
winter,2012-09-28,17,101,707,808,7415,17:00 - 18:59
winter,2012-09-28,18,58,609,667,7415,17:00 - 18:59
winter,2012-09-28,19,38,470,508,7415,19:00 - 20:59
winter,2012-09-28,20,32,304,336,7415,19:00 - 20:59
winter,2012-09-28,21,32,205,237,7415,21:00 - 22:59
winter,2012-09-28,22,30,190,220,7415,21:00 - 22:59
winter,2012-09-28,23,26,164,190,7415,23:00 - 24:59
winter,2012-09-29,0,15,134,149,8555,
winter,2012-09-29,1,12,89,101,8555,01:00 - 02:59
winter,2012-09-29,2,12,80,92,8555,01:00 - 02:59
winter,2012-09-29,3,4,25,29,8555,03:00 - 04:59
winter,2012-09-29,4,6,8,14,8555,03:00 - 04:59
winter,2012-09-29,5,2,13,15,8555,05:00 - 06:59
winter,2012-09-29,6,4,33,37,8555,05:00 - 06:59
winter,2012-09-29,7,12,61,73,8555,07:00 - 08:59
winter,2012-09-29,8,37,174,211,8555,07:00 - 08:59
winter,2012-09-29,9,69,263,332,8555,09:00 - 10:59
winter,2012-09-29,10,134,338,472,8555,09:00 - 10:59
winter,2012-09-29,11,217,446,663,8555,11:00 - 12:59
winter,2012-09-29,12,191,491,682,8555,11:00 - 12:59
winter,2012-09-29,13,233,453,686,8555,13:00 - 14:59
winter,2012-09-29,14,302,448,750,8555,13:00 - 14:59
winter,2012-09-29,15,271,456,727,8555,15:00 - 16:59
winter,2012-09-29,16,275,447,722,8555,15:00 - 16:59
winter,2012-09-29,17,256,456,712,8555,17:00 - 18:59
winter,2012-09-29,18,174,420,594,8555,17:00 - 18:59
winter,2012-09-29,19,119,351,470,8555,19:00 - 20:59
winter,2012-09-29,20,88,227,315,8555,19:00 - 20:59
winter,2012-09-29,21,73,219,292,8555,21:00 - 22:59
winter,2012-09-29,22,48,173,221,8555,21:00 - 22:59
winter,2012-09-29,23,35,161,196,8555,23:00 - 24:59
winter,2012-09-30,0,35,112,147,6889,
winter,2012-09-30,1,31,85,116,6889,01:00 - 02:59
winter,2012-09-30,2,21,71,92,6889,01:00 - 02:59
winter,2012-09-30,3,17,41,58,6889,03:00 - 04:59
winter,2012-09-30,4,1,6,7,6889,03:00 - 04:59
winter,2012-09-30,5,1,9,10,6889,05:00 - 06:59
winter,2012-09-30,6,2,20,22,6889,05:00 - 06:59
winter,2012-09-30,7,14,43,57,6889,07:00 - 08:59
winter,2012-09-30,8,18,126,144,6889,07:00 - 08:59
winter,2012-09-30,9,74,211,285,6889,09:00 - 10:59
winter,2012-09-30,10,160,319,479,6889,09:00 - 10:59
winter,2012-09-30,11,222,369,591,6889,11:00 - 12:59
winter,2012-09-30,12,206,474,680,6889,11:00 - 12:59
winter,2012-09-30,13,180,414,594,6889,13:00 - 14:59
winter,2012-09-30,14,208,404,612,6889,13:00 - 14:59
winter,2012-09-30,15,230,419,649,6889,15:00 - 16:59
winter,2012-09-30,16,202,446,648,6889,15:00 - 16:59
winter,2012-09-30,17,195,380,575,6889,17:00 - 18:59
winter,2012-09-30,18,91,310,401,6889,17:00 - 18:59
winter,2012-09-30,19,34,223,257,6889,19:00 - 20:59
winter,2012-09-30,20,31,163,194,6889,19:00 - 20:59
winter,2012-09-30,21,19,104,123,6889,21:00 - 22:59
winter,2012-09-30,22,15,76,91,6889,21:00 - 22:59
winter,2012-09-30,23,8,49,57,6889,23:00 - 24:59
winter,2012-10-01,0,6,39,45,6778,
winter,2012-10-01,1,5,13,18,6778,01:00 - 02:59
winter,2012-10-01,2,6,6,12,6778,01:00 - 02:59
winter,2012-10-01,3,1,6,7,6778,03:00 - 04:59
winter,2012-10-01,4,0,10,10,6778,03:00 - 04:59
winter,2012-10-01,5,2,34,36,6778,05:00 - 06:59
winter,2012-10-01,6,8,147,155,6778,05:00 - 06:59
winter,2012-10-01,7,13,470,483,6778,07:00 - 08:59
winter,2012-10-01,8,40,744,784,6778,07:00 - 08:59
winter,2012-10-01,9,26,314,340,6778,09:00 - 10:59
winter,2012-10-01,10,44,135,179,6778,09:00 - 10:59
winter,2012-10-01,11,76,196,272,6778,11:00 - 12:59
winter,2012-10-01,12,61,262,323,6778,11:00 - 12:59
winter,2012-10-01,13,80,225,305,6778,13:00 - 14:59
winter,2012-10-01,14,51,193,244,6778,13:00 - 14:59
winter,2012-10-01,15,95,234,329,6778,15:00 - 16:59
winter,2012-10-01,16,51,408,459,6778,15:00 - 16:59
winter,2012-10-01,17,65,791,856,6778,17:00 - 18:59
winter,2012-10-01,18,42,571,613,6778,17:00 - 18:59
winter,2012-10-01,19,33,483,516,6778,19:00 - 20:59
winter,2012-10-01,20,11,251,262,6778,19:00 - 20:59
winter,2012-10-01,21,13,205,218,6778,21:00 - 22:59
winter,2012-10-01,22,17,190,207,6778,21:00 - 22:59
winter,2012-10-01,23,17,88,105,6778,23:00 - 24:59
winter,2012-10-02,0,1,30,31,4639,
winter,2012-10-02,1,0,11,11,4639,01:00 - 02:59
winter,2012-10-02,2,0,2,2,4639,01:00 - 02:59
winter,2012-10-02,3,1,4,5,4639,03:00 - 04:59
winter,2012-10-02,4,2,8,10,4639,03:00 - 04:59
winter,2012-10-02,5,1,42,43,4639,05:00 - 06:59
winter,2012-10-02,6,3,176,179,4639,05:00 - 06:59
winter,2012-10-02,7,4,256,260,4639,07:00 - 08:59
winter,2012-10-02,8,6,128,134,4639,07:00 - 08:59
winter,2012-10-02,9,3,83,86,4639,09:00 - 10:59
winter,2012-10-02,10,3,42,45,4639,09:00 - 10:59
winter,2012-10-02,11,7,92,99,4639,11:00 - 12:59
winter,2012-10-02,12,6,98,104,4639,11:00 - 12:59
winter,2012-10-02,13,6,148,154,4639,13:00 - 14:59
winter,2012-10-02,14,16,147,163,4639,13:00 - 14:59
winter,2012-10-02,15,14,195,209,4639,15:00 - 16:59
winter,2012-10-02,16,46,328,374,4639,15:00 - 16:59
winter,2012-10-02,17,38,677,715,4639,17:00 - 18:59
winter,2012-10-02,18,48,639,687,4639,17:00 - 18:59
winter,2012-10-02,19,27,368,395,4639,19:00 - 20:59
winter,2012-10-02,20,20,286,306,4639,19:00 - 20:59
winter,2012-10-02,21,24,265,289,4639,21:00 - 22:59
winter,2012-10-02,22,28,212,240,4639,21:00 - 22:59
winter,2012-10-02,23,11,87,98,4639,23:00 - 24:59
winter,2012-10-03,0,5,47,52,7572,
winter,2012-10-03,1,3,16,19,7572,01:00 - 02:59
winter,2012-10-03,2,2,7,9,7572,01:00 - 02:59
winter,2012-10-03,3,0,7,7,7572,03:00 - 04:59
winter,2012-10-03,4,2,9,11,7572,03:00 - 04:59
winter,2012-10-03,5,2,32,34,7572,05:00 - 06:59
winter,2012-10-03,6,4,173,177,7572,05:00 - 06:59
winter,2012-10-03,7,11,504,515,7572,07:00 - 08:59
winter,2012-10-03,8,28,781,809,7572,07:00 - 08:59
winter,2012-10-03,9,30,332,362,7572,09:00 - 10:59
winter,2012-10-03,10,29,146,175,7572,09:00 - 10:59
winter,2012-10-03,11,52,178,230,7572,11:00 - 12:59
winter,2012-10-03,12,69,289,358,7572,11:00 - 12:59
winter,2012-10-03,13,55,224,279,7572,13:00 - 14:59
winter,2012-10-03,14,56,195,251,7572,13:00 - 14:59
winter,2012-10-03,15,59,260,319,7572,15:00 - 16:59
winter,2012-10-03,16,42,436,478,7572,15:00 - 16:59
winter,2012-10-03,17,84,833,917,7572,17:00 - 18:59
winter,2012-10-03,18,54,756,810,7572,17:00 - 18:59
winter,2012-10-03,19,49,544,593,7572,19:00 - 20:59
winter,2012-10-03,20,48,449,497,7572,19:00 - 20:59
winter,2012-10-03,21,14,195,209,7572,21:00 - 22:59
winter,2012-10-03,22,9,232,241,7572,21:00 - 22:59
winter,2012-10-03,23,21,199,220,7572,23:00 - 24:59
winter,2012-10-04,0,11,65,76,7328,
winter,2012-10-04,1,2,23,25,7328,01:00 - 02:59
winter,2012-10-04,2,3,10,13,7328,01:00 - 02:59
winter,2012-10-04,3,5,6,11,7328,03:00 - 04:59
winter,2012-10-04,4,0,10,10,7328,03:00 - 04:59
winter,2012-10-04,5,2,37,39,7328,05:00 - 06:59
winter,2012-10-04,6,1,132,133,7328,05:00 - 06:59
winter,2012-10-04,7,12,379,391,7328,07:00 - 08:59
winter,2012-10-04,8,27,711,738,7328,07:00 - 08:59
winter,2012-10-04,9,40,319,359,7328,09:00 - 10:59
winter,2012-10-04,10,27,150,177,7328,09:00 - 10:59
winter,2012-10-04,11,38,176,214,7328,11:00 - 12:59
winter,2012-10-04,12,57,231,288,7328,11:00 - 12:59
winter,2012-10-04,13,63,231,294,7328,13:00 - 14:59
winter,2012-10-04,14,56,211,267,7328,13:00 - 14:59
winter,2012-10-04,15,77,248,325,7328,15:00 - 16:59
winter,2012-10-04,16,86,411,497,7328,15:00 - 16:59
winter,2012-10-04,17,112,789,901,7328,17:00 - 18:59
winter,2012-10-04,18,75,812,887,7328,17:00 - 18:59
winter,2012-10-04,19,67,467,534,7328,19:00 - 20:59
winter,2012-10-04,20,50,391,441,7328,19:00 - 20:59
winter,2012-10-04,21,33,288,321,7328,21:00 - 22:59
winter,2012-10-04,22,29,203,232,7328,21:00 - 22:59
winter,2012-10-04,23,18,137,155,7328,23:00 - 24:59
winter,2012-10-05,0,16,86,102,8156,
winter,2012-10-05,1,3,43,46,8156,01:00 - 02:59
winter,2012-10-05,2,1,10,11,8156,01:00 - 02:59
winter,2012-10-05,3,5,11,16,8156,03:00 - 04:59
winter,2012-10-05,4,0,11,11,8156,03:00 - 04:59
winter,2012-10-05,5,0,41,41,8156,05:00 - 06:59
winter,2012-10-05,6,4,133,137,8156,05:00 - 06:59
winter,2012-10-05,7,11,417,428,8156,07:00 - 08:59
winter,2012-10-05,8,36,749,785,8156,07:00 - 08:59
winter,2012-10-05,9,58,326,384,8156,09:00 - 10:59
winter,2012-10-05,10,68,192,260,8156,09:00 - 10:59
winter,2012-10-05,11,90,214,304,8156,11:00 - 12:59
winter,2012-10-05,12,161,307,468,8156,11:00 - 12:59
winter,2012-10-05,13,117,307,424,8156,13:00 - 14:59
winter,2012-10-05,14,113,287,400,8156,13:00 - 14:59
winter,2012-10-05,15,150,320,470,8156,15:00 - 16:59
winter,2012-10-05,16,153,481,634,8156,15:00 - 16:59
winter,2012-10-05,17,158,742,900,8156,17:00 - 18:59
winter,2012-10-05,18,106,655,761,8156,17:00 - 18:59
winter,2012-10-05,19,67,433,500,8156,19:00 - 20:59
winter,2012-10-05,20,66,306,372,8156,19:00 - 20:59
winter,2012-10-05,21,47,220,267,8156,21:00 - 22:59
winter,2012-10-05,22,63,201,264,8156,21:00 - 22:59
winter,2012-10-05,23,23,148,171,8156,23:00 - 24:59
winter,2012-10-06,0,37,154,191,7965,
winter,2012-10-06,1,25,116,141,7965,01:00 - 02:59
winter,2012-10-06,2,13,62,75,7965,01:00 - 02:59
winter,2012-10-06,3,2,54,56,7965,03:00 - 04:59
winter,2012-10-06,4,4,7,11,7965,03:00 - 04:59
winter,2012-10-06,5,2,8,10,7965,05:00 - 06:59
winter,2012-10-06,6,2,28,30,7965,05:00 - 06:59
winter,2012-10-06,7,13,71,84,7965,07:00 - 08:59
winter,2012-10-06,8,22,184,206,7965,07:00 - 08:59
winter,2012-10-06,9,130,265,395,7965,09:00 - 10:59
winter,2012-10-06,10,198,341,539,7965,09:00 - 10:59
winter,2012-10-06,11,258,389,647,7965,11:00 - 12:59
winter,2012-10-06,12,362,381,743,7965,11:00 - 12:59
winter,2012-10-06,13,310,400,710,7965,13:00 - 14:59
winter,2012-10-06,14,269,307,576,7965,13:00 - 14:59
winter,2012-10-06,15,279,341,620,7965,15:00 - 16:59
winter,2012-10-06,16,317,342,659,7965,15:00 - 16:59
winter,2012-10-06,17,268,342,610,7965,17:00 - 18:59
winter,2012-10-06,18,183,312,495,7965,17:00 - 18:59
winter,2012-10-06,19,102,239,341,7965,19:00 - 20:59
winter,2012-10-06,20,75,172,247,7965,19:00 - 20:59
winter,2012-10-06,21,78,137,215,7965,21:00 - 22:59
winter,2012-10-06,22,45,140,185,7965,21:00 - 22:59
winter,2012-10-06,23,37,142,179,7965,23:00 - 24:59
winter,2012-10-07,0,28,99,127,3510,
winter,2012-10-07,1,29,80,109,3510,01:00 - 02:59
winter,2012-10-07,2,10,64,74,3510,01:00 - 02:59
winter,2012-10-07,3,5,17,22,3510,03:00 - 04:59
winter,2012-10-07,4,5,6,11,3510,03:00 - 04:59
winter,2012-10-07,5,2,8,10,3510,05:00 - 06:59
winter,2012-10-07,6,4,19,23,3510,05:00 - 06:59
winter,2012-10-07,7,6,29,35,3510,07:00 - 08:59
winter,2012-10-07,8,11,51,62,3510,07:00 - 08:59
winter,2012-10-07,9,16,70,86,3510,09:00 - 10:59
winter,2012-10-07,10,41,144,185,3510,09:00 - 10:59
winter,2012-10-07,11,76,260,336,3510,11:00 - 12:59
winter,2012-10-07,12,100,292,392,3510,11:00 - 12:59
winter,2012-10-07,13,80,240,320,3510,13:00 - 14:59
winter,2012-10-07,14,71,243,314,3510,13:00 - 14:59
winter,2012-10-07,15,74,232,306,3510,15:00 - 16:59
winter,2012-10-07,16,87,246,333,3510,15:00 - 16:59
winter,2012-10-07,17,35,122,157,3510,17:00 - 18:59
winter,2012-10-07,18,24,82,106,3510,17:00 - 18:59
winter,2012-10-07,19,17,97,114,3510,19:00 - 20:59
winter,2012-10-07,20,19,97,116,3510,19:00 - 20:59
winter,2012-10-07,21,22,91,113,3510,21:00 - 22:59
winter,2012-10-07,22,7,72,79,3510,21:00 - 22:59
winter,2012-10-07,23,12,68,80,3510,23:00 - 24:59
winter,2012-10-08,0,7,44,51,5478,
winter,2012-10-08,1,2,35,37,5478,01:00 - 02:59
winter,2012-10-08,2,3,12,15,5478,01:00 - 02:59
winter,2012-10-08,3,2,8,10,5478,03:00 - 04:59
winter,2012-10-08,4,1,6,7,5478,03:00 - 04:59
winter,2012-10-08,5,2,17,19,5478,05:00 - 06:59
winter,2012-10-08,6,5,54,59,5478,05:00 - 06:59
winter,2012-10-08,7,3,151,154,5478,07:00 - 08:59
winter,2012-10-08,8,23,374,397,5478,07:00 - 08:59
winter,2012-10-08,9,59,273,332,5478,09:00 - 10:59
winter,2012-10-08,10,69,229,298,5478,09:00 - 10:59
winter,2012-10-08,11,72,236,308,5478,11:00 - 12:59
winter,2012-10-08,12,74,267,341,5478,11:00 - 12:59
winter,2012-10-08,13,82,323,405,5478,13:00 - 14:59
winter,2012-10-08,14,121,299,420,5478,13:00 - 14:59
winter,2012-10-08,15,76,294,370,5478,15:00 - 16:59
winter,2012-10-08,16,61,316,377,5478,15:00 - 16:59
winter,2012-10-08,17,81,416,497,5478,17:00 - 18:59
winter,2012-10-08,18,41,415,456,5478,17:00 - 18:59
winter,2012-10-08,19,38,333,371,5478,19:00 - 20:59
winter,2012-10-08,20,20,207,227,5478,19:00 - 20:59
winter,2012-10-08,21,17,134,151,5478,21:00 - 22:59
winter,2012-10-08,22,6,101,107,5478,21:00 - 22:59
winter,2012-10-08,23,9,60,69,5478,23:00 - 24:59
winter,2012-10-09,0,9,22,31,6392,
winter,2012-10-09,1,0,13,13,6392,01:00 - 02:59
winter,2012-10-09,2,2,5,7,6392,01:00 - 02:59
winter,2012-10-09,3,0,3,3,6392,03:00 - 04:59
winter,2012-10-09,4,1,6,7,6392,03:00 - 04:59
winter,2012-10-09,5,0,19,19,6392,05:00 - 06:59
winter,2012-10-09,6,2,141,143,6392,05:00 - 06:59
winter,2012-10-09,7,5,357,362,6392,07:00 - 08:59
winter,2012-10-09,8,15,698,713,6392,07:00 - 08:59
winter,2012-10-09,9,37,345,382,6392,09:00 - 10:59
winter,2012-10-09,10,33,131,164,6392,09:00 - 10:59
winter,2012-10-09,11,37,156,193,6392,11:00 - 12:59
winter,2012-10-09,12,43,217,260,6392,11:00 - 12:59
winter,2012-10-09,13,54,184,238,6392,13:00 - 14:59
winter,2012-10-09,14,43,201,244,6392,13:00 - 14:59
winter,2012-10-09,15,59,195,254,6392,15:00 - 16:59
winter,2012-10-09,16,70,354,424,6392,15:00 - 16:59
winter,2012-10-09,17,73,733,806,6392,17:00 - 18:59
winter,2012-10-09,18,26,758,784,6392,17:00 - 18:59
winter,2012-10-09,19,31,483,514,6392,19:00 - 20:59
winter,2012-10-09,20,30,330,360,6392,19:00 - 20:59
winter,2012-10-09,21,16,209,225,6392,21:00 - 22:59
winter,2012-10-09,22,7,155,162,6392,21:00 - 22:59
winter,2012-10-09,23,8,76,84,6392,23:00 - 24:59
winter,2012-10-10,0,0,33,33,7691,
winter,2012-10-10,1,2,6,8,7691,01:00 - 02:59
winter,2012-10-10,2,2,6,8,7691,01:00 - 02:59
winter,2012-10-10,3,0,6,6,7691,03:00 - 04:59
winter,2012-10-10,4,0,6,6,7691,03:00 - 04:59
winter,2012-10-10,5,2,38,40,7691,05:00 - 06:59
winter,2012-10-10,6,3,172,175,7691,05:00 - 06:59
winter,2012-10-10,7,9,498,507,7691,07:00 - 08:59
winter,2012-10-10,8,33,806,839,7691,07:00 - 08:59
winter,2012-10-10,9,35,331,366,7691,09:00 - 10:59
winter,2012-10-10,10,27,190,217,7691,09:00 - 10:59
winter,2012-10-10,11,53,238,291,7691,11:00 - 12:59
winter,2012-10-10,12,78,312,390,7691,11:00 - 12:59
winter,2012-10-10,13,60,237,297,7691,13:00 - 14:59
winter,2012-10-10,14,63,208,271,7691,13:00 - 14:59
winter,2012-10-10,15,58,261,319,7691,15:00 - 16:59
winter,2012-10-10,16,92,474,566,7691,15:00 - 16:59
winter,2012-10-10,17,91,857,948,7691,17:00 - 18:59
winter,2012-10-10,18,57,787,844,7691,17:00 - 18:59
winter,2012-10-10,19,32,534,566,7691,19:00 - 20:59
winter,2012-10-10,20,21,371,392,7691,19:00 - 20:59
winter,2012-10-10,21,18,251,269,7691,21:00 - 22:59
winter,2012-10-10,22,27,170,197,7691,21:00 - 22:59
winter,2012-10-10,23,17,119,136,7691,23:00 - 24:59
winter,2012-10-11,0,1,41,42,7570,
winter,2012-10-11,1,1,10,11,7570,01:00 - 02:59
winter,2012-10-11,2,4,7,11,7570,01:00 - 02:59
winter,2012-10-11,3,0,3,3,7570,03:00 - 04:59
winter,2012-10-11,4,0,10,10,7570,03:00 - 04:59
winter,2012-10-11,5,0,42,42,7570,05:00 - 06:59
winter,2012-10-11,6,1,158,159,7570,05:00 - 06:59
winter,2012-10-11,7,11,467,478,7570,07:00 - 08:59
winter,2012-10-11,8,25,773,798,7570,07:00 - 08:59
winter,2012-10-11,9,27,328,355,7570,09:00 - 10:59
winter,2012-10-11,10,39,165,204,7570,09:00 - 10:59
winter,2012-10-11,11,76,175,251,7570,11:00 - 12:59
winter,2012-10-11,12,47,279,326,7570,11:00 - 12:59
winter,2012-10-11,13,48,243,291,7570,13:00 - 14:59
winter,2012-10-11,14,78,270,348,7570,13:00 - 14:59
winter,2012-10-11,15,102,358,460,7570,15:00 - 16:59
winter,2012-10-11,16,68,413,481,7570,15:00 - 16:59
winter,2012-10-11,17,90,737,827,7570,17:00 - 18:59
winter,2012-10-11,18,64,628,692,7570,17:00 - 18:59
winter,2012-10-11,19,81,662,743,7570,19:00 - 20:59
winter,2012-10-11,20,27,388,415,7570,19:00 - 20:59
winter,2012-10-11,21,24,236,260,7570,21:00 - 22:59
winter,2012-10-11,22,10,167,177,7570,21:00 - 22:59
winter,2012-10-11,23,10,176,186,7570,23:00 - 24:59
winter,2012-10-12,0,8,60,68,7282,
winter,2012-10-12,1,8,29,37,7282,01:00 - 02:59
winter,2012-10-12,2,0,16,16,7282,01:00 - 02:59
winter,2012-10-12,3,0,6,6,7282,03:00 - 04:59
winter,2012-10-12,4,0,8,8,7282,03:00 - 04:59
winter,2012-10-12,5,2,33,35,7282,05:00 - 06:59
winter,2012-10-12,6,3,140,143,7282,05:00 - 06:59
winter,2012-10-12,7,8,384,392,7282,07:00 - 08:59
winter,2012-10-12,8,34,711,745,7282,07:00 - 08:59
winter,2012-10-12,9,26,374,400,7282,09:00 - 10:59
winter,2012-10-12,10,75,200,275,7282,09:00 - 10:59
winter,2012-10-12,11,61,252,313,7282,11:00 - 12:59
winter,2012-10-12,12,75,312,387,7282,11:00 - 12:59
winter,2012-10-12,13,81,300,381,7282,13:00 - 14:59
winter,2012-10-12,14,109,262,371,7282,13:00 - 14:59
winter,2012-10-12,15,138,317,455,7282,15:00 - 16:59
winter,2012-10-12,16,108,412,520,7282,15:00 - 16:59
winter,2012-10-12,17,131,706,837,7282,17:00 - 18:59
winter,2012-10-12,18,76,566,642,7282,17:00 - 18:59
winter,2012-10-12,19,40,453,493,7282,19:00 - 20:59
winter,2012-10-12,20,28,280,308,7282,19:00 - 20:59
winter,2012-10-12,21,21,169,190,7282,21:00 - 22:59
winter,2012-10-12,22,17,143,160,7282,21:00 - 22:59
winter,2012-10-12,23,11,89,100,7282,23:00 - 24:59
winter,2012-10-13,0,31,218,249,7109,
winter,2012-10-13,1,23,123,146,7109,01:00 - 02:59
winter,2012-10-13,2,7,60,67,7109,01:00 - 02:59
winter,2012-10-13,3,2,13,15,7109,03:00 - 04:59
winter,2012-10-13,4,2,9,11,7109,03:00 - 04:59
winter,2012-10-13,5,0,11,11,7109,05:00 - 06:59
winter,2012-10-13,6,5,23,28,7109,05:00 - 06:59
winter,2012-10-13,7,10,60,70,7109,07:00 - 08:59
winter,2012-10-13,8,23,151,174,7109,07:00 - 08:59
winter,2012-10-13,9,46,220,266,7109,09:00 - 10:59
winter,2012-10-13,10,82,265,347,7109,09:00 - 10:59
winter,2012-10-13,11,192,335,527,7109,11:00 - 12:59
winter,2012-10-13,12,202,371,573,7109,11:00 - 12:59
winter,2012-10-13,13,235,435,670,7109,13:00 - 14:59
winter,2012-10-13,14,243,354,597,7109,13:00 - 14:59
winter,2012-10-13,15,251,364,615,7109,15:00 - 16:59
winter,2012-10-13,16,294,343,637,7109,15:00 - 16:59
winter,2012-10-13,17,193,335,528,7109,17:00 - 18:59
winter,2012-10-13,18,174,299,473,7109,17:00 - 18:59
winter,2012-10-13,19,73,259,332,7109,19:00 - 20:59
winter,2012-10-13,20,57,198,255,7109,19:00 - 20:59
winter,2012-10-13,21,47,157,204,7109,21:00 - 22:59
winter,2012-10-13,22,33,156,189,7109,21:00 - 22:59
winter,2012-10-13,23,27,98,125,7109,23:00 - 24:59
winter,2012-10-14,0,8,103,111,6639,
winter,2012-10-14,1,16,96,112,6639,01:00 - 02:59
winter,2012-10-14,2,8,58,66,6639,01:00 - 02:59
winter,2012-10-14,3,3,25,28,6639,03:00 - 04:59
winter,2012-10-14,4,2,10,12,6639,03:00 - 04:59
winter,2012-10-14,5,5,6,11,6639,05:00 - 06:59
winter,2012-10-14,6,4,20,24,6639,05:00 - 06:59
winter,2012-10-14,7,7,44,51,6639,07:00 - 08:59
winter,2012-10-14,8,28,104,132,6639,07:00 - 08:59
winter,2012-10-14,9,62,161,223,6639,09:00 - 10:59
winter,2012-10-14,10,150,278,428,6639,09:00 - 10:59
winter,2012-10-14,11,156,338,494,6639,11:00 - 12:59
winter,2012-10-14,12,200,362,562,6639,11:00 - 12:59
winter,2012-10-14,13,218,401,619,6639,13:00 - 14:59
winter,2012-10-14,14,249,368,617,6639,13:00 - 14:59
winter,2012-10-14,15,213,355,568,6639,15:00 - 16:59
winter,2012-10-14,16,203,378,581,6639,15:00 - 16:59
winter,2012-10-14,17,193,346,539,6639,17:00 - 18:59
winter,2012-10-14,18,134,319,453,6639,17:00 - 18:59
winter,2012-10-14,19,68,268,336,6639,19:00 - 20:59
winter,2012-10-14,20,48,198,246,6639,19:00 - 20:59
winter,2012-10-14,21,40,156,196,6639,21:00 - 22:59
winter,2012-10-14,22,38,87,125,6639,21:00 - 22:59
winter,2012-10-14,23,27,78,105,6639,23:00 - 24:59
winter,2012-10-15,0,17,31,48,5875,
winter,2012-10-15,1,5,24,29,5875,01:00 - 02:59
winter,2012-10-15,2,1,5,6,5875,01:00 - 02:59
winter,2012-10-15,3,2,2,4,5875,03:00 - 04:59
winter,2012-10-15,4,1,9,10,5875,03:00 - 04:59
winter,2012-10-15,5,2,38,40,5875,05:00 - 06:59
winter,2012-10-15,6,6,141,147,5875,05:00 - 06:59
winter,2012-10-15,7,15,461,476,5875,07:00 - 08:59
winter,2012-10-15,8,24,713,737,5875,07:00 - 08:59
winter,2012-10-15,9,31,328,359,5875,09:00 - 10:59
winter,2012-10-15,10,43,125,168,5875,09:00 - 10:59
winter,2012-10-15,11,88,175,263,5875,11:00 - 12:59
winter,2012-10-15,12,73,211,284,5875,11:00 - 12:59
winter,2012-10-15,13,37,109,146,5875,13:00 - 14:59
winter,2012-10-15,14,57,128,185,5875,13:00 - 14:59
winter,2012-10-15,15,70,190,260,5875,15:00 - 16:59
winter,2012-10-15,16,76,371,447,5875,15:00 - 16:59
winter,2012-10-15,17,96,670,766,5875,17:00 - 18:59
winter,2012-10-15,18,52,540,592,5875,17:00 - 18:59
winter,2012-10-15,19,12,227,239,5875,19:00 - 20:59
winter,2012-10-15,20,19,237,256,5875,19:00 - 20:59
winter,2012-10-15,21,16,190,206,5875,21:00 - 22:59
winter,2012-10-15,22,8,118,126,5875,21:00 - 22:59
winter,2012-10-15,23,9,72,81,5875,23:00 - 24:59
winter,2012-10-16,0,3,45,48,7534,
winter,2012-10-16,1,4,9,13,7534,01:00 - 02:59
winter,2012-10-16,2,2,1,3,7534,01:00 - 02:59
winter,2012-10-16,3,0,2,2,7534,03:00 - 04:59
winter,2012-10-16,4,0,7,7,7534,03:00 - 04:59
winter,2012-10-16,5,5,47,52,7534,05:00 - 06:59
winter,2012-10-16,6,4,168,172,7534,05:00 - 06:59
winter,2012-10-16,7,20,505,525,7534,07:00 - 08:59
winter,2012-10-16,8,35,800,835,7534,07:00 - 08:59
winter,2012-10-16,9,32,323,355,7534,09:00 - 10:59
winter,2012-10-16,10,65,157,222,7534,09:00 - 10:59
winter,2012-10-16,11,56,172,228,7534,11:00 - 12:59
winter,2012-10-16,12,69,256,325,7534,11:00 - 12:59
winter,2012-10-16,13,68,260,328,7534,13:00 - 14:59
winter,2012-10-16,14,94,214,308,7534,13:00 - 14:59
winter,2012-10-16,15,76,270,346,7534,15:00 - 16:59
winter,2012-10-16,16,79,367,446,7534,15:00 - 16:59
winter,2012-10-16,17,104,839,943,7534,17:00 - 18:59
winter,2012-10-16,18,71,767,838,7534,17:00 - 18:59
winter,2012-10-16,19,40,491,531,7534,19:00 - 20:59
winter,2012-10-16,20,35,397,432,7534,19:00 - 20:59
winter,2012-10-16,21,19,176,195,7534,21:00 - 22:59
winter,2012-10-16,22,18,163,181,7534,21:00 - 22:59
winter,2012-10-16,23,23,176,199,7534,23:00 - 24:59
winter,2012-10-17,0,1,48,49,7461,
winter,2012-10-17,1,3,14,17,7461,01:00 - 02:59
winter,2012-10-17,2,4,12,16,7461,01:00 - 02:59
winter,2012-10-17,3,0,7,7,7461,03:00 - 04:59
winter,2012-10-17,4,0,4,4,7461,03:00 - 04:59
winter,2012-10-17,5,2,39,41,7461,05:00 - 06:59
winter,2012-10-17,6,7,171,178,7461,05:00 - 06:59
winter,2012-10-17,7,15,449,464,7461,07:00 - 08:59
winter,2012-10-17,8,38,779,817,7461,07:00 - 08:59
winter,2012-10-17,9,38,344,382,7461,09:00 - 10:59
winter,2012-10-17,10,60,168,228,7461,09:00 - 10:59
winter,2012-10-17,11,78,156,234,7461,11:00 - 12:59
winter,2012-10-17,12,71,261,332,7461,11:00 - 12:59
winter,2012-10-17,13,73,237,310,7461,13:00 - 14:59
winter,2012-10-17,14,82,188,270,7461,13:00 - 14:59
winter,2012-10-17,15,62,239,301,7461,15:00 - 16:59
winter,2012-10-17,16,70,396,466,7461,15:00 - 16:59
winter,2012-10-17,17,122,766,888,7461,17:00 - 18:59
winter,2012-10-17,18,90,794,884,7461,17:00 - 18:59
winter,2012-10-17,19,49,467,516,7461,19:00 - 20:59
winter,2012-10-17,20,54,360,414,7461,19:00 - 20:59
winter,2012-10-17,21,28,301,329,7461,21:00 - 22:59
winter,2012-10-17,22,17,198,215,7461,21:00 - 22:59
winter,2012-10-17,23,15,84,99,7461,23:00 - 24:59
winter,2012-10-18,0,4,53,57,7509,
winter,2012-10-18,1,0,14,14,7509,01:00 - 02:59
winter,2012-10-18,2,1,13,14,7509,01:00 - 02:59
winter,2012-10-18,3,0,5,5,7509,03:00 - 04:59
winter,2012-10-18,4,0,5,5,7509,03:00 - 04:59
winter,2012-10-18,5,1,41,42,7509,05:00 - 06:59
winter,2012-10-18,6,3,150,153,7509,05:00 - 06:59
winter,2012-10-18,7,20,488,508,7509,07:00 - 08:59
winter,2012-10-18,8,31,803,834,7509,07:00 - 08:59
winter,2012-10-18,9,41,346,387,7509,09:00 - 10:59
winter,2012-10-18,10,60,158,218,7509,09:00 - 10:59
winter,2012-10-18,11,79,189,268,7509,11:00 - 12:59
winter,2012-10-18,12,93,284,377,7509,11:00 - 12:59
winter,2012-10-18,13,96,236,332,7509,13:00 - 14:59
winter,2012-10-18,14,94,191,285,7509,13:00 - 14:59
winter,2012-10-18,15,69,284,353,7509,15:00 - 16:59
winter,2012-10-18,16,94,356,450,7509,15:00 - 16:59
winter,2012-10-18,17,102,788,890,7509,17:00 - 18:59
winter,2012-10-18,18,68,720,788,7509,17:00 - 18:59
winter,2012-10-18,19,42,471,513,7509,19:00 - 20:59
winter,2012-10-18,20,39,348,387,7509,19:00 - 20:59
winter,2012-10-18,21,38,245,283,7509,21:00 - 22:59
winter,2012-10-18,22,27,202,229,7509,21:00 - 22:59
winter,2012-10-18,23,6,111,117,7509,23:00 - 24:59
winter,2012-10-19,0,5,51,56,5424,
winter,2012-10-19,1,4,12,16,5424,01:00 - 02:59
winter,2012-10-19,2,1,9,10,5424,01:00 - 02:59
winter,2012-10-19,3,0,5,5,5424,03:00 - 04:59
winter,2012-10-19,4,1,5,6,5424,03:00 - 04:59
winter,2012-10-19,5,1,35,36,5424,05:00 - 06:59
winter,2012-10-19,6,5,126,131,5424,05:00 - 06:59
winter,2012-10-19,7,5,149,154,5424,07:00 - 08:59
winter,2012-10-19,8,20,447,467,5424,07:00 - 08:59
winter,2012-10-19,9,26,363,389,5424,09:00 - 10:59
winter,2012-10-19,10,26,198,224,5424,09:00 - 10:59
winter,2012-10-19,11,41,211,252,5424,11:00 - 12:59
winter,2012-10-19,12,74,258,332,5424,11:00 - 12:59
winter,2012-10-19,13,87,288,375,5424,13:00 - 14:59
winter,2012-10-19,14,88,277,365,5424,13:00 - 14:59
winter,2012-10-19,15,93,302,395,5424,15:00 - 16:59
winter,2012-10-19,16,131,434,565,5424,15:00 - 16:59
winter,2012-10-19,17,48,377,425,5424,17:00 - 18:59
winter,2012-10-19,18,21,212,233,5424,17:00 - 18:59
winter,2012-10-19,19,19,213,232,5424,19:00 - 20:59
winter,2012-10-19,20,13,216,229,5424,19:00 - 20:59
winter,2012-10-19,21,17,189,206,5424,21:00 - 22:59
winter,2012-10-19,22,14,176,190,5424,21:00 - 22:59
winter,2012-10-19,23,13,118,131,5424,23:00 - 24:59
winter,2012-10-20,0,13,110,123,8090,
winter,2012-10-20,1,2,93,95,8090,01:00 - 02:59
winter,2012-10-20,2,9,69,78,8090,01:00 - 02:59
winter,2012-10-20,3,2,27,29,8090,03:00 - 04:59
winter,2012-10-20,4,9,9,18,8090,03:00 - 04:59
winter,2012-10-20,5,6,7,13,8090,05:00 - 06:59
winter,2012-10-20,6,5,26,31,8090,05:00 - 06:59
winter,2012-10-20,7,6,59,65,8090,07:00 - 08:59
winter,2012-10-20,8,29,164,193,8090,07:00 - 08:59
winter,2012-10-20,9,106,257,363,8090,09:00 - 10:59
winter,2012-10-20,10,111,312,423,8090,09:00 - 10:59
winter,2012-10-20,11,204,408,612,8090,11:00 - 12:59
winter,2012-10-20,12,267,436,703,8090,11:00 - 12:59
winter,2012-10-20,13,273,441,714,8090,13:00 - 14:59
winter,2012-10-20,14,335,376,711,8090,13:00 - 14:59
winter,2012-10-20,15,308,403,711,8090,15:00 - 16:59
winter,2012-10-20,16,325,366,691,8090,15:00 - 16:59
winter,2012-10-20,17,347,384,731,8090,17:00 - 18:59
winter,2012-10-20,18,165,356,521,8090,17:00 - 18:59
winter,2012-10-20,19,77,268,345,8090,19:00 - 20:59
winter,2012-10-20,20,61,198,259,8090,19:00 - 20:59
winter,2012-10-20,21,72,224,296,8090,21:00 - 22:59
winter,2012-10-20,22,47,155,202,8090,21:00 - 22:59
winter,2012-10-20,23,27,136,163,8090,23:00 - 24:59
winter,2012-10-21,0,35,119,154,6824,
winter,2012-10-21,1,20,97,117,6824,01:00 - 02:59
winter,2012-10-21,2,44,88,132,6824,01:00 - 02:59
winter,2012-10-21,3,12,29,41,6824,03:00 - 04:59
winter,2012-10-21,4,8,13,21,6824,03:00 - 04:59
winter,2012-10-21,5,6,4,10,6824,05:00 - 06:59
winter,2012-10-21,6,8,18,26,6824,05:00 - 06:59
winter,2012-10-21,7,13,43,56,6824,07:00 - 08:59
winter,2012-10-21,8,39,104,143,6824,07:00 - 08:59
winter,2012-10-21,9,77,192,269,6824,09:00 - 10:59
winter,2012-10-21,10,167,276,443,6824,09:00 - 10:59
winter,2012-10-21,11,191,356,547,6824,11:00 - 12:59
winter,2012-10-21,12,236,439,675,6824,11:00 - 12:59
winter,2012-10-21,13,243,383,626,6824,13:00 - 14:59
winter,2012-10-21,14,235,405,640,6824,13:00 - 14:59
winter,2012-10-21,15,240,383,623,6824,15:00 - 16:59
winter,2012-10-21,16,182,409,591,6824,15:00 - 16:59
winter,2012-10-21,17,153,338,491,6824,17:00 - 18:59
winter,2012-10-21,18,71,342,413,6824,17:00 - 18:59
winter,2012-10-21,19,50,216,266,6824,19:00 - 20:59
winter,2012-10-21,20,35,160,195,6824,19:00 - 20:59
winter,2012-10-21,21,42,124,166,6824,21:00 - 22:59
winter,2012-10-21,22,18,95,113,6824,21:00 - 22:59
winter,2012-10-21,23,7,59,66,6824,23:00 - 24:59
winter,2012-10-22,0,3,28,31,7058,
winter,2012-10-22,1,0,11,11,7058,01:00 - 02:59
winter,2012-10-22,2,1,4,5,7058,01:00 - 02:59
winter,2012-10-22,3,1,5,6,7058,03:00 - 04:59
winter,2012-10-22,4,1,6,7,7058,03:00 - 04:59
winter,2012-10-22,5,2,44,46,7058,05:00 - 06:59
winter,2012-10-22,6,4,140,144,7058,05:00 - 06:59
winter,2012-10-22,7,15,437,452,7058,07:00 - 08:59
winter,2012-10-22,8,32,696,728,7058,07:00 - 08:59
winter,2012-10-22,9,25,335,360,7058,09:00 - 10:59
winter,2012-10-22,10,51,161,212,7058,09:00 - 10:59
winter,2012-10-22,11,63,148,211,7058,11:00 - 12:59
winter,2012-10-22,12,52,231,283,7058,11:00 - 12:59
winter,2012-10-22,13,88,227,315,7058,13:00 - 14:59
winter,2012-10-22,14,73,209,282,7058,13:00 - 14:59
winter,2012-10-22,15,74,222,296,7058,15:00 - 16:59
winter,2012-10-22,16,80,444,524,7058,15:00 - 16:59
winter,2012-10-22,17,84,838,922,7058,17:00 - 18:59
winter,2012-10-22,18,60,726,786,7058,17:00 - 18:59
winter,2012-10-22,19,36,478,514,7058,19:00 - 20:59
winter,2012-10-22,20,21,382,403,7058,19:00 - 20:59
winter,2012-10-22,21,19,155,174,7058,21:00 - 22:59
winter,2012-10-22,22,25,158,183,7058,21:00 - 22:59
winter,2012-10-22,23,20,143,163,7058,23:00 - 24:59
winter,2012-10-23,0,5,32,37,7466,
winter,2012-10-23,1,1,16,17,7466,01:00 - 02:59
winter,2012-10-23,2,1,6,7,7466,01:00 - 02:59
winter,2012-10-23,3,0,1,1,7466,03:00 - 04:59
winter,2012-10-23,4,1,6,7,7466,03:00 - 04:59
winter,2012-10-23,5,1,49,50,7466,05:00 - 06:59
winter,2012-10-23,6,6,152,158,7466,05:00 - 06:59
winter,2012-10-23,7,12,519,531,7466,07:00 - 08:59
winter,2012-10-23,8,28,733,761,7466,07:00 - 08:59
winter,2012-10-23,9,29,305,334,7466,09:00 - 10:59
winter,2012-10-23,10,50,171,221,7466,09:00 - 10:59
winter,2012-10-23,11,52,201,253,7466,11:00 - 12:59
winter,2012-10-23,12,80,298,378,7466,11:00 - 12:59
winter,2012-10-23,13,59,244,303,7466,13:00 - 14:59
winter,2012-10-23,14,67,229,296,7466,13:00 - 14:59
winter,2012-10-23,15,76,270,346,7466,15:00 - 16:59
winter,2012-10-23,16,108,433,541,7466,15:00 - 16:59
winter,2012-10-23,17,67,871,938,7466,17:00 - 18:59
winter,2012-10-23,18,64,762,826,7466,17:00 - 18:59
winter,2012-10-23,19,25,457,482,7466,19:00 - 20:59
winter,2012-10-23,20,45,334,379,7466,19:00 - 20:59
winter,2012-10-23,21,35,260,295,7466,21:00 - 22:59
winter,2012-10-23,22,20,174,194,7466,21:00 - 22:59
winter,2012-10-23,23,9,102,111,7466,23:00 - 24:59
winter,2012-10-24,0,7,39,46,7693,
winter,2012-10-24,1,4,23,27,7693,01:00 - 02:59
winter,2012-10-24,2,0,6,6,7693,01:00 - 02:59
winter,2012-10-24,3,0,4,4,7693,03:00 - 04:59
winter,2012-10-24,4,1,5,6,7693,03:00 - 04:59
winter,2012-10-24,5,1,52,53,7693,05:00 - 06:59
winter,2012-10-24,6,11,162,173,7693,05:00 - 06:59
winter,2012-10-24,7,20,506,526,7693,07:00 - 08:59
winter,2012-10-24,8,24,777,801,7693,07:00 - 08:59
winter,2012-10-24,9,24,349,373,7693,09:00 - 10:59
winter,2012-10-24,10,29,142,171,7693,09:00 - 10:59
winter,2012-10-24,11,47,189,236,7693,11:00 - 12:59
winter,2012-10-24,12,48,268,316,7693,11:00 - 12:59
winter,2012-10-24,13,65,241,306,7693,13:00 - 14:59
winter,2012-10-24,14,64,237,301,7693,13:00 - 14:59
winter,2012-10-24,15,63,245,308,7693,15:00 - 16:59
winter,2012-10-24,16,67,465,532,7693,15:00 - 16:59
winter,2012-10-24,17,87,876,963,7693,17:00 - 18:59
winter,2012-10-24,18,63,795,858,7693,17:00 - 18:59
winter,2012-10-24,19,50,522,572,7693,19:00 - 20:59
winter,2012-10-24,20,45,396,441,7693,19:00 - 20:59
winter,2012-10-24,21,33,280,313,7693,21:00 - 22:59
winter,2012-10-24,22,30,208,238,7693,21:00 - 22:59
winter,2012-10-24,23,12,111,123,7693,23:00 - 24:59
winter,2012-10-25,0,19,57,76,7359,
winter,2012-10-25,1,6,22,28,7359,01:00 - 02:59
winter,2012-10-25,2,3,15,18,7359,01:00 - 02:59
winter,2012-10-25,3,0,8,8,7359,03:00 - 04:59
winter,2012-10-25,4,1,4,5,7359,03:00 - 04:59
winter,2012-10-25,5,2,53,55,7359,05:00 - 06:59
winter,2012-10-25,6,3,168,171,7359,05:00 - 06:59
winter,2012-10-25,7,18,477,495,7359,07:00 - 08:59
winter,2012-10-25,8,33,746,779,7359,07:00 - 08:59
winter,2012-10-25,9,23,320,343,7359,09:00 - 10:59
winter,2012-10-25,10,53,172,225,7359,09:00 - 10:59
winter,2012-10-25,11,57,181,238,7359,11:00 - 12:59
winter,2012-10-25,12,61,258,319,7359,11:00 - 12:59
winter,2012-10-25,13,49,264,313,7359,13:00 - 14:59
winter,2012-10-25,14,71,214,285,7359,13:00 - 14:59
winter,2012-10-25,15,63,242,305,7359,15:00 - 16:59
winter,2012-10-25,16,92,407,499,7359,15:00 - 16:59
winter,2012-10-25,17,112,774,886,7359,17:00 - 18:59
winter,2012-10-25,18,77,732,809,7359,17:00 - 18:59
winter,2012-10-25,19,45,497,542,7359,19:00 - 20:59
winter,2012-10-25,20,28,319,347,7359,19:00 - 20:59
winter,2012-10-25,21,24,247,271,7359,21:00 - 22:59
winter,2012-10-25,22,22,185,207,7359,21:00 - 22:59
winter,2012-10-25,23,13,122,135,7359,23:00 - 24:59
winter,2012-10-26,0,6,65,71,7444,
winter,2012-10-26,1,4,32,36,7444,01:00 - 02:59
winter,2012-10-26,2,4,15,19,7444,01:00 - 02:59
winter,2012-10-26,3,5,8,13,7444,03:00 - 04:59
winter,2012-10-26,4,1,4,5,7444,03:00 - 04:59
winter,2012-10-26,5,3,47,50,7444,05:00 - 06:59
winter,2012-10-26,6,2,142,144,7444,05:00 - 06:59
winter,2012-10-26,7,13,408,421,7444,07:00 - 08:59
winter,2012-10-26,8,20,714,734,7444,07:00 - 08:59
winter,2012-10-26,9,56,347,403,7444,09:00 - 10:59
winter,2012-10-26,10,41,156,197,7444,09:00 - 10:59
winter,2012-10-26,11,68,222,290,7444,11:00 - 12:59
winter,2012-10-26,12,90,302,392,7444,11:00 - 12:59
winter,2012-10-26,13,77,260,337,7444,13:00 - 14:59
winter,2012-10-26,14,99,252,351,7444,13:00 - 14:59
winter,2012-10-26,15,142,306,448,7444,15:00 - 16:59
winter,2012-10-26,16,137,445,582,7444,15:00 - 16:59
winter,2012-10-26,17,125,692,817,7444,17:00 - 18:59
winter,2012-10-26,18,81,584,665,7444,17:00 - 18:59
winter,2012-10-26,19,72,399,471,7444,19:00 - 20:59
winter,2012-10-26,20,40,271,311,7444,19:00 - 20:59
winter,2012-10-26,21,40,252,292,7444,21:00 - 22:59
winter,2012-10-26,22,37,180,217,7444,21:00 - 22:59
winter,2012-10-26,23,19,159,178,7444,23:00 - 24:59
winter,2012-10-27,0,10,132,142,7852,
winter,2012-10-27,1,23,123,146,7852,01:00 - 02:59
winter,2012-10-27,2,19,71,90,7852,01:00 - 02:59
winter,2012-10-27,3,5,21,26,7852,03:00 - 04:59
winter,2012-10-27,4,1,12,13,7852,03:00 - 04:59
winter,2012-10-27,5,2,7,9,7852,05:00 - 06:59
winter,2012-10-27,6,2,29,31,7852,05:00 - 06:59
winter,2012-10-27,7,7,79,86,7852,07:00 - 08:59
winter,2012-10-27,8,26,187,213,7852,07:00 - 08:59
winter,2012-10-27,9,88,240,328,7852,09:00 - 10:59
winter,2012-10-27,10,165,314,479,7852,09:00 - 10:59
winter,2012-10-27,11,197,388,585,7852,11:00 - 12:59
winter,2012-10-27,12,264,404,668,7852,11:00 - 12:59
winter,2012-10-27,13,310,450,760,7852,13:00 - 14:59
winter,2012-10-27,14,325,425,750,7852,13:00 - 14:59
winter,2012-10-27,15,310,401,711,7852,15:00 - 16:59
winter,2012-10-27,16,257,355,612,7852,15:00 - 16:59
winter,2012-10-27,17,248,370,618,7852,17:00 - 18:59
winter,2012-10-27,18,138,318,456,7852,17:00 - 18:59
winter,2012-10-27,19,67,233,300,7852,19:00 - 20:59
winter,2012-10-27,20,58,238,296,7852,19:00 - 20:59
winter,2012-10-27,21,49,160,209,7852,21:00 - 22:59
winter,2012-10-27,22,41,116,157,7852,21:00 - 22:59
winter,2012-10-27,23,31,136,167,7852,23:00 - 24:59
winter,2012-10-28,0,20,97,117,4459,
winter,2012-10-28,1,22,111,133,4459,01:00 - 02:59
winter,2012-10-28,2,17,99,116,4459,01:00 - 02:59
winter,2012-10-28,3,18,61,79,4459,03:00 - 04:59
winter,2012-10-28,4,1,19,20,4459,03:00 - 04:59
winter,2012-10-28,5,6,22,28,4459,05:00 - 06:59
winter,2012-10-28,6,7,32,39,4459,05:00 - 06:59
winter,2012-10-28,7,17,48,65,4459,07:00 - 08:59
winter,2012-10-28,8,55,118,173,4459,07:00 - 08:59
winter,2012-10-28,9,124,206,330,4459,09:00 - 10:59
winter,2012-10-28,10,120,314,434,4459,09:00 - 10:59
winter,2012-10-28,11,110,352,462,4459,11:00 - 12:59
winter,2012-10-28,12,118,373,491,4459,11:00 - 12:59
winter,2012-10-28,13,75,316,391,4459,13:00 - 14:59
winter,2012-10-28,14,98,304,402,4459,13:00 - 14:59
winter,2012-10-28,15,76,225,301,4459,15:00 - 16:59
winter,2012-10-28,16,42,251,293,4459,15:00 - 16:59
winter,2012-10-28,17,37,188,225,4459,17:00 - 18:59
winter,2012-10-28,18,18,136,154,4459,17:00 - 18:59
winter,2012-10-28,19,7,47,54,4459,19:00 - 20:59
winter,2012-10-28,20,4,51,55,4459,19:00 - 20:59
winter,2012-10-28,21,2,44,46,4459,21:00 - 22:59
winter,2012-10-28,22,2,35,37,4459,21:00 - 22:59
winter,2012-10-28,23,2,12,14,4459,23:00 - 24:59
winter,2012-10-29,0,2,20,22,22,
winter,2012-10-30,13,11,105,116,1096,13:00 - 14:59
winter,2012-10-30,14,8,118,126,1096,13:00 - 14:59
winter,2012-10-30,15,10,114,124,1096,15:00 - 16:59
winter,2012-10-30,16,15,83,98,1096,15:00 - 16:59
winter,2012-10-30,17,19,105,124,1096,17:00 - 18:59
winter,2012-10-30,18,4,139,143,1096,17:00 - 18:59
winter,2012-10-30,19,6,109,115,1096,19:00 - 20:59
winter,2012-10-30,20,5,76,81,1096,19:00 - 20:59
winter,2012-10-30,21,4,60,64,1096,21:00 - 22:59
winter,2012-10-30,22,2,64,66,1096,21:00 - 22:59
winter,2012-10-30,23,3,36,39,1096,23:00 - 24:59
winter,2012-10-31,0,0,16,16,5566,
winter,2012-10-31,1,0,8,8,5566,01:00 - 02:59
winter,2012-10-31,2,0,7,7,5566,01:00 - 02:59
winter,2012-10-31,3,0,3,3,5566,03:00 - 04:59
winter,2012-10-31,4,0,5,5,5566,03:00 - 04:59
winter,2012-10-31,5,0,24,24,5566,05:00 - 06:59
winter,2012-10-31,6,0,116,116,5566,05:00 - 06:59
winter,2012-10-31,7,3,334,337,5566,07:00 - 08:59
winter,2012-10-31,8,6,615,621,5566,07:00 - 08:59
winter,2012-10-31,9,17,280,297,5566,09:00 - 10:59
winter,2012-10-31,10,21,147,168,5566,09:00 - 10:59
winter,2012-10-31,11,37,152,189,5566,11:00 - 12:59
winter,2012-10-31,12,44,197,241,5566,11:00 - 12:59
winter,2012-10-31,13,22,191,213,5566,13:00 - 14:59
winter,2012-10-31,14,45,179,224,5566,13:00 - 14:59
winter,2012-10-31,15,33,197,230,5566,15:00 - 16:59
winter,2012-10-31,16,51,373,424,5566,15:00 - 16:59
winter,2012-10-31,17,39,684,723,5566,17:00 - 18:59
winter,2012-10-31,18,28,556,584,5566,17:00 - 18:59
winter,2012-10-31,19,27,383,410,5566,19:00 - 20:59
winter,2012-10-31,20,9,259,268,5566,19:00 - 20:59
winter,2012-10-31,21,12,180,192,5566,21:00 - 22:59
winter,2012-10-31,22,18,147,165,5566,21:00 - 22:59
winter,2012-10-31,23,7,94,101,5566,23:00 - 24:59
winter,2012-11-01,0,8,52,60,5986,
winter,2012-11-01,1,8,22,30,5986,01:00 - 02:59
winter,2012-11-01,2,10,10,20,5986,01:00 - 02:59
winter,2012-11-01,3,5,10,15,5986,03:00 - 04:59
winter,2012-11-01,4,2,8,10,5986,03:00 - 04:59
winter,2012-11-01,5,1,39,40,5986,05:00 - 06:59
winter,2012-11-01,6,2,146,148,5986,05:00 - 06:59
winter,2012-11-01,7,6,414,420,5986,07:00 - 08:59
winter,2012-11-01,8,12,668,680,5986,07:00 - 08:59
winter,2012-11-01,9,21,310,331,5986,09:00 - 10:59
winter,2012-11-01,10,13,133,146,5986,09:00 - 10:59
winter,2012-11-01,11,14,156,170,5986,11:00 - 12:59
winter,2012-11-01,12,23,198,221,5986,11:00 - 12:59
winter,2012-11-01,13,49,199,248,5986,13:00 - 14:59
winter,2012-11-01,14,31,154,185,5986,13:00 - 14:59
winter,2012-11-01,15,35,179,214,5986,15:00 - 16:59
winter,2012-11-01,16,31,313,344,5986,15:00 - 16:59
winter,2012-11-01,17,37,652,689,5986,17:00 - 18:59
winter,2012-11-01,18,50,628,678,5986,17:00 - 18:59
winter,2012-11-01,19,28,424,452,5986,19:00 - 20:59
winter,2012-11-01,20,16,280,296,5986,19:00 - 20:59
winter,2012-11-01,21,29,238,267,5986,21:00 - 22:59
winter,2012-11-01,22,27,175,202,5986,21:00 - 22:59
winter,2012-11-01,23,8,112,120,5986,23:00 - 24:59
winter,2012-11-02,0,10,40,50,5847,
winter,2012-11-02,1,5,19,24,5847,01:00 - 02:59
winter,2012-11-02,2,3,7,10,5847,01:00 - 02:59
winter,2012-11-02,3,0,3,3,5847,03:00 - 04:59
winter,2012-11-02,4,1,6,7,5847,03:00 - 04:59
winter,2012-11-02,5,1,25,26,5847,05:00 - 06:59
winter,2012-11-02,6,2,120,122,5847,05:00 - 06:59
winter,2012-11-02,7,8,349,357,5847,07:00 - 08:59
winter,2012-11-02,8,31,656,687,5847,07:00 - 08:59
winter,2012-11-02,9,27,355,382,5847,09:00 - 10:59
winter,2012-11-02,10,21,183,204,5847,09:00 - 10:59
winter,2012-11-02,11,42,179,221,5847,11:00 - 12:59
winter,2012-11-02,12,52,240,292,5847,11:00 - 12:59
winter,2012-11-02,13,64,230,294,5847,13:00 - 14:59
winter,2012-11-02,14,63,199,262,5847,13:00 - 14:59
winter,2012-11-02,15,51,255,306,5847,15:00 - 16:59
winter,2012-11-02,16,48,373,421,5847,15:00 - 16:59
winter,2012-11-02,17,57,581,638,5847,17:00 - 18:59
winter,2012-11-02,18,32,490,522,5847,17:00 - 18:59
winter,2012-11-02,19,38,336,374,5847,19:00 - 20:59
winter,2012-11-02,20,14,207,221,5847,19:00 - 20:59
winter,2012-11-02,21,23,133,156,5847,21:00 - 22:59
winter,2012-11-02,22,14,135,149,5847,21:00 - 22:59
winter,2012-11-02,23,11,108,119,5847,23:00 - 24:59
winter,2012-11-03,0,9,99,108,5138,
winter,2012-11-03,1,6,83,89,5138,01:00 - 02:59
winter,2012-11-03,2,10,36,46,5138,01:00 - 02:59
winter,2012-11-03,3,6,22,28,5138,03:00 - 04:59
winter,2012-11-03,4,8,8,16,5138,03:00 - 04:59
winter,2012-11-03,5,1,8,9,5138,05:00 - 06:59
winter,2012-11-03,6,4,17,21,5138,05:00 - 06:59
winter,2012-11-03,7,1,58,59,5138,07:00 - 08:59
winter,2012-11-03,8,10,132,142,5138,07:00 - 08:59
winter,2012-11-03,9,31,188,219,5138,09:00 - 10:59
winter,2012-11-03,10,68,260,328,5138,09:00 - 10:59
winter,2012-11-03,11,56,284,340,5138,11:00 - 12:59
winter,2012-11-03,12,74,320,394,5138,11:00 - 12:59
winter,2012-11-03,13,110,339,449,5138,13:00 - 14:59
winter,2012-11-03,14,136,319,455,5138,13:00 - 14:59
winter,2012-11-03,15,117,331,448,5138,15:00 - 16:59
winter,2012-11-03,16,108,292,400,5138,15:00 - 16:59
winter,2012-11-03,17,112,298,410,5138,17:00 - 18:59
winter,2012-11-03,18,58,239,297,5138,17:00 - 18:59
winter,2012-11-03,19,22,217,239,5138,19:00 - 20:59
winter,2012-11-03,20,23,158,181,5138,19:00 - 20:59
winter,2012-11-03,21,31,135,166,5138,21:00 - 22:59
winter,2012-11-03,22,13,133,146,5138,21:00 - 22:59
winter,2012-11-03,23,15,133,148,5138,23:00 - 24:59
winter,2012-11-04,0,5,97,102,5107,
winter,2012-11-04,1,26,139,165,5107,01:00 - 02:59
winter,2012-11-04,2,6,31,37,5107,01:00 - 02:59
winter,2012-11-04,3,1,10,11,5107,03:00 - 04:59
winter,2012-11-04,4,2,7,9,5107,03:00 - 04:59
winter,2012-11-04,5,0,5,5,5107,05:00 - 06:59
winter,2012-11-04,6,2,14,16,5107,05:00 - 06:59
winter,2012-11-04,7,11,39,50,5107,07:00 - 08:59
winter,2012-11-04,8,34,115,149,5107,07:00 - 08:59
winter,2012-11-04,9,56,161,217,5107,09:00 - 10:59
winter,2012-11-04,10,73,287,360,5107,09:00 - 10:59
winter,2012-11-04,11,134,311,445,5107,11:00 - 12:59
winter,2012-11-04,12,150,354,504,5107,11:00 - 12:59
winter,2012-11-04,13,122,371,493,5107,13:00 - 14:59
winter,2012-11-04,14,149,360,509,5107,13:00 - 14:59
winter,2012-11-04,15,149,300,449,5107,15:00 - 16:59
winter,2012-11-04,16,119,316,435,5107,15:00 - 16:59
winter,2012-11-04,17,57,270,327,5107,17:00 - 18:59
winter,2012-11-04,18,31,206,237,5107,17:00 - 18:59
winter,2012-11-04,19,24,203,227,5107,19:00 - 20:59
winter,2012-11-04,20,7,134,141,5107,19:00 - 20:59
winter,2012-11-04,21,16,71,87,5107,21:00 - 22:59
winter,2012-11-04,22,15,64,79,5107,21:00 - 22:59
winter,2012-11-04,23,12,41,53,5107,23:00 - 24:59
winter,2012-11-05,0,3,20,23,5259,
winter,2012-11-05,1,0,8,8,5259,01:00 - 02:59
winter,2012-11-05,2,2,4,6,5259,01:00 - 02:59
winter,2012-11-05,3,1,3,4,5259,03:00 - 04:59
winter,2012-11-05,4,5,11,16,5259,03:00 - 04:59
winter,2012-11-05,5,1,38,39,5259,05:00 - 06:59
winter,2012-11-05,6,4,135,139,5259,05:00 - 06:59
winter,2012-11-05,7,8,453,461,5259,07:00 - 08:59
winter,2012-11-05,8,19,629,648,5259,07:00 - 08:59
winter,2012-11-05,9,18,239,257,5259,09:00 - 10:59
winter,2012-11-05,10,30,112,142,5259,09:00 - 10:59
winter,2012-11-05,11,31,119,150,5259,11:00 - 12:59
winter,2012-11-05,12,38,206,244,5259,11:00 - 12:59
winter,2012-11-05,13,39,183,222,5259,13:00 - 14:59
winter,2012-11-05,14,31,165,196,5259,13:00 - 14:59
winter,2012-11-05,15,24,207,231,5259,15:00 - 16:59
winter,2012-11-05,16,35,325,360,5259,15:00 - 16:59
winter,2012-11-05,17,34,604,638,5259,17:00 - 18:59
winter,2012-11-05,18,19,523,542,5259,17:00 - 18:59
winter,2012-11-05,19,11,361,372,5259,19:00 - 20:59
winter,2012-11-05,20,13,228,241,5259,19:00 - 20:59
winter,2012-11-05,21,8,144,152,5259,21:00 - 22:59
winter,2012-11-05,22,4,111,115,5259,21:00 - 22:59
winter,2012-11-05,23,0,53,53,5259,23:00 - 24:59
winter,2012-11-06,0,1,18,19,5686,
winter,2012-11-06,1,0,8,8,5686,01:00 - 02:59
winter,2012-11-06,2,0,2,2,5686,01:00 - 02:59
winter,2012-11-06,3,0,4,4,5686,03:00 - 04:59
winter,2012-11-06,4,0,7,7,5686,03:00 - 04:59
winter,2012-11-06,5,1,40,41,5686,05:00 - 06:59
winter,2012-11-06,6,6,143,149,5686,05:00 - 06:59
winter,2012-11-06,7,9,378,387,5686,07:00 - 08:59
winter,2012-11-06,8,20,568,588,5686,07:00 - 08:59
winter,2012-11-06,9,25,338,363,5686,09:00 - 10:59
winter,2012-11-06,10,41,189,230,5686,09:00 - 10:59
winter,2012-11-06,11,39,177,216,5686,11:00 - 12:59
winter,2012-11-06,12,31,217,248,5686,11:00 - 12:59
winter,2012-11-06,13,46,232,278,5686,13:00 - 14:59
winter,2012-11-06,14,44,196,240,5686,13:00 - 14:59
winter,2012-11-06,15,45,227,272,5686,15:00 - 16:59
winter,2012-11-06,16,33,369,402,5686,15:00 - 16:59
winter,2012-11-06,17,30,597,627,5686,17:00 - 18:59
winter,2012-11-06,18,20,477,497,5686,17:00 - 18:59
winter,2012-11-06,19,15,356,371,5686,19:00 - 20:59
winter,2012-11-06,20,10,218,228,5686,19:00 - 20:59
winter,2012-11-06,21,14,137,151,5686,21:00 - 22:59
winter,2012-11-06,22,17,136,153,5686,21:00 - 22:59
winter,2012-11-06,23,19,186,205,5686,23:00 - 24:59
winter,2012-11-07,0,49,234,283,5035,
winter,2012-11-07,1,6,86,92,5035,01:00 - 02:59
winter,2012-11-07,2,6,68,74,5035,01:00 - 02:59
winter,2012-11-07,3,2,9,11,5035,03:00 - 04:59
winter,2012-11-07,4,0,9,9,5035,03:00 - 04:59
winter,2012-11-07,5,0,27,27,5035,05:00 - 06:59
winter,2012-11-07,6,3,115,118,5035,05:00 - 06:59
winter,2012-11-07,7,5,314,319,5035,07:00 - 08:59
winter,2012-11-07,8,18,583,601,5035,07:00 - 08:59
winter,2012-11-07,9,17,351,368,5035,09:00 - 10:59
winter,2012-11-07,10,27,151,178,5035,09:00 - 10:59
winter,2012-11-07,11,15,132,147,5035,11:00 - 12:59
winter,2012-11-07,12,24,188,212,5035,11:00 - 12:59
winter,2012-11-07,13,23,158,181,5035,13:00 - 14:59
winter,2012-11-07,14,19,142,161,5035,13:00 - 14:59
winter,2012-11-07,15,20,178,198,5035,15:00 - 16:59
winter,2012-11-07,16,23,250,273,5035,15:00 - 16:59
winter,2012-11-07,17,16,501,517,5035,17:00 - 18:59
winter,2012-11-07,18,17,448,465,5035,17:00 - 18:59
winter,2012-11-07,19,17,302,319,5035,19:00 - 20:59
winter,2012-11-07,20,7,249,256,5035,19:00 - 20:59
winter,2012-11-07,21,5,121,126,5035,21:00 - 22:59
winter,2012-11-07,22,4,56,60,5035,21:00 - 22:59
winter,2012-11-07,23,3,37,40,5035,23:00 - 24:59
winter,2012-11-08,0,1,14,15,5315,
winter,2012-11-08,1,1,11,12,5315,01:00 - 02:59
winter,2012-11-08,2,1,5,6,5315,01:00 - 02:59
winter,2012-11-08,4,1,9,10,5315,03:00 - 04:59
winter,2012-11-08,5,0,35,35,5315,05:00 - 06:59
winter,2012-11-08,6,2,122,124,5315,05:00 - 06:59
winter,2012-11-08,7,12,411,423,5315,07:00 - 08:59
winter,2012-11-08,8,16,652,668,5315,07:00 - 08:59
winter,2012-11-08,9,22,253,275,5315,09:00 - 10:59
winter,2012-11-08,10,13,148,161,5315,09:00 - 10:59
winter,2012-11-08,11,16,155,171,5315,11:00 - 12:59
winter,2012-11-08,12,33,202,235,5315,11:00 - 12:59
winter,2012-11-08,13,33,195,228,5315,13:00 - 14:59
winter,2012-11-08,14,33,149,182,5315,13:00 - 14:59
winter,2012-11-08,15,32,201,233,5315,15:00 - 16:59
winter,2012-11-08,16,18,321,339,5315,15:00 - 16:59
winter,2012-11-08,17,36,556,592,5315,17:00 - 18:59
winter,2012-11-08,18,16,491,507,5315,17:00 - 18:59
winter,2012-11-08,19,14,359,373,5315,19:00 - 20:59
winter,2012-11-08,20,10,235,245,5315,19:00 - 20:59
winter,2012-11-08,21,11,222,233,5315,21:00 - 22:59
winter,2012-11-08,22,14,147,161,5315,21:00 - 22:59
winter,2012-11-08,23,5,82,87,5315,23:00 - 24:59
winter,2012-11-09,0,9,46,55,5992,
winter,2012-11-09,1,3,17,20,5992,01:00 - 02:59
winter,2012-11-09,2,1,11,12,5992,01:00 - 02:59
winter,2012-11-09,3,3,6,9,5992,03:00 - 04:59
winter,2012-11-09,4,0,14,14,5992,03:00 - 04:59
winter,2012-11-09,5,2,25,27,5992,05:00 - 06:59
winter,2012-11-09,6,5,126,131,5992,05:00 - 06:59
winter,2012-11-09,7,9,332,341,5992,07:00 - 08:59
winter,2012-11-09,8,25,668,693,5992,07:00 - 08:59
winter,2012-11-09,9,23,304,327,5992,09:00 - 10:59
winter,2012-11-09,10,34,163,197,5992,09:00 - 10:59
winter,2012-11-09,11,66,185,251,5992,11:00 - 12:59
winter,2012-11-09,12,48,214,262,5992,11:00 - 12:59
winter,2012-11-09,13,62,237,299,5992,13:00 - 14:59
winter,2012-11-09,14,67,207,274,5992,13:00 - 14:59
winter,2012-11-09,15,78,278,356,5992,15:00 - 16:59
winter,2012-11-09,16,57,377,434,5992,15:00 - 16:59
winter,2012-11-09,17,61,593,654,5992,17:00 - 18:59
winter,2012-11-09,18,46,450,496,5992,17:00 - 18:59
winter,2012-11-09,19,30,331,361,5992,19:00 - 20:59
winter,2012-11-09,20,20,235,255,5992,19:00 - 20:59
winter,2012-11-09,21,23,176,199,5992,21:00 - 22:59
winter,2012-11-09,22,17,146,163,5992,21:00 - 22:59
winter,2012-11-09,23,20,142,162,5992,23:00 - 24:59
winter,2012-11-10,0,16,106,122,6536,
winter,2012-11-10,1,8,68,76,6536,01:00 - 02:59
winter,2012-11-10,2,2,42,44,6536,01:00 - 02:59
winter,2012-11-10,3,9,11,20,6536,03:00 - 04:59
winter,2012-11-10,4,2,4,6,6536,03:00 - 04:59
winter,2012-11-10,5,1,9,10,6536,05:00 - 06:59
winter,2012-11-10,6,5,11,16,6536,05:00 - 06:59
winter,2012-11-10,7,14,57,71,6536,07:00 - 08:59
winter,2012-11-10,8,16,130,146,6536,07:00 - 08:59
winter,2012-11-10,9,43,216,259,6536,09:00 - 10:59
winter,2012-11-10,10,86,264,350,6536,09:00 - 10:59
winter,2012-11-10,11,143,323,466,6536,11:00 - 12:59
winter,2012-11-10,12,258,348,606,6536,11:00 - 12:59
winter,2012-11-10,13,268,383,651,6536,13:00 - 14:59
winter,2012-11-10,14,280,347,627,6536,13:00 - 14:59
winter,2012-11-10,15,216,351,567,6536,15:00 - 16:59
winter,2012-11-10,16,227,378,605,6536,15:00 - 16:59
winter,2012-11-10,17,183,318,501,6536,17:00 - 18:59
winter,2012-11-10,18,103,256,359,6536,17:00 - 18:59
winter,2012-11-10,19,55,228,283,6536,19:00 - 20:59
winter,2012-11-10,20,39,153,192,6536,19:00 - 20:59
winter,2012-11-10,21,51,169,220,6536,21:00 - 22:59
winter,2012-11-10,22,39,154,193,6536,21:00 - 22:59
winter,2012-11-10,23,26,120,146,6536,23:00 - 24:59
winter,2012-11-11,0,14,110,124,6852,
winter,2012-11-11,1,26,82,108,6852,01:00 - 02:59
winter,2012-11-11,2,12,58,70,6852,01:00 - 02:59
winter,2012-11-11,3,9,39,48,6852,03:00 - 04:59
winter,2012-11-11,4,5,6,11,6852,03:00 - 04:59
winter,2012-11-11,5,0,12,12,6852,05:00 - 06:59
winter,2012-11-11,6,3,16,19,6852,05:00 - 06:59
winter,2012-11-11,7,12,56,68,6852,07:00 - 08:59
winter,2012-11-11,8,32,87,119,6852,07:00 - 08:59
winter,2012-11-11,9,94,179,273,6852,09:00 - 10:59
winter,2012-11-11,10,133,272,405,6852,09:00 - 10:59
winter,2012-11-11,11,180,324,504,6852,11:00 - 12:59
winter,2012-11-11,12,195,390,585,6852,11:00 - 12:59
winter,2012-11-11,13,262,424,686,6852,13:00 - 14:59
winter,2012-11-11,14,292,362,654,6852,13:00 - 14:59
winter,2012-11-11,15,304,420,724,6852,15:00 - 16:59
winter,2012-11-11,16,260,393,653,6852,15:00 - 16:59
winter,2012-11-11,17,151,342,493,6852,17:00 - 18:59
winter,2012-11-11,18,102,303,405,6852,17:00 - 18:59
winter,2012-11-11,19,69,208,277,6852,19:00 - 20:59
winter,2012-11-11,20,54,146,200,6852,19:00 - 20:59
winter,2012-11-11,21,44,127,171,6852,21:00 - 22:59
winter,2012-11-11,22,21,113,134,6852,21:00 - 22:59
winter,2012-11-11,23,16,93,109,6852,23:00 - 24:59
winter,2012-11-12,0,6,43,49,6269,
winter,2012-11-12,1,4,26,30,6269,01:00 - 02:59
winter,2012-11-12,2,6,14,20,6269,01:00 - 02:59
winter,2012-11-12,3,1,3,4,6269,03:00 - 04:59
winter,2012-11-12,4,1,3,4,6269,03:00 - 04:59
winter,2012-11-12,5,1,23,24,6269,05:00 - 06:59
winter,2012-11-12,6,7,64,71,6269,05:00 - 06:59
winter,2012-11-12,7,16,248,264,6269,07:00 - 08:59
winter,2012-11-12,8,50,490,540,6269,07:00 - 08:59
winter,2012-11-12,9,60,337,397,6269,09:00 - 10:59
winter,2012-11-12,10,82,184,266,6269,09:00 - 10:59
winter,2012-11-12,11,112,255,367,6269,11:00 - 12:59
winter,2012-11-12,12,105,314,419,6269,11:00 - 12:59
winter,2012-11-12,13,108,312,420,6269,13:00 - 14:59
winter,2012-11-12,14,134,310,444,6269,13:00 - 14:59
winter,2012-11-12,15,102,280,382,6269,15:00 - 16:59
winter,2012-11-12,16,87,347,434,6269,15:00 - 16:59
winter,2012-11-12,17,66,530,596,6269,17:00 - 18:59
winter,2012-11-12,18,65,486,551,6269,17:00 - 18:59
winter,2012-11-12,19,30,323,353,6269,19:00 - 20:59
winter,2012-11-12,20,31,273,304,6269,19:00 - 20:59
winter,2012-11-12,21,10,145,155,6269,21:00 - 22:59
winter,2012-11-12,22,12,100,112,6269,21:00 - 22:59
winter,2012-11-12,23,1,62,63,6269,23:00 - 24:59
winter,2012-11-13,0,5,18,23,4094,
winter,2012-11-13,1,0,5,5,4094,01:00 - 02:59
winter,2012-11-13,2,7,4,11,4094,01:00 - 02:59
winter,2012-11-13,3,2,3,5,4094,03:00 - 04:59
winter,2012-11-13,4,0,9,9,4094,03:00 - 04:59
winter,2012-11-13,5,0,18,18,4094,05:00 - 06:59
winter,2012-11-13,6,2,48,50,4094,05:00 - 06:59
winter,2012-11-13,7,1,106,107,4094,07:00 - 08:59
winter,2012-11-13,8,4,207,211,4094,07:00 - 08:59
winter,2012-11-13,9,1,109,110,4094,09:00 - 10:59
winter,2012-11-13,10,10,84,94,4094,09:00 - 10:59
winter,2012-11-13,11,22,133,155,4094,11:00 - 12:59
winter,2012-11-13,12,16,180,196,4094,11:00 - 12:59
winter,2012-11-13,13,30,188,218,4094,13:00 - 14:59
winter,2012-11-13,14,34,169,203,4094,13:00 - 14:59
winter,2012-11-13,15,33,184,217,4094,15:00 - 16:59
winter,2012-11-13,16,28,282,310,4094,15:00 - 16:59
winter,2012-11-13,17,33,575,608,4094,17:00 - 18:59
winter,2012-11-13,18,45,514,559,4094,17:00 - 18:59
winter,2012-11-13,19,12,344,356,4094,19:00 - 20:59
winter,2012-11-13,20,12,211,223,4094,19:00 - 20:59
winter,2012-11-13,21,9,178,187,4094,21:00 - 22:59
winter,2012-11-13,22,15,120,135,4094,21:00 - 22:59
winter,2012-11-13,23,6,78,84,4094,23:00 - 24:59
winter,2012-11-14,0,4,20,24,5495,
winter,2012-11-14,1,2,10,12,5495,01:00 - 02:59
winter,2012-11-14,2,0,1,1,5495,01:00 - 02:59
winter,2012-11-14,3,0,5,5,5495,03:00 - 04:59
winter,2012-11-14,4,0,6,6,5495,03:00 - 04:59
winter,2012-11-14,5,0,39,39,5495,05:00 - 06:59
winter,2012-11-14,6,4,142,146,5495,05:00 - 06:59
winter,2012-11-14,7,10,405,415,5495,07:00 - 08:59
winter,2012-11-14,8,27,664,691,5495,07:00 - 08:59
winter,2012-11-14,9,22,310,332,5495,09:00 - 10:59
winter,2012-11-14,10,18,153,171,5495,09:00 - 10:59
winter,2012-11-14,11,25,126,151,5495,11:00 - 12:59
winter,2012-11-14,12,40,200,240,5495,11:00 - 12:59
winter,2012-11-14,13,32,182,214,5495,13:00 - 14:59
winter,2012-11-14,14,20,161,181,5495,13:00 - 14:59
winter,2012-11-14,15,32,228,260,5495,15:00 - 16:59
winter,2012-11-14,16,31,290,321,5495,15:00 - 16:59
winter,2012-11-14,17,19,564,583,5495,17:00 - 18:59
winter,2012-11-14,18,24,543,567,5495,17:00 - 18:59
winter,2012-11-14,19,28,368,396,5495,19:00 - 20:59
winter,2012-11-14,20,15,252,267,5495,19:00 - 20:59
winter,2012-11-14,21,5,208,213,5495,21:00 - 22:59
winter,2012-11-14,22,6,167,173,5495,21:00 - 22:59
winter,2012-11-14,23,9,78,87,5495,23:00 - 24:59
winter,2012-11-15,0,1,33,34,5445,
winter,2012-11-15,1,2,14,16,5445,01:00 - 02:59
winter,2012-11-15,2,0,7,7,5445,01:00 - 02:59
winter,2012-11-15,3,0,2,2,5445,03:00 - 04:59
winter,2012-11-15,4,0,5,5,5445,03:00 - 04:59
winter,2012-11-15,5,3,34,37,5445,05:00 - 06:59
winter,2012-11-15,6,1,146,147,5445,05:00 - 06:59
winter,2012-11-15,7,7,403,410,5445,07:00 - 08:59
winter,2012-11-15,8,21,625,646,5445,07:00 - 08:59
winter,2012-11-15,9,17,306,323,5445,09:00 - 10:59
winter,2012-11-15,10,11,142,153,5445,09:00 - 10:59
winter,2012-11-15,11,28,138,166,5445,11:00 - 12:59
winter,2012-11-15,12,29,184,213,5445,11:00 - 12:59
winter,2012-11-15,13,20,197,217,5445,13:00 - 14:59
winter,2012-11-15,14,27,174,201,5445,13:00 - 14:59
winter,2012-11-15,15,26,191,217,5445,15:00 - 16:59
winter,2012-11-15,16,24,318,342,5445,15:00 - 16:59
winter,2012-11-15,17,22,541,563,5445,17:00 - 18:59
winter,2012-11-15,18,10,563,573,5445,17:00 - 18:59
winter,2012-11-15,19,11,375,386,5445,19:00 - 20:59
winter,2012-11-15,20,23,262,285,5445,19:00 - 20:59
winter,2012-11-15,21,20,204,224,5445,21:00 - 22:59
winter,2012-11-15,22,10,143,153,5445,21:00 - 22:59
winter,2012-11-15,23,7,118,125,5445,23:00 - 24:59
winter,2012-11-16,0,7,58,65,5698,
winter,2012-11-16,1,5,16,21,5698,01:00 - 02:59
winter,2012-11-16,2,0,9,9,5698,01:00 - 02:59
winter,2012-11-16,3,0,6,6,5698,03:00 - 04:59
winter,2012-11-16,4,0,5,5,5698,03:00 - 04:59
winter,2012-11-16,5,2,34,36,5698,05:00 - 06:59
winter,2012-11-16,6,4,126,130,5698,05:00 - 06:59
winter,2012-11-16,7,5,362,367,5698,07:00 - 08:59
winter,2012-11-16,8,17,694,711,5698,07:00 - 08:59
winter,2012-11-16,9,21,330,351,5698,09:00 - 10:59
winter,2012-11-16,10,33,165,198,5698,09:00 - 10:59
winter,2012-11-16,11,33,185,218,5698,11:00 - 12:59
winter,2012-11-16,12,28,262,290,5698,11:00 - 12:59
winter,2012-11-16,13,52,226,278,5698,13:00 - 14:59
winter,2012-11-16,14,47,204,251,5698,13:00 - 14:59
winter,2012-11-16,15,30,237,267,5698,15:00 - 16:59
winter,2012-11-16,16,33,350,383,5698,15:00 - 16:59
winter,2012-11-16,17,41,539,580,5698,17:00 - 18:59
winter,2012-11-16,18,22,483,505,5698,17:00 - 18:59
winter,2012-11-16,19,26,306,332,5698,19:00 - 20:59
winter,2012-11-16,20,20,207,227,5698,19:00 - 20:59
winter,2012-11-16,21,21,157,178,5698,21:00 - 22:59
winter,2012-11-16,22,23,139,162,5698,21:00 - 22:59
winter,2012-11-16,23,14,114,128,5698,23:00 - 24:59
winter,2012-11-17,0,11,95,106,5629,
winter,2012-11-17,1,13,74,87,5629,01:00 - 02:59
winter,2012-11-17,2,8,41,49,5629,01:00 - 02:59
winter,2012-11-17,3,2,19,21,5629,03:00 - 04:59
winter,2012-11-17,4,1,6,7,5629,03:00 - 04:59
winter,2012-11-17,5,1,10,11,5629,05:00 - 06:59
winter,2012-11-17,6,0,21,21,5629,05:00 - 06:59
winter,2012-11-17,7,8,70,78,5629,07:00 - 08:59
winter,2012-11-17,8,30,138,168,5629,07:00 - 08:59
winter,2012-11-17,9,48,200,248,5629,09:00 - 10:59
winter,2012-11-17,10,62,258,320,5629,09:00 - 10:59
winter,2012-11-17,11,80,343,423,5629,11:00 - 12:59
winter,2012-11-17,12,117,359,476,5629,11:00 - 12:59
winter,2012-11-17,13,179,346,525,5629,13:00 - 14:59
winter,2012-11-17,14,175,380,555,5629,13:00 - 14:59
winter,2012-11-17,15,175,374,549,5629,15:00 - 16:59
winter,2012-11-17,16,144,325,469,5629,15:00 - 16:59
winter,2012-11-17,17,101,302,403,5629,17:00 - 18:59
winter,2012-11-17,18,34,237,271,5629,17:00 - 18:59
winter,2012-11-17,19,45,208,253,5629,19:00 - 20:59
winter,2012-11-17,20,30,142,172,5629,19:00 - 20:59
winter,2012-11-17,21,15,124,139,5629,21:00 - 22:59
winter,2012-11-17,22,15,130,145,5629,21:00 - 22:59
winter,2012-11-17,23,19,114,133,5629,23:00 - 24:59
winter,2012-11-18,0,11,118,129,4669,
winter,2012-11-18,1,14,81,95,4669,01:00 - 02:59
winter,2012-11-18,2,8,65,73,4669,01:00 - 02:59
winter,2012-11-18,3,9,37,46,4669,03:00 - 04:59
winter,2012-11-18,4,4,8,12,4669,03:00 - 04:59
winter,2012-11-18,5,5,7,12,4669,05:00 - 06:59
winter,2012-11-18,6,2,13,15,4669,05:00 - 06:59
winter,2012-11-18,7,3,39,42,4669,07:00 - 08:59
winter,2012-11-18,8,19,100,119,4669,07:00 - 08:59
winter,2012-11-18,9,49,155,204,4669,09:00 - 10:59
winter,2012-11-18,10,79,250,329,4669,09:00 - 10:59
winter,2012-11-18,11,92,267,359,4669,11:00 - 12:59
winter,2012-11-18,12,101,341,442,4669,11:00 - 12:59
winter,2012-11-18,13,113,334,447,4669,13:00 - 14:59
winter,2012-11-18,14,125,303,428,4669,13:00 - 14:59
winter,2012-11-18,15,89,318,407,4669,15:00 - 16:59
winter,2012-11-18,16,59,313,372,4669,15:00 - 16:59
winter,2012-11-18,17,48,232,280,4669,17:00 - 18:59
winter,2012-11-18,18,36,240,276,4669,17:00 - 18:59
winter,2012-11-18,19,16,194,210,4669,19:00 - 20:59
winter,2012-11-18,20,9,120,129,4669,19:00 - 20:59
winter,2012-11-18,21,17,93,110,4669,21:00 - 22:59
winter,2012-11-18,22,8,66,74,4669,21:00 - 22:59
winter,2012-11-18,23,6,53,59,4669,23:00 - 24:59
winter,2012-11-19,0,5,22,27,5499,
winter,2012-11-19,1,0,19,19,5499,01:00 - 02:59
winter,2012-11-19,2,0,5,5,5499,01:00 - 02:59
winter,2012-11-19,3,0,2,2,5499,03:00 - 04:59
winter,2012-11-19,4,1,11,12,5499,03:00 - 04:59
winter,2012-11-19,5,1,38,39,5499,05:00 - 06:59
winter,2012-11-19,6,3,128,131,5499,05:00 - 06:59
winter,2012-11-19,7,5,381,386,5499,07:00 - 08:59
winter,2012-11-19,8,13,650,663,5499,07:00 - 08:59
winter,2012-11-19,9,18,260,278,5499,09:00 - 10:59
winter,2012-11-19,10,33,106,139,5499,09:00 - 10:59
winter,2012-11-19,11,33,164,197,5499,11:00 - 12:59
winter,2012-11-19,12,35,207,242,5499,11:00 - 12:59
winter,2012-11-19,13,46,205,251,5499,13:00 - 14:59
winter,2012-11-19,14,47,170,217,5499,13:00 - 14:59
winter,2012-11-19,15,44,213,257,5499,15:00 - 16:59
winter,2012-11-19,16,55,325,380,5499,15:00 - 16:59
winter,2012-11-19,17,33,586,619,5499,17:00 - 18:59
winter,2012-11-19,18,21,559,580,5499,17:00 - 18:59
winter,2012-11-19,19,25,381,406,5499,19:00 - 20:59
winter,2012-11-19,20,7,252,259,5499,19:00 - 20:59
winter,2012-11-19,21,15,188,203,5499,21:00 - 22:59
winter,2012-11-19,22,7,106,113,5499,21:00 - 22:59
winter,2012-11-19,23,2,72,74,5499,23:00 - 24:59
winter,2012-11-20,0,3,26,29,5634,
winter,2012-11-20,1,3,10,13,5634,01:00 - 02:59
winter,2012-11-20,2,0,5,5,5634,01:00 - 02:59
winter,2012-11-20,3,0,2,2,5634,03:00 - 04:59
winter,2012-11-20,4,0,6,6,5634,03:00 - 04:59
winter,2012-11-20,5,2,32,34,5634,05:00 - 06:59
winter,2012-11-20,6,2,146,148,5634,05:00 - 06:59
winter,2012-11-20,7,7,411,418,5634,07:00 - 08:59
winter,2012-11-20,8,16,649,665,5634,07:00 - 08:59
winter,2012-11-20,9,28,298,326,5634,09:00 - 10:59
winter,2012-11-20,10,32,144,176,5634,09:00 - 10:59
winter,2012-11-20,11,45,160,205,5634,11:00 - 12:59
winter,2012-11-20,12,70,243,313,5634,11:00 - 12:59
winter,2012-11-20,13,49,218,267,5634,13:00 - 14:59
winter,2012-11-20,14,47,177,224,5634,13:00 - 14:59
winter,2012-11-20,15,61,226,287,5634,15:00 - 16:59
winter,2012-11-20,16,60,335,395,5634,15:00 - 16:59
winter,2012-11-20,17,37,553,590,5634,17:00 - 18:59
winter,2012-11-20,18,16,534,550,5634,17:00 - 18:59
winter,2012-11-20,19,23,361,384,5634,19:00 - 20:59
winter,2012-11-20,20,11,224,235,5634,19:00 - 20:59
winter,2012-11-20,21,14,143,157,5634,21:00 - 22:59
winter,2012-11-20,22,7,115,122,5634,21:00 - 22:59
winter,2012-11-20,23,1,82,83,5634,23:00 - 24:59
winter,2012-11-21,0,1,25,26,5146,
winter,2012-11-21,1,1,13,14,5146,01:00 - 02:59
winter,2012-11-21,2,2,6,8,5146,01:00 - 02:59
winter,2012-11-21,3,0,2,2,5146,03:00 - 04:59
winter,2012-11-21,4,0,10,10,5146,03:00 - 04:59
winter,2012-11-21,5,1,28,29,5146,05:00 - 06:59
winter,2012-11-21,6,2,99,101,5146,05:00 - 06:59
winter,2012-11-21,7,11,262,273,5146,07:00 - 08:59
winter,2012-11-21,8,12,539,551,5146,07:00 - 08:59
winter,2012-11-21,9,45,320,365,5146,09:00 - 10:59
winter,2012-11-21,10,22,150,172,5146,09:00 - 10:59
winter,2012-11-21,11,43,198,241,5146,11:00 - 12:59
winter,2012-11-21,12,74,270,344,5146,11:00 - 12:59
winter,2012-11-21,13,70,295,365,5146,13:00 - 14:59
winter,2012-11-21,14,84,329,413,5146,13:00 - 14:59
winter,2012-11-21,15,68,381,449,5146,15:00 - 16:59
winter,2012-11-21,16,59,410,469,5146,15:00 - 16:59
winter,2012-11-21,17,41,333,374,5146,17:00 - 18:59
winter,2012-11-21,18,24,287,311,5146,17:00 - 18:59
winter,2012-11-21,19,23,220,243,5146,19:00 - 20:59
winter,2012-11-21,20,11,125,136,5146,19:00 - 20:59
winter,2012-11-21,21,8,97,105,5146,21:00 - 22:59
winter,2012-11-21,22,6,82,88,5146,21:00 - 22:59
winter,2012-11-21,23,7,50,57,5146,23:00 - 24:59
winter,2012-11-22,0,3,43,46,2425,
winter,2012-11-22,1,5,37,42,2425,01:00 - 02:59
winter,2012-11-22,2,3,15,18,2425,01:00 - 02:59
winter,2012-11-22,3,0,6,6,2425,03:00 - 04:59
winter,2012-11-22,4,1,2,3,2425,03:00 - 04:59
winter,2012-11-22,5,2,6,8,2425,05:00 - 06:59
winter,2012-11-22,6,2,15,17,2425,05:00 - 06:59
winter,2012-11-22,7,7,49,56,2425,07:00 - 08:59
winter,2012-11-22,8,20,77,97,2425,07:00 - 08:59
winter,2012-11-22,9,25,94,119,2425,09:00 - 10:59
winter,2012-11-22,10,65,154,219,2425,09:00 - 10:59
winter,2012-11-22,11,89,143,232,2425,11:00 - 12:59
winter,2012-11-22,12,117,145,262,2425,11:00 - 12:59
winter,2012-11-22,13,125,144,269,2425,13:00 - 14:59
winter,2012-11-22,14,125,95,220,2425,13:00 - 14:59
winter,2012-11-22,15,132,96,228,2425,15:00 - 16:59
winter,2012-11-22,16,101,81,182,2425,15:00 - 16:59
winter,2012-11-22,17,66,43,109,2425,17:00 - 18:59
winter,2012-11-22,18,16,54,70,2425,17:00 - 18:59
winter,2012-11-22,19,13,31,44,2425,19:00 - 20:59
winter,2012-11-22,20,15,37,52,2425,19:00 - 20:59
winter,2012-11-22,21,7,39,46,2425,21:00 - 22:59
winter,2012-11-22,22,8,36,44,2425,21:00 - 22:59
winter,2012-11-22,23,8,28,36,2425,23:00 - 24:59
winter,2012-11-23,0,0,32,32,3910,
winter,2012-11-23,1,2,11,13,3910,01:00 - 02:59
winter,2012-11-23,2,1,4,5,3910,01:00 - 02:59
winter,2012-11-23,3,1,0,1,3910,03:00 - 04:59
winter,2012-11-23,4,1,3,4,3910,03:00 - 04:59
winter,2012-11-23,5,0,10,10,3910,05:00 - 06:59
winter,2012-11-23,6,0,20,20,3910,05:00 - 06:59
winter,2012-11-23,7,5,72,77,3910,07:00 - 08:59
winter,2012-11-23,8,11,83,94,3910,07:00 - 08:59
winter,2012-11-23,9,32,80,112,3910,09:00 - 10:59
winter,2012-11-23,10,87,114,201,3910,09:00 - 10:59
winter,2012-11-23,11,121,130,251,3910,11:00 - 12:59
winter,2012-11-23,12,186,193,379,3910,11:00 - 12:59
winter,2012-11-23,13,224,200,424,3910,13:00 - 14:59
winter,2012-11-23,14,240,195,435,3910,13:00 - 14:59
winter,2012-11-23,15,233,214,447,3910,15:00 - 16:59
winter,2012-11-23,16,158,199,357,3910,15:00 - 16:59
winter,2012-11-23,17,117,183,300,3910,17:00 - 18:59
winter,2012-11-23,18,50,158,208,3910,17:00 - 18:59
winter,2012-11-23,19,33,121,154,3910,19:00 - 20:59
winter,2012-11-23,20,42,100,142,3910,19:00 - 20:59
winter,2012-11-23,21,23,75,98,3910,21:00 - 22:59
winter,2012-11-23,22,16,63,79,3910,21:00 - 22:59
winter,2012-11-23,23,20,47,67,3910,23:00 - 24:59
winter,2012-11-24,0,9,33,42,2277,
winter,2012-11-24,1,1,19,20,2277,01:00 - 02:59
winter,2012-11-24,2,10,22,32,2277,01:00 - 02:59
winter,2012-11-24,3,6,5,11,2277,03:00 - 04:59
winter,2012-11-24,4,1,2,3,2277,03:00 - 04:59
winter,2012-11-24,5,1,2,3,2277,05:00 - 06:59
winter,2012-11-24,6,1,9,10,2277,05:00 - 06:59
winter,2012-11-24,7,4,21,25,2277,07:00 - 08:59
winter,2012-11-24,8,7,55,62,2277,07:00 - 08:59
winter,2012-11-24,9,26,96,122,2277,09:00 - 10:59
winter,2012-11-24,10,46,96,142,2277,09:00 - 10:59
winter,2012-11-24,11,55,131,186,2277,11:00 - 12:59
winter,2012-11-24,12,53,146,199,2277,11:00 - 12:59
winter,2012-11-24,13,64,161,225,2277,13:00 - 14:59
winter,2012-11-24,14,58,149,207,2277,13:00 - 14:59
winter,2012-11-24,15,59,139,198,2277,15:00 - 16:59
winter,2012-11-24,16,43,127,170,2277,15:00 - 16:59
winter,2012-11-24,17,29,97,126,2277,17:00 - 18:59
winter,2012-11-24,18,22,123,145,2277,17:00 - 18:59
winter,2012-11-24,19,9,74,83,2277,19:00 - 20:59
winter,2012-11-24,20,3,55,58,2277,19:00 - 20:59
winter,2012-11-24,21,9,66,75,2277,21:00 - 22:59
winter,2012-11-24,22,7,69,76,2277,21:00 - 22:59
winter,2012-11-24,23,9,48,57,2277,23:00 - 24:59
winter,2012-11-25,0,3,31,34,2424,
winter,2012-11-25,1,4,32,36,2424,01:00 - 02:59
winter,2012-11-25,2,1,27,28,2424,01:00 - 02:59
winter,2012-11-25,3,0,8,8,2424,03:00 - 04:59
winter,2012-11-25,4,1,1,2,2424,03:00 - 04:59
winter,2012-11-25,5,0,3,3,2424,05:00 - 06:59
winter,2012-11-25,6,1,10,11,2424,05:00 - 06:59
winter,2012-11-25,7,2,19,21,2424,07:00 - 08:59
winter,2012-11-25,8,2,32,34,2424,07:00 - 08:59
winter,2012-11-25,9,13,83,96,2424,09:00 - 10:59
winter,2012-11-25,10,15,124,139,2424,09:00 - 10:59
winter,2012-11-25,11,49,155,204,2424,11:00 - 12:59
winter,2012-11-25,12,37,165,202,2424,11:00 - 12:59
winter,2012-11-25,13,37,158,195,2424,13:00 - 14:59
winter,2012-11-25,14,33,170,203,2424,13:00 - 14:59
winter,2012-11-25,15,36,209,245,2424,15:00 - 16:59
winter,2012-11-25,16,25,203,228,2424,15:00 - 16:59
winter,2012-11-25,17,11,170,181,2424,17:00 - 18:59
winter,2012-11-25,18,9,132,141,2424,17:00 - 18:59
winter,2012-11-25,19,13,114,127,2424,19:00 - 20:59
winter,2012-11-25,20,9,110,119,2424,19:00 - 20:59
winter,2012-11-25,21,4,60,64,2424,21:00 - 22:59
winter,2012-11-25,22,3,59,62,2424,21:00 - 22:59
winter,2012-11-25,23,1,40,41,2424,23:00 - 24:59
winter,2012-11-26,0,4,19,23,5087,
winter,2012-11-26,1,1,9,10,5087,01:00 - 02:59
winter,2012-11-26,2,0,5,5,5087,01:00 - 02:59
winter,2012-11-26,3,1,4,5,5087,03:00 - 04:59
winter,2012-11-26,4,0,10,10,5087,03:00 - 04:59
winter,2012-11-26,5,0,41,41,5087,05:00 - 06:59
winter,2012-11-26,6,1,123,124,5087,05:00 - 06:59
winter,2012-11-26,7,2,363,365,5087,07:00 - 08:59
winter,2012-11-26,8,9,629,638,5087,07:00 - 08:59
winter,2012-11-26,9,10,276,286,5087,09:00 - 10:59
winter,2012-11-26,10,20,127,147,5087,09:00 - 10:59
winter,2012-11-26,11,18,112,130,5087,11:00 - 12:59
winter,2012-11-26,12,22,188,210,5087,11:00 - 12:59
winter,2012-11-26,13,20,197,217,5087,13:00 - 14:59
winter,2012-11-26,14,51,177,228,5087,13:00 - 14:59
winter,2012-11-26,15,49,181,230,5087,15:00 - 16:59
winter,2012-11-26,16,49,297,346,5087,15:00 - 16:59
winter,2012-11-26,17,13,540,553,5087,17:00 - 18:59
winter,2012-11-26,18,19,502,521,5087,17:00 - 18:59
winter,2012-11-26,19,16,355,371,5087,19:00 - 20:59
winter,2012-11-26,20,12,265,277,5087,19:00 - 20:59
winter,2012-11-26,21,9,172,181,5087,21:00 - 22:59
winter,2012-11-26,22,3,101,104,5087,21:00 - 22:59
winter,2012-11-26,23,8,57,65,5087,23:00 - 24:59
winter,2012-11-27,0,2,24,26,3959,
winter,2012-11-27,1,0,6,6,3959,01:00 - 02:59
winter,2012-11-27,2,0,5,5,3959,01:00 - 02:59
winter,2012-11-27,3,1,3,4,3959,03:00 - 04:59
winter,2012-11-27,4,0,5,5,3959,03:00 - 04:59
winter,2012-11-27,5,0,31,31,3959,05:00 - 06:59
winter,2012-11-27,6,3,97,100,3959,05:00 - 06:59
winter,2012-11-27,7,4,289,293,3959,07:00 - 08:59
winter,2012-11-27,8,6,494,500,3959,07:00 - 08:59
winter,2012-11-27,9,11,257,268,3959,09:00 - 10:59
winter,2012-11-27,10,5,52,57,3959,09:00 - 10:59
winter,2012-11-27,11,6,59,65,3959,11:00 - 12:59
winter,2012-11-27,12,6,70,76,3959,11:00 - 12:59
winter,2012-11-27,13,4,73,77,3959,13:00 - 14:59
winter,2012-11-27,14,8,86,94,3959,13:00 - 14:59
winter,2012-11-27,15,9,146,155,3959,15:00 - 16:59
winter,2012-11-27,16,5,252,257,3959,15:00 - 16:59
winter,2012-11-27,17,13,514,527,3959,17:00 - 18:59
winter,2012-11-27,18,13,469,482,3959,17:00 - 18:59
winter,2012-11-27,19,12,338,350,3959,19:00 - 20:59
winter,2012-11-27,20,4,228,232,3959,19:00 - 20:59
winter,2012-11-27,21,6,179,185,3959,21:00 - 22:59
winter,2012-11-27,22,2,95,97,3959,21:00 - 22:59
winter,2012-11-27,23,3,64,67,3959,23:00 - 24:59
winter,2012-11-28,0,1,22,23,5260,
winter,2012-11-28,1,0,12,12,5260,01:00 - 02:59
winter,2012-11-28,2,0,1,1,5260,01:00 - 02:59
winter,2012-11-28,3,0,3,3,5260,03:00 - 04:59
winter,2012-11-28,4,0,4,4,5260,03:00 - 04:59
winter,2012-11-28,5,0,39,39,5260,05:00 - 06:59
winter,2012-11-28,6,4,132,136,5260,05:00 - 06:59
winter,2012-11-28,7,6,403,409,5260,07:00 - 08:59
winter,2012-11-28,8,9,683,692,5260,07:00 - 08:59
winter,2012-11-28,9,13,309,322,5260,09:00 - 10:59
winter,2012-11-28,10,17,144,161,5260,09:00 - 10:59
winter,2012-11-28,11,19,127,146,5260,11:00 - 12:59
winter,2012-11-28,12,19,189,208,5260,11:00 - 12:59
winter,2012-11-28,13,21,193,214,5260,13:00 - 14:59
winter,2012-11-28,14,15,161,176,5260,13:00 - 14:59
winter,2012-11-28,15,7,172,179,5260,15:00 - 16:59
winter,2012-11-28,16,9,316,325,5260,15:00 - 16:59
winter,2012-11-28,17,17,546,563,5260,17:00 - 18:59
winter,2012-11-28,18,12,530,542,5260,17:00 - 18:59
winter,2012-11-28,19,9,378,387,5260,19:00 - 20:59
winter,2012-11-28,20,5,258,263,5260,19:00 - 20:59
winter,2012-11-28,21,4,219,223,5260,21:00 - 22:59
winter,2012-11-28,22,6,148,154,5260,21:00 - 22:59
winter,2012-11-28,23,5,73,78,5260,23:00 - 24:59
winter,2012-11-29,0,4,25,29,5323,
winter,2012-11-29,1,1,15,16,5323,01:00 - 02:59
winter,2012-11-29,2,1,6,7,5323,01:00 - 02:59
winter,2012-11-29,4,0,7,7,5323,03:00 - 04:59
winter,2012-11-29,5,0,42,42,5323,05:00 - 06:59
winter,2012-11-29,6,1,120,121,5323,05:00 - 06:59
winter,2012-11-29,7,8,354,362,5323,07:00 - 08:59
winter,2012-11-29,8,15,664,679,5323,07:00 - 08:59
winter,2012-11-29,9,13,286,299,5323,09:00 - 10:59
winter,2012-11-29,10,25,153,178,5323,09:00 - 10:59
winter,2012-11-29,11,13,150,163,5323,11:00 - 12:59
winter,2012-11-29,12,11,225,236,5323,11:00 - 12:59
winter,2012-11-29,13,15,209,224,5323,13:00 - 14:59
winter,2012-11-29,14,13,174,187,5323,13:00 - 14:59
winter,2012-11-29,15,19,201,220,5323,15:00 - 16:59
winter,2012-11-29,16,24,346,370,5323,15:00 - 16:59
winter,2012-11-29,17,17,544,561,5323,17:00 - 18:59
winter,2012-11-29,18,17,520,537,5323,17:00 - 18:59
winter,2012-11-29,19,18,326,344,5323,19:00 - 20:59
winter,2012-11-29,20,11,241,252,5323,19:00 - 20:59
winter,2012-11-29,21,7,201,208,5323,21:00 - 22:59
winter,2012-11-29,22,4,147,151,5323,21:00 - 22:59
winter,2012-11-29,23,6,124,130,5323,23:00 - 24:59
winter,2012-11-30,0,4,48,52,5668,
winter,2012-11-30,1,2,17,19,5668,01:00 - 02:59
winter,2012-11-30,2,2,10,12,5668,01:00 - 02:59
winter,2012-11-30,3,0,4,4,5668,03:00 - 04:59
winter,2012-11-30,4,0,3,3,5668,03:00 - 04:59
winter,2012-11-30,5,1,39,40,5668,05:00 - 06:59
winter,2012-11-30,6,2,104,106,5668,05:00 - 06:59
winter,2012-11-30,7,6,346,352,5668,07:00 - 08:59
winter,2012-11-30,8,20,709,729,5668,07:00 - 08:59
winter,2012-11-30,9,17,313,330,5668,09:00 - 10:59
winter,2012-11-30,10,10,159,169,5668,09:00 - 10:59
winter,2012-11-30,11,31,170,201,5668,11:00 - 12:59
winter,2012-11-30,12,25,243,268,5668,11:00 - 12:59
winter,2012-11-30,13,21,241,262,5668,13:00 - 14:59
winter,2012-11-30,14,26,225,251,5668,13:00 - 14:59
winter,2012-11-30,15,34,262,296,5668,15:00 - 16:59
winter,2012-11-30,16,37,368,405,5668,15:00 - 16:59
winter,2012-11-30,17,31,551,582,5668,17:00 - 18:59
winter,2012-11-30,18,20,489,509,5668,17:00 - 18:59
winter,2012-11-30,19,18,359,377,5668,19:00 - 20:59
winter,2012-11-30,20,12,233,245,5668,19:00 - 20:59
winter,2012-11-30,21,14,169,183,5668,21:00 - 22:59
winter,2012-11-30,22,18,145,163,5668,21:00 - 22:59
winter,2012-11-30,23,11,99,110,5668,23:00 - 24:59
winter,2012-12-01,0,9,99,108,5191,
winter,2012-12-01,1,5,64,69,5191,01:00 - 02:59
winter,2012-12-01,2,3,47,50,5191,01:00 - 02:59
winter,2012-12-01,3,1,14,15,5191,03:00 - 04:59
winter,2012-12-01,4,0,5,5,5191,03:00 - 04:59
winter,2012-12-01,5,1,12,13,5191,05:00 - 06:59
winter,2012-12-01,6,7,20,27,5191,05:00 - 06:59
winter,2012-12-01,7,7,56,63,5191,07:00 - 08:59
winter,2012-12-01,8,11,133,144,5191,07:00 - 08:59
winter,2012-12-01,9,34,159,193,5191,09:00 - 10:59
winter,2012-12-01,10,45,211,256,5191,09:00 - 10:59
winter,2012-12-01,11,74,318,392,5191,11:00 - 12:59
winter,2012-12-01,12,119,327,446,5191,11:00 - 12:59
winter,2012-12-01,13,123,386,509,5191,13:00 - 14:59
winter,2012-12-01,14,110,369,479,5191,13:00 - 14:59
winter,2012-12-01,15,113,371,484,5191,15:00 - 16:59
winter,2012-12-01,16,89,354,443,5191,15:00 - 16:59
winter,2012-12-01,17,50,270,320,5191,17:00 - 18:59
winter,2012-12-01,18,42,255,297,5191,17:00 - 18:59
winter,2012-12-01,19,30,219,249,5191,19:00 - 20:59
winter,2012-12-01,20,28,170,198,5191,19:00 - 20:59
winter,2012-12-01,21,23,135,158,5191,21:00 - 22:59
winter,2012-12-01,22,17,130,147,5191,21:00 - 22:59
winter,2012-12-01,23,10,116,126,5191,23:00 - 24:59
winter,2012-12-02,0,9,108,117,4649,
winter,2012-12-02,1,10,84,94,4649,01:00 - 02:59
winter,2012-12-02,2,2,72,74,4649,01:00 - 02:59
winter,2012-12-02,3,4,21,25,4649,03:00 - 04:59
winter,2012-12-02,4,1,6,7,4649,03:00 - 04:59
winter,2012-12-02,5,1,7,8,4649,05:00 - 06:59
winter,2012-12-02,6,1,15,16,4649,05:00 - 06:59
winter,2012-12-02,7,5,26,31,4649,07:00 - 08:59
winter,2012-12-02,8,12,81,93,4649,07:00 - 08:59
winter,2012-12-02,9,37,135,172,4649,09:00 - 10:59
winter,2012-12-02,10,63,230,293,4649,09:00 - 10:59
winter,2012-12-02,11,81,274,355,4649,11:00 - 12:59
winter,2012-12-02,12,111,409,520,4649,11:00 - 12:59
winter,2012-12-02,13,84,347,431,4649,13:00 - 14:59
winter,2012-12-02,14,142,331,473,4649,13:00 - 14:59
winter,2012-12-02,15,106,311,417,4649,15:00 - 16:59
winter,2012-12-02,16,85,358,443,4649,15:00 - 16:59
winter,2012-12-02,17,59,244,303,4649,17:00 - 18:59
winter,2012-12-02,18,25,178,203,4649,17:00 - 18:59
winter,2012-12-02,19,16,158,174,4649,19:00 - 20:59
winter,2012-12-02,20,12,142,154,4649,19:00 - 20:59
winter,2012-12-02,21,8,91,99,4649,21:00 - 22:59
winter,2012-12-02,22,11,85,96,4649,21:00 - 22:59
winter,2012-12-02,23,7,44,51,4649,23:00 - 24:59
winter,2012-12-03,0,3,18,21,6234,
winter,2012-12-03,1,2,11,13,6234,01:00 - 02:59
winter,2012-12-03,2,1,9,10,6234,01:00 - 02:59
winter,2012-12-03,3,2,6,8,6234,03:00 - 04:59
winter,2012-12-03,4,1,4,5,6234,03:00 - 04:59
winter,2012-12-03,5,0,38,38,6234,05:00 - 06:59
winter,2012-12-03,6,2,136,138,6234,05:00 - 06:59
winter,2012-12-03,7,9,387,396,6234,07:00 - 08:59
winter,2012-12-03,8,19,712,731,6234,07:00 - 08:59
winter,2012-12-03,9,19,289,308,6234,09:00 - 10:59
winter,2012-12-03,10,31,105,136,6234,09:00 - 10:59
winter,2012-12-03,11,51,182,233,6234,11:00 - 12:59
winter,2012-12-03,12,40,228,268,6234,11:00 - 12:59
winter,2012-12-03,13,81,240,321,6234,13:00 - 14:59
winter,2012-12-03,14,51,209,260,6234,13:00 - 14:59
winter,2012-12-03,15,58,210,268,6234,15:00 - 16:59
winter,2012-12-03,16,45,397,442,6234,15:00 - 16:59
winter,2012-12-03,17,43,665,708,6234,17:00 - 18:59
winter,2012-12-03,18,26,666,692,6234,17:00 - 18:59
winter,2012-12-03,19,27,444,471,6234,19:00 - 20:59
winter,2012-12-03,20,16,284,300,6234,19:00 - 20:59
winter,2012-12-03,21,14,207,221,6234,21:00 - 22:59
winter,2012-12-03,22,5,139,144,6234,21:00 - 22:59
winter,2012-12-03,23,9,93,102,6234,23:00 - 24:59
winter,2012-12-04,0,6,49,55,6606,
winter,2012-12-04,1,3,22,25,6606,01:00 - 02:59
winter,2012-12-04,2,3,5,8,6606,01:00 - 02:59
winter,2012-12-04,3,1,3,4,6606,03:00 - 04:59
winter,2012-12-04,4,0,7,7,6606,03:00 - 04:59
winter,2012-12-04,5,1,45,46,6606,05:00 - 06:59
winter,2012-12-04,6,3,150,153,6606,05:00 - 06:59
winter,2012-12-04,7,7,495,502,6606,07:00 - 08:59
winter,2012-12-04,8,21,700,721,6606,07:00 - 08:59
winter,2012-12-04,9,19,317,336,6606,09:00 - 10:59
winter,2012-12-04,10,26,130,156,6606,09:00 - 10:59
winter,2012-12-04,11,24,183,207,6606,11:00 - 12:59
winter,2012-12-04,12,39,273,312,6606,11:00 - 12:59
winter,2012-12-04,13,39,233,272,6606,13:00 - 14:59
winter,2012-12-04,14,39,231,270,6606,13:00 - 14:59
winter,2012-12-04,15,56,244,300,6606,15:00 - 16:59
winter,2012-12-04,16,44,391,435,6606,15:00 - 16:59
winter,2012-12-04,17,43,700,743,6606,17:00 - 18:59
winter,2012-12-04,18,38,693,731,6606,17:00 - 18:59
winter,2012-12-04,19,46,414,460,6606,19:00 - 20:59
winter,2012-12-04,20,34,272,306,6606,19:00 - 20:59
winter,2012-12-04,21,28,252,280,6606,21:00 - 22:59
winter,2012-12-04,22,26,155,181,6606,21:00 - 22:59
winter,2012-12-04,23,5,91,96,6606,23:00 - 24:59
winter,2012-12-05,0,6,31,37,5729,
winter,2012-12-05,1,0,11,11,5729,01:00 - 02:59
winter,2012-12-05,2,2,7,9,5729,01:00 - 02:59
winter,2012-12-05,3,0,7,7,5729,03:00 - 04:59
winter,2012-12-05,4,1,9,10,5729,03:00 - 04:59
winter,2012-12-05,5,1,48,49,5729,05:00 - 06:59
winter,2012-12-05,6,5,119,124,5729,05:00 - 06:59
winter,2012-12-05,7,9,389,398,5729,07:00 - 08:59
winter,2012-12-05,8,22,737,759,5729,07:00 - 08:59
winter,2012-12-05,9,26,362,388,5729,09:00 - 10:59
winter,2012-12-05,10,14,127,141,5729,09:00 - 10:59
winter,2012-12-05,11,11,161,172,5729,11:00 - 12:59
winter,2012-12-05,12,24,208,232,5729,11:00 - 12:59
winter,2012-12-05,13,14,200,214,5729,13:00 - 14:59
winter,2012-12-05,14,39,179,218,5729,13:00 - 14:59
winter,2012-12-05,15,20,265,285,5729,15:00 - 16:59
winter,2012-12-05,16,23,354,377,5729,15:00 - 16:59
winter,2012-12-05,17,29,576,605,5729,17:00 - 18:59
winter,2012-12-05,18,29,580,609,5729,17:00 - 18:59
winter,2012-12-05,19,14,400,414,5729,19:00 - 20:59
winter,2012-12-05,20,19,274,293,5729,19:00 - 20:59
winter,2012-12-05,21,14,184,198,5729,21:00 - 22:59
winter,2012-12-05,22,4,101,105,5729,21:00 - 22:59
winter,2012-12-05,23,5,69,74,5729,23:00 - 24:59
winter,2012-12-06,0,1,43,44,5375,
winter,2012-12-06,1,0,16,16,5375,01:00 - 02:59
winter,2012-12-06,2,0,9,9,5375,01:00 - 02:59
winter,2012-12-06,3,0,2,2,5375,03:00 - 04:59
winter,2012-12-06,4,1,8,9,5375,03:00 - 04:59
winter,2012-12-06,5,0,32,32,5375,05:00 - 06:59
winter,2012-12-06,6,2,122,124,5375,05:00 - 06:59
winter,2012-12-06,7,8,381,389,5375,07:00 - 08:59
winter,2012-12-06,8,13,646,659,5375,07:00 - 08:59
winter,2012-12-06,9,19,257,276,5375,09:00 - 10:59
winter,2012-12-06,10,23,122,145,5375,09:00 - 10:59
winter,2012-12-06,11,16,162,178,5375,11:00 - 12:59
winter,2012-12-06,12,29,206,235,5375,11:00 - 12:59
winter,2012-12-06,13,33,212,245,5375,13:00 - 14:59
winter,2012-12-06,14,37,175,212,5375,13:00 - 14:59
winter,2012-12-06,15,38,232,270,5375,15:00 - 16:59
winter,2012-12-06,16,39,292,331,5375,15:00 - 16:59
winter,2012-12-06,17,31,586,617,5375,17:00 - 18:59
winter,2012-12-06,18,23,542,565,5375,17:00 - 18:59
winter,2012-12-06,19,13,360,373,5375,19:00 - 20:59
winter,2012-12-06,20,5,222,227,5375,19:00 - 20:59
winter,2012-12-06,21,7,184,191,5375,21:00 - 22:59
winter,2012-12-06,22,2,131,133,5375,21:00 - 22:59
winter,2012-12-06,23,0,93,93,5375,23:00 - 24:59
winter,2012-12-07,0,3,45,48,5008,
winter,2012-12-07,1,2,26,28,5008,01:00 - 02:59
winter,2012-12-07,2,0,11,11,5008,01:00 - 02:59
winter,2012-12-07,3,0,5,5,5008,03:00 - 04:59
winter,2012-12-07,4,0,10,10,5008,03:00 - 04:59
winter,2012-12-07,5,1,25,26,5008,05:00 - 06:59
winter,2012-12-07,6,0,84,84,5008,05:00 - 06:59
winter,2012-12-07,7,3,212,215,5008,07:00 - 08:59
winter,2012-12-07,8,11,430,441,5008,07:00 - 08:59
winter,2012-12-07,9,10,291,301,5008,09:00 - 10:59
winter,2012-12-07,10,16,150,166,5008,09:00 - 10:59
winter,2012-12-07,11,20,183,203,5008,11:00 - 12:59
winter,2012-12-07,12,36,204,240,5008,11:00 - 12:59
winter,2012-12-07,13,23,197,220,5008,13:00 - 14:59
winter,2012-12-07,14,40,175,215,5008,13:00 - 14:59
winter,2012-12-07,15,34,269,303,5008,15:00 - 16:59
winter,2012-12-07,16,39,336,375,5008,15:00 - 16:59
winter,2012-12-07,17,29,539,568,5008,17:00 - 18:59
winter,2012-12-07,18,25,473,498,5008,17:00 - 18:59
winter,2012-12-07,19,15,337,352,5008,19:00 - 20:59
winter,2012-12-07,20,12,229,241,5008,19:00 - 20:59
winter,2012-12-07,21,9,162,171,5008,21:00 - 22:59
winter,2012-12-07,22,15,150,165,5008,21:00 - 22:59
winter,2012-12-07,23,6,116,122,5008,23:00 - 24:59
winter,2012-12-08,0,5,98,103,5582,
winter,2012-12-08,1,16,84,100,5582,01:00 - 02:59
winter,2012-12-08,2,3,67,70,5582,01:00 - 02:59
winter,2012-12-08,3,6,23,29,5582,03:00 - 04:59
winter,2012-12-08,4,3,9,12,5582,03:00 - 04:59
winter,2012-12-08,5,2,4,6,5582,05:00 - 06:59
winter,2012-12-08,6,1,19,20,5582,05:00 - 06:59
winter,2012-12-08,7,3,36,39,5582,07:00 - 08:59
winter,2012-12-08,8,5,106,111,5582,07:00 - 08:59
winter,2012-12-08,9,17,153,170,5582,09:00 - 10:59
winter,2012-12-08,10,43,244,287,5582,09:00 - 10:59
winter,2012-12-08,11,63,341,404,5582,11:00 - 12:59
winter,2012-12-08,12,122,364,486,5582,11:00 - 12:59
winter,2012-12-08,13,148,399,547,5582,13:00 - 14:59
winter,2012-12-08,14,164,378,542,5582,13:00 - 14:59
winter,2012-12-08,15,167,374,541,5582,15:00 - 16:59
winter,2012-12-08,16,139,368,507,5582,15:00 - 16:59
winter,2012-12-08,17,77,268,345,5582,17:00 - 18:59
winter,2012-12-08,18,40,264,304,5582,17:00 - 18:59
winter,2012-12-08,19,34,212,246,5582,19:00 - 20:59
winter,2012-12-08,20,20,162,182,5582,19:00 - 20:59
winter,2012-12-08,21,34,175,209,5582,21:00 - 22:59
winter,2012-12-08,22,23,137,160,5582,21:00 - 22:59
winter,2012-12-08,23,18,144,162,5582,23:00 - 24:59
winter,2012-12-09,0,15,103,118,3228,
winter,2012-12-09,1,17,85,102,3228,01:00 - 02:59
winter,2012-12-09,2,8,70,78,3228,01:00 - 02:59
winter,2012-12-09,3,14,34,48,3228,03:00 - 04:59
winter,2012-12-09,4,1,11,12,3228,03:00 - 04:59
winter,2012-12-09,5,0,8,8,3228,05:00 - 06:59
winter,2012-12-09,6,0,6,6,3228,05:00 - 06:59
winter,2012-12-09,7,1,22,23,3228,07:00 - 08:59
winter,2012-12-09,8,1,68,69,3228,07:00 - 08:59
winter,2012-12-09,9,9,94,103,3228,09:00 - 10:59
winter,2012-12-09,10,39,180,219,3228,09:00 - 10:59
winter,2012-12-09,11,40,210,250,3228,11:00 - 12:59
winter,2012-12-09,12,60,255,315,3228,11:00 - 12:59
winter,2012-12-09,13,65,220,285,3228,13:00 - 14:59
winter,2012-12-09,14,42,190,232,3228,13:00 - 14:59
winter,2012-12-09,15,25,200,225,3228,15:00 - 16:59
winter,2012-12-09,16,33,220,253,3228,15:00 - 16:59
winter,2012-12-09,17,20,209,229,3228,17:00 - 18:59
winter,2012-12-09,18,17,181,198,3228,17:00 - 18:59
winter,2012-12-09,19,12,110,122,3228,19:00 - 20:59
winter,2012-12-09,20,6,102,108,3228,19:00 - 20:59
winter,2012-12-09,21,10,86,96,3228,21:00 - 22:59
winter,2012-12-09,22,3,75,78,3228,21:00 - 22:59
winter,2012-12-09,23,3,48,51,3228,23:00 - 24:59
winter,2012-12-10,0,0,20,20,5170,
winter,2012-12-10,1,0,4,4,5170,01:00 - 02:59
winter,2012-12-10,2,2,3,5,5170,01:00 - 02:59
winter,2012-12-10,3,0,4,4,5170,03:00 - 04:59
winter,2012-12-10,4,3,9,12,5170,03:00 - 04:59
winter,2012-12-10,5,0,27,27,5170,05:00 - 06:59
winter,2012-12-10,6,2,121,123,5170,05:00 - 06:59
winter,2012-12-10,7,3,291,294,5170,07:00 - 08:59
winter,2012-12-10,8,9,575,584,5170,07:00 - 08:59
winter,2012-12-10,9,11,273,284,5170,09:00 - 10:59
winter,2012-12-10,10,12,121,133,5170,09:00 - 10:59
winter,2012-12-10,11,8,126,134,5170,11:00 - 12:59
winter,2012-12-10,12,23,150,173,5170,11:00 - 12:59
winter,2012-12-10,13,30,190,220,5170,13:00 - 14:59
winter,2012-12-10,14,31,179,210,5170,13:00 - 14:59
winter,2012-12-10,15,29,207,236,5170,15:00 - 16:59
winter,2012-12-10,16,37,308,345,5170,15:00 - 16:59
winter,2012-12-10,17,38,578,616,5170,17:00 - 18:59
winter,2012-12-10,18,20,544,564,5170,17:00 - 18:59
winter,2012-12-10,19,18,409,427,5170,19:00 - 20:59
winter,2012-12-10,20,13,287,300,5170,19:00 - 20:59
winter,2012-12-10,21,21,224,245,5170,21:00 - 22:59
winter,2012-12-10,22,11,115,126,5170,21:00 - 22:59
winter,2012-12-10,23,8,76,84,5170,23:00 - 24:59
winter,2012-12-11,0,2,29,31,5501,
winter,2012-12-11,1,1,7,8,5501,01:00 - 02:59
winter,2012-12-11,2,0,1,1,5501,01:00 - 02:59
winter,2012-12-11,3,0,3,3,5501,03:00 - 04:59
winter,2012-12-11,4,0,8,8,5501,03:00 - 04:59
winter,2012-12-11,5,1,40,41,5501,05:00 - 06:59
winter,2012-12-11,6,0,118,118,5501,05:00 - 06:59
winter,2012-12-11,7,8,372,380,5501,07:00 - 08:59
winter,2012-12-11,8,16,708,724,5501,07:00 - 08:59
winter,2012-12-11,9,12,322,334,5501,09:00 - 10:59
winter,2012-12-11,10,12,142,154,5501,09:00 - 10:59
winter,2012-12-11,11,28,145,173,5501,11:00 - 12:59
winter,2012-12-11,12,13,213,226,5501,11:00 - 12:59
winter,2012-12-11,13,28,226,254,5501,13:00 - 14:59
winter,2012-12-11,14,19,185,204,5501,13:00 - 14:59
winter,2012-12-11,15,20,250,270,5501,15:00 - 16:59
winter,2012-12-11,16,24,334,358,5501,15:00 - 16:59
winter,2012-12-11,17,21,580,601,5501,17:00 - 18:59
winter,2012-12-11,18,23,523,546,5501,17:00 - 18:59
winter,2012-12-11,19,21,412,433,5501,19:00 - 20:59
winter,2012-12-11,20,9,248,257,5501,19:00 - 20:59
winter,2012-12-11,21,14,193,207,5501,21:00 - 22:59
winter,2012-12-11,22,6,100,106,5501,21:00 - 22:59
winter,2012-12-11,23,4,60,64,5501,23:00 - 24:59
winter,2012-12-12,0,1,33,34,5319,
winter,2012-12-12,1,3,18,21,5319,01:00 - 02:59
winter,2012-12-12,2,5,4,9,5319,01:00 - 02:59
winter,2012-12-12,3,3,7,10,5319,03:00 - 04:59
winter,2012-12-12,4,0,4,4,5319,03:00 - 04:59
winter,2012-12-12,5,0,37,37,5319,05:00 - 06:59
winter,2012-12-12,6,2,126,128,5319,05:00 - 06:59
winter,2012-12-12,7,3,366,369,5319,07:00 - 08:59
winter,2012-12-12,8,18,670,688,5319,07:00 - 08:59
winter,2012-12-12,9,13,272,285,5319,09:00 - 10:59
winter,2012-12-12,10,20,116,136,5319,09:00 - 10:59
winter,2012-12-12,11,24,148,172,5319,11:00 - 12:59
winter,2012-12-12,12,14,218,232,5319,11:00 - 12:59
winter,2012-12-12,13,18,220,238,5319,13:00 - 14:59
winter,2012-12-12,14,34,191,225,5319,13:00 - 14:59
winter,2012-12-12,15,21,207,228,5319,15:00 - 16:59
winter,2012-12-12,16,19,310,329,5319,15:00 - 16:59
winter,2012-12-12,17,21,540,561,5319,17:00 - 18:59
winter,2012-12-12,18,25,515,540,5319,17:00 - 18:59
winter,2012-12-12,19,18,384,402,5319,19:00 - 20:59
winter,2012-12-12,20,25,243,268,5319,19:00 - 20:59
winter,2012-12-12,21,16,186,202,5319,21:00 - 22:59
winter,2012-12-12,22,4,118,122,5319,21:00 - 22:59
winter,2012-12-12,23,3,76,79,5319,23:00 - 24:59
winter,2012-12-13,0,1,31,32,5532,
winter,2012-12-13,1,4,19,23,5532,01:00 - 02:59
winter,2012-12-13,2,3,5,8,5532,01:00 - 02:59
winter,2012-12-13,3,0,2,2,5532,03:00 - 04:59
winter,2012-12-13,4,0,8,8,5532,03:00 - 04:59
winter,2012-12-13,5,2,31,33,5532,05:00 - 06:59
winter,2012-12-13,6,2,112,114,5532,05:00 - 06:59
winter,2012-12-13,7,5,380,385,5532,07:00 - 08:59
winter,2012-12-13,8,24,655,679,5532,07:00 - 08:59
winter,2012-12-13,9,25,300,325,5532,09:00 - 10:59
winter,2012-12-13,10,28,139,167,5532,09:00 - 10:59
winter,2012-12-13,11,25,164,189,5532,11:00 - 12:59
winter,2012-12-13,12,30,252,282,5532,11:00 - 12:59
winter,2012-12-13,13,41,230,271,5532,13:00 - 14:59
winter,2012-12-13,14,31,211,242,5532,13:00 - 14:59
winter,2012-12-13,15,40,240,280,5532,15:00 - 16:59
winter,2012-12-13,16,50,356,406,5532,15:00 - 16:59
winter,2012-12-13,17,43,507,550,5532,17:00 - 18:59
winter,2012-12-13,18,20,446,466,5532,17:00 - 18:59
winter,2012-12-13,19,20,328,348,5532,19:00 - 20:59
winter,2012-12-13,20,6,235,241,5532,19:00 - 20:59
winter,2012-12-13,21,13,200,213,5532,21:00 - 22:59
winter,2012-12-13,22,7,141,148,5532,21:00 - 22:59
winter,2012-12-13,23,5,115,120,5532,23:00 - 24:59
winter,2012-12-14,0,4,43,47,5611,
winter,2012-12-14,1,0,26,26,5611,01:00 - 02:59
winter,2012-12-14,2,3,6,9,5611,01:00 - 02:59
winter,2012-12-14,3,0,12,12,5611,03:00 - 04:59
winter,2012-12-14,4,1,9,10,5611,03:00 - 04:59
winter,2012-12-14,5,0,34,34,5611,05:00 - 06:59
winter,2012-12-14,6,1,112,113,5611,05:00 - 06:59
winter,2012-12-14,7,3,305,308,5611,07:00 - 08:59
winter,2012-12-14,8,13,623,636,5611,07:00 - 08:59
winter,2012-12-14,9,13,330,343,5611,09:00 - 10:59
winter,2012-12-14,10,28,162,190,5611,09:00 - 10:59
winter,2012-12-14,11,31,180,211,5611,11:00 - 12:59
winter,2012-12-14,12,29,244,273,5611,11:00 - 12:59
winter,2012-12-14,13,39,274,313,5611,13:00 - 14:59
winter,2012-12-14,14,48,251,299,5611,13:00 - 14:59
winter,2012-12-14,15,57,252,309,5611,15:00 - 16:59
winter,2012-12-14,16,45,372,417,5611,15:00 - 16:59
winter,2012-12-14,17,40,582,622,5611,17:00 - 18:59
winter,2012-12-14,18,23,432,455,5611,17:00 - 18:59
winter,2012-12-14,19,17,302,319,5611,19:00 - 20:59
winter,2012-12-14,20,12,209,221,5611,19:00 - 20:59
winter,2012-12-14,21,7,165,172,5611,21:00 - 22:59
winter,2012-12-14,22,4,134,138,5611,21:00 - 22:59
winter,2012-12-14,23,11,123,134,5611,23:00 - 24:59
winter,2012-12-15,0,4,90,94,5047,
winter,2012-12-15,1,9,86,95,5047,01:00 - 02:59
winter,2012-12-15,2,6,63,69,5047,01:00 - 02:59
winter,2012-12-15,3,5,18,23,5047,03:00 - 04:59
winter,2012-12-15,4,1,5,6,5047,03:00 - 04:59
winter,2012-12-15,5,0,3,3,5047,05:00 - 06:59
winter,2012-12-15,6,0,11,11,5047,05:00 - 06:59
winter,2012-12-15,7,1,47,48,5047,07:00 - 08:59
winter,2012-12-15,8,8,111,119,5047,07:00 - 08:59
winter,2012-12-15,9,17,203,220,5047,09:00 - 10:59
winter,2012-12-15,10,23,250,273,5047,09:00 - 10:59
winter,2012-12-15,11,66,327,393,5047,11:00 - 12:59
winter,2012-12-15,12,89,364,453,5047,11:00 - 12:59
winter,2012-12-15,13,88,368,456,5047,13:00 - 14:59
winter,2012-12-15,14,92,334,426,5047,13:00 - 14:59
winter,2012-12-15,15,95,352,447,5047,15:00 - 16:59
winter,2012-12-15,16,85,328,413,5047,15:00 - 16:59
winter,2012-12-15,17,35,274,309,5047,17:00 - 18:59
winter,2012-12-15,18,40,232,272,5047,17:00 - 18:59
winter,2012-12-15,19,32,225,257,5047,19:00 - 20:59
winter,2012-12-15,20,23,178,201,5047,19:00 - 20:59
winter,2012-12-15,21,15,169,184,5047,21:00 - 22:59
winter,2012-12-15,22,22,134,156,5047,21:00 - 22:59
winter,2012-12-15,23,11,108,119,5047,23:00 - 24:59
winter,2012-12-16,0,8,102,110,3786,
winter,2012-12-16,1,14,82,96,3786,01:00 - 02:59
winter,2012-12-16,2,8,79,87,3786,01:00 - 02:59
winter,2012-12-16,3,1,37,38,3786,03:00 - 04:59
winter,2012-12-16,4,1,10,11,3786,03:00 - 04:59
winter,2012-12-16,5,0,9,9,3786,05:00 - 06:59
winter,2012-12-16,6,0,6,6,3786,05:00 - 06:59
winter,2012-12-16,7,5,22,27,3786,07:00 - 08:59
winter,2012-12-16,8,12,76,88,3786,07:00 - 08:59
winter,2012-12-16,9,19,113,132,3786,09:00 - 10:59
winter,2012-12-16,10,42,215,257,3786,09:00 - 10:59
winter,2012-12-16,11,47,248,295,3786,11:00 - 12:59
winter,2012-12-16,12,67,350,417,3786,11:00 - 12:59
winter,2012-12-16,13,67,289,356,3786,13:00 - 14:59
winter,2012-12-16,14,50,260,310,3786,13:00 - 14:59
winter,2012-12-16,15,46,292,338,3786,15:00 - 16:59
winter,2012-12-16,16,66,334,400,3786,15:00 - 16:59
winter,2012-12-16,17,29,214,243,3786,17:00 - 18:59
winter,2012-12-16,18,8,99,107,3786,17:00 - 18:59
winter,2012-12-16,19,10,99,109,3786,19:00 - 20:59
winter,2012-12-16,20,14,108,122,3786,19:00 - 20:59
winter,2012-12-16,21,14,92,106,3786,21:00 - 22:59
winter,2012-12-16,22,6,83,89,3786,21:00 - 22:59
winter,2012-12-16,23,4,29,33,3786,23:00 - 24:59
winter,2012-12-17,0,2,26,28,4585,
winter,2012-12-17,1,1,14,15,4585,01:00 - 02:59
winter,2012-12-17,2,1,4,5,4585,01:00 - 02:59
winter,2012-12-17,3,0,3,3,4585,03:00 - 04:59
winter,2012-12-17,4,2,3,5,4585,03:00 - 04:59
winter,2012-12-17,5,0,24,24,4585,05:00 - 06:59
winter,2012-12-17,6,1,107,108,4585,05:00 - 06:59
winter,2012-12-17,7,5,314,319,4585,07:00 - 08:59
winter,2012-12-17,8,10,582,592,4585,07:00 - 08:59
winter,2012-12-17,9,11,271,282,4585,09:00 - 10:59
winter,2012-12-17,10,15,120,135,4585,09:00 - 10:59
winter,2012-12-17,11,22,148,170,4585,11:00 - 12:59
winter,2012-12-17,12,21,211,232,4585,11:00 - 12:59
winter,2012-12-17,13,16,194,210,4585,13:00 - 14:59
winter,2012-12-17,14,12,169,181,4585,13:00 - 14:59
winter,2012-12-17,15,15,196,211,4585,15:00 - 16:59
winter,2012-12-17,16,15,287,302,4585,15:00 - 16:59
winter,2012-12-17,17,17,478,495,4585,17:00 - 18:59
winter,2012-12-17,18,14,493,507,4585,17:00 - 18:59
winter,2012-12-17,19,7,333,340,4585,19:00 - 20:59
winter,2012-12-17,20,8,192,200,4585,19:00 - 20:59
winter,2012-12-17,21,6,114,120,4585,21:00 - 22:59
winter,2012-12-17,22,5,49,54,4585,21:00 - 22:59
winter,2012-12-17,23,6,41,47,4585,23:00 - 24:59
winter,2012-12-18,0,0,18,18,5557,
winter,2012-12-18,1,0,15,15,5557,01:00 - 02:59
winter,2012-12-18,2,2,5,7,5557,01:00 - 02:59
winter,2012-12-18,3,0,5,5,5557,03:00 - 04:59
winter,2012-12-18,4,3,5,8,5557,03:00 - 04:59
winter,2012-12-18,5,0,36,36,5557,05:00 - 06:59
winter,2012-12-18,6,1,117,118,5557,05:00 - 06:59
winter,2012-12-18,7,4,351,355,5557,07:00 - 08:59
winter,2012-12-18,8,10,652,662,5557,07:00 - 08:59
winter,2012-12-18,9,19,307,326,5557,09:00 - 10:59
winter,2012-12-18,10,22,162,184,5557,09:00 - 10:59
winter,2012-12-18,11,58,211,269,5557,11:00 - 12:59
winter,2012-12-18,12,49,264,313,5557,11:00 - 12:59
winter,2012-12-18,13,51,235,286,5557,13:00 - 14:59
winter,2012-12-18,14,56,191,247,5557,13:00 - 14:59
winter,2012-12-18,15,28,218,246,5557,15:00 - 16:59
winter,2012-12-18,16,40,323,363,5557,15:00 - 16:59
winter,2012-12-18,17,39,533,572,5557,17:00 - 18:59
winter,2012-12-18,18,13,512,525,5557,17:00 - 18:59
winter,2012-12-18,19,19,334,353,5557,19:00 - 20:59
winter,2012-12-18,20,4,264,268,5557,19:00 - 20:59
winter,2012-12-18,21,9,159,168,5557,21:00 - 22:59
winter,2012-12-18,22,5,127,132,5557,21:00 - 22:59
winter,2012-12-18,23,1,80,81,5557,23:00 - 24:59
winter,2012-12-19,0,6,35,41,5267,
winter,2012-12-19,1,1,14,15,5267,01:00 - 02:59
winter,2012-12-19,2,1,2,3,5267,01:00 - 02:59
winter,2012-12-19,3,0,5,5,5267,03:00 - 04:59
winter,2012-12-19,4,1,6,7,5267,03:00 - 04:59
winter,2012-12-19,5,2,29,31,5267,05:00 - 06:59
winter,2012-12-19,6,3,109,112,5267,05:00 - 06:59
winter,2012-12-19,7,3,360,363,5267,07:00 - 08:59
winter,2012-12-19,8,13,665,678,5267,07:00 - 08:59
winter,2012-12-19,9,8,309,317,5267,09:00 - 10:59
winter,2012-12-19,10,17,147,164,5267,09:00 - 10:59
winter,2012-12-19,11,31,169,200,5267,11:00 - 12:59
winter,2012-12-19,12,33,203,236,5267,11:00 - 12:59
winter,2012-12-19,13,30,183,213,5267,13:00 - 14:59
winter,2012-12-19,14,33,185,218,5267,13:00 - 14:59
winter,2012-12-19,15,28,209,237,5267,15:00 - 16:59
winter,2012-12-19,16,37,297,334,5267,15:00 - 16:59
winter,2012-12-19,17,26,536,562,5267,17:00 - 18:59
winter,2012-12-19,18,23,546,569,5267,17:00 - 18:59
winter,2012-12-19,19,7,329,336,5267,19:00 - 20:59
winter,2012-12-19,20,10,231,241,5267,19:00 - 20:59
winter,2012-12-19,21,4,164,168,5267,21:00 - 22:59
winter,2012-12-19,22,12,117,129,5267,21:00 - 22:59
winter,2012-12-19,23,4,84,88,5267,23:00 - 24:59
winter,2012-12-20,0,2,40,42,4128,
winter,2012-12-20,1,1,19,20,4128,01:00 - 02:59
winter,2012-12-20,2,2,6,8,4128,01:00 - 02:59
winter,2012-12-20,3,1,3,4,4128,03:00 - 04:59
winter,2012-12-20,4,0,6,6,4128,03:00 - 04:59
winter,2012-12-20,5,0,35,35,4128,05:00 - 06:59
winter,2012-12-20,6,4,114,118,4128,05:00 - 06:59
winter,2012-12-20,7,4,346,350,4128,07:00 - 08:59
winter,2012-12-20,8,14,585,599,4128,07:00 - 08:59
winter,2012-12-20,9,14,303,317,4128,09:00 - 10:59
winter,2012-12-20,10,23,138,161,4128,09:00 - 10:59
winter,2012-12-20,11,22,168,190,4128,11:00 - 12:59
winter,2012-12-20,12,31,181,212,4128,11:00 - 12:59
winter,2012-12-20,13,46,171,217,4128,13:00 - 14:59
winter,2012-12-20,14,43,171,214,4128,13:00 - 14:59
winter,2012-12-20,15,33,216,249,4128,15:00 - 16:59
winter,2012-12-20,16,21,281,302,4128,15:00 - 16:59
winter,2012-12-20,17,25,450,475,4128,17:00 - 18:59
winter,2012-12-20,18,22,359,381,4128,17:00 - 18:59
winter,2012-12-20,19,3,115,118,4128,19:00 - 20:59
winter,2012-12-20,20,1,49,50,4128,19:00 - 20:59
winter,2012-12-20,21,1,25,26,4128,21:00 - 22:59
winter,2012-12-20,22,1,20,21,4128,21:00 - 22:59
winter,2012-12-20,23,0,13,13,4128,23:00 - 24:59
springer,2012-12-21,0,0,17,17,3623,
springer,2012-12-21,1,2,7,9,3623,01:00 - 02:59
springer,2012-12-21,2,0,3,3,3623,01:00 - 02:59
springer,2012-12-21,3,0,3,3,3623,03:00 - 04:59
springer,2012-12-21,4,1,5,6,3623,03:00 - 04:59
springer,2012-12-21,5,0,13,13,3623,05:00 - 06:59
springer,2012-12-21,6,4,76,80,3623,05:00 - 06:59
springer,2012-12-21,7,3,205,208,3623,07:00 - 08:59
springer,2012-12-21,8,8,464,472,3623,07:00 - 08:59
springer,2012-12-21,9,2,265,267,3623,09:00 - 10:59
springer,2012-12-21,10,8,146,154,3623,09:00 - 10:59
springer,2012-12-21,11,12,150,162,3623,11:00 - 12:59
springer,2012-12-21,12,25,199,224,3623,11:00 - 12:59
springer,2012-12-21,13,26,214,240,3623,13:00 - 14:59
springer,2012-12-21,14,20,199,219,3623,13:00 - 14:59
springer,2012-12-21,15,29,234,263,3623,15:00 - 16:59
springer,2012-12-21,16,28,253,281,3623,15:00 - 16:59
springer,2012-12-21,17,24,297,321,3623,17:00 - 18:59
springer,2012-12-21,18,7,236,243,3623,17:00 - 18:59
springer,2012-12-21,19,5,148,153,3623,19:00 - 20:59
springer,2012-12-21,20,8,104,112,3623,19:00 - 20:59
springer,2012-12-21,21,2,68,70,3623,21:00 - 22:59
springer,2012-12-21,22,6,57,63,3623,21:00 - 22:59
springer,2012-12-21,23,1,39,40,3623,23:00 - 24:59
springer,2012-12-22,0,1,30,31,1749,
springer,2012-12-22,1,1,34,35,1749,01:00 - 02:59
springer,2012-12-22,2,0,23,23,1749,01:00 - 02:59
springer,2012-12-22,3,0,7,7,1749,03:00 - 04:59
springer,2012-12-22,4,3,2,5,1749,03:00 - 04:59
springer,2012-12-22,5,0,5,5,1749,05:00 - 06:59
springer,2012-12-22,6,0,13,13,1749,05:00 - 06:59
springer,2012-12-22,7,2,18,20,1749,07:00 - 08:59
springer,2012-12-22,8,0,29,29,1749,07:00 - 08:59
springer,2012-12-22,9,13,77,90,1749,09:00 - 10:59
springer,2012-12-22,10,13,105,118,1749,09:00 - 10:59
springer,2012-12-22,11,29,130,159,1749,11:00 - 12:59
springer,2012-12-22,12,18,128,146,1749,11:00 - 12:59
springer,2012-12-22,13,23,135,158,1749,13:00 - 14:59
springer,2012-12-22,14,20,141,161,1749,13:00 - 14:59
springer,2012-12-22,15,14,139,153,1749,15:00 - 16:59
springer,2012-12-22,16,23,124,147,1749,15:00 - 16:59
springer,2012-12-22,17,15,99,114,1749,17:00 - 18:59
springer,2012-12-22,18,7,75,82,1749,17:00 - 18:59
springer,2012-12-22,19,9,51,60,1749,19:00 - 20:59
springer,2012-12-22,20,6,55,61,1749,19:00 - 20:59
springer,2012-12-22,21,4,49,53,1749,21:00 - 22:59
springer,2012-12-22,22,1,38,39,1749,21:00 - 22:59
springer,2012-12-22,23,3,37,40,1749,23:00 - 24:59
springer,2012-12-23,0,3,24,27,1787,
springer,2012-12-23,1,1,19,20,1787,01:00 - 02:59
springer,2012-12-23,2,1,17,18,1787,01:00 - 02:59
springer,2012-12-23,3,0,9,9,1787,03:00 - 04:59
springer,2012-12-23,4,1,3,4,1787,03:00 - 04:59
springer,2012-12-23,5,0,6,6,1787,05:00 - 06:59
springer,2012-12-23,6,4,5,9,1787,05:00 - 06:59
springer,2012-12-23,7,3,16,19,1787,07:00 - 08:59
springer,2012-12-23,8,5,43,48,1787,07:00 - 08:59
springer,2012-12-23,9,7,49,56,1787,09:00 - 10:59
springer,2012-12-23,10,26,67,93,1787,09:00 - 10:59
springer,2012-12-23,11,48,104,152,1787,11:00 - 12:59
springer,2012-12-23,12,52,144,196,1787,11:00 - 12:59
springer,2012-12-23,13,63,123,186,1787,13:00 - 14:59
springer,2012-12-23,14,57,118,175,1787,13:00 - 14:59
springer,2012-12-23,15,39,98,137,1787,15:00 - 16:59
springer,2012-12-23,16,53,137,190,1787,15:00 - 16:59
springer,2012-12-23,17,21,93,114,1787,17:00 - 18:59
springer,2012-12-23,18,8,85,93,1787,17:00 - 18:59
springer,2012-12-23,19,4,54,58,1787,19:00 - 20:59
springer,2012-12-23,20,0,52,52,1787,19:00 - 20:59
springer,2012-12-23,21,4,38,42,1787,21:00 - 22:59
springer,2012-12-23,22,5,53,58,1787,21:00 - 22:59
springer,2012-12-23,23,3,22,25,1787,23:00 - 24:59
springer,2012-12-24,0,0,12,12,920,
springer,2012-12-24,1,0,11,11,920,01:00 - 02:59
springer,2012-12-24,2,0,5,5,920,01:00 - 02:59
springer,2012-12-24,3,1,2,3,920,03:00 - 04:59
springer,2012-12-24,5,0,9,9,920,05:00 - 06:59
springer,2012-12-24,6,1,16,17,920,05:00 - 06:59
springer,2012-12-24,7,3,27,30,920,07:00 - 08:59
springer,2012-12-24,8,4,62,66,920,07:00 - 08:59
springer,2012-12-24,9,17,68,85,920,09:00 - 10:59
springer,2012-12-24,10,21,82,103,920,09:00 - 10:59
springer,2012-12-24,11,20,104,124,920,11:00 - 12:59
springer,2012-12-24,12,22,113,135,920,11:00 - 12:59
springer,2012-12-24,13,16,54,70,920,13:00 - 14:59
springer,2012-12-24,14,13,33,46,920,13:00 - 14:59
springer,2012-12-24,15,6,27,33,920,15:00 - 16:59
springer,2012-12-24,16,6,27,33,920,15:00 - 16:59
springer,2012-12-24,17,7,19,26,920,17:00 - 18:59
springer,2012-12-24,18,6,20,26,920,17:00 - 18:59
springer,2012-12-24,19,4,14,18,920,19:00 - 20:59
springer,2012-12-24,20,6,17,23,920,19:00 - 20:59
springer,2012-12-24,21,13,9,22,920,21:00 - 22:59
springer,2012-12-24,22,7,5,12,920,21:00 - 22:59
springer,2012-12-24,23,1,10,11,920,23:00 - 24:59
springer,2012-12-25,0,3,10,13,1013,
springer,2012-12-25,1,0,13,13,1013,01:00 - 02:59
springer,2012-12-25,2,0,7,7,1013,01:00 - 02:59
springer,2012-12-25,4,0,1,1,1013,03:00 - 04:59
springer,2012-12-25,5,2,1,3,1013,05:00 - 06:59
springer,2012-12-25,6,1,6,7,1013,05:00 - 06:59
springer,2012-12-25,7,0,6,6,1013,07:00 - 08:59
springer,2012-12-25,8,1,10,11,1013,07:00 - 08:59
springer,2012-12-25,9,7,21,28,1013,09:00 - 10:59
springer,2012-12-25,10,11,21,32,1013,09:00 - 10:59
springer,2012-12-25,11,43,43,86,1013,11:00 - 12:59
springer,2012-12-25,12,62,52,114,1013,11:00 - 12:59
springer,2012-12-25,13,75,46,121,1013,13:00 - 14:59
springer,2012-12-25,14,58,68,126,1013,13:00 - 14:59
springer,2012-12-25,15,51,56,107,1013,15:00 - 16:59
springer,2012-12-25,16,48,38,86,1013,15:00 - 16:59
springer,2012-12-25,17,16,34,50,1013,17:00 - 18:59
springer,2012-12-25,18,20,23,43,1013,17:00 - 18:59
springer,2012-12-25,19,16,20,36,1013,19:00 - 20:59
springer,2012-12-25,20,11,29,40,1013,19:00 - 20:59
springer,2012-12-25,21,8,26,34,1013,21:00 - 22:59
springer,2012-12-25,22,3,16,19,1013,21:00 - 22:59
springer,2012-12-25,23,4,26,30,1013,23:00 - 24:59
springer,2012-12-26,0,1,8,9,441,
springer,2012-12-26,1,0,7,7,441,01:00 - 02:59
springer,2012-12-26,2,0,1,1,441,01:00 - 02:59
springer,2012-12-26,3,0,2,2,441,03:00 - 04:59
springer,2012-12-26,4,0,2,2,441,03:00 - 04:59
springer,2012-12-26,5,0,11,11,441,05:00 - 06:59
springer,2012-12-26,6,0,36,36,441,05:00 - 06:59
springer,2012-12-26,7,0,26,26,441,07:00 - 08:59
springer,2012-12-26,8,0,31,31,441,07:00 - 08:59
springer,2012-12-26,9,1,22,23,441,09:00 - 10:59
springer,2012-12-26,10,0,8,8,441,09:00 - 10:59
springer,2012-12-26,11,0,10,10,441,11:00 - 12:59
springer,2012-12-26,12,0,10,10,441,11:00 - 12:59
springer,2012-12-26,13,0,15,15,441,13:00 - 14:59
springer,2012-12-26,14,0,20,20,441,13:00 - 14:59
springer,2012-12-26,15,0,13,13,441,15:00 - 16:59
springer,2012-12-26,16,0,13,13,441,15:00 - 16:59
springer,2012-12-26,17,2,51,53,441,17:00 - 18:59
springer,2012-12-26,18,1,42,43,441,17:00 - 18:59
springer,2012-12-26,19,2,33,35,441,19:00 - 20:59
springer,2012-12-26,20,0,32,32,441,19:00 - 20:59
springer,2012-12-26,21,0,20,20,441,21:00 - 22:59
springer,2012-12-26,22,0,11,11,441,21:00 - 22:59
springer,2012-12-26,23,2,8,10,441,23:00 - 24:59
springer,2012-12-27,0,0,3,3,2114,
springer,2012-12-27,1,0,5,5,2114,01:00 - 02:59
springer,2012-12-27,2,0,2,2,2114,01:00 - 02:59
springer,2012-12-27,3,0,1,1,2114,03:00 - 04:59
springer,2012-12-27,4,0,3,3,2114,03:00 - 04:59
springer,2012-12-27,5,1,10,11,2114,05:00 - 06:59
springer,2012-12-27,6,0,45,45,2114,05:00 - 06:59
springer,2012-12-27,7,0,90,90,2114,07:00 - 08:59
springer,2012-12-27,8,2,206,208,2114,07:00 - 08:59
springer,2012-12-27,9,6,127,133,2114,09:00 - 10:59
springer,2012-12-27,10,8,67,75,2114,09:00 - 10:59
springer,2012-12-27,11,23,80,103,2114,11:00 - 12:59
springer,2012-12-27,12,22,87,109,2114,11:00 - 12:59
springer,2012-12-27,13,19,99,118,2114,13:00 - 14:59
springer,2012-12-27,14,25,94,119,2114,13:00 - 14:59
springer,2012-12-27,15,31,89,120,2114,15:00 - 16:59
springer,2012-12-27,16,23,151,174,2114,15:00 - 16:59
springer,2012-12-27,17,30,227,257,2114,17:00 - 18:59
springer,2012-12-27,18,9,188,197,2114,17:00 - 18:59
springer,2012-12-27,19,11,106,117,2114,19:00 - 20:59
springer,2012-12-27,20,12,79,91,2114,19:00 - 20:59
springer,2012-12-27,21,12,51,63,2114,21:00 - 22:59
springer,2012-12-27,22,11,33,44,2114,21:00 - 22:59
springer,2012-12-27,23,2,24,26,2114,23:00 - 24:59
springer,2012-12-28,0,3,22,25,3095,
springer,2012-12-28,1,0,9,9,3095,01:00 - 02:59
springer,2012-12-28,2,0,5,5,3095,01:00 - 02:59
springer,2012-12-28,3,0,2,2,3095,03:00 - 04:59
springer,2012-12-28,4,0,4,4,3095,03:00 - 04:59
springer,2012-12-28,5,0,15,15,3095,05:00 - 06:59
springer,2012-12-28,6,2,49,51,3095,05:00 - 06:59
springer,2012-12-28,7,1,111,112,3095,07:00 - 08:59
springer,2012-12-28,8,1,238,239,3095,07:00 - 08:59
springer,2012-12-28,9,18,173,191,3095,09:00 - 10:59
springer,2012-12-28,10,77,85,162,3095,09:00 - 10:59
springer,2012-12-28,11,71,107,178,3095,11:00 - 12:59
springer,2012-12-28,12,72,150,222,3095,11:00 - 12:59
springer,2012-12-28,13,76,146,222,3095,13:00 - 14:59
springer,2012-12-28,14,84,177,261,3095,13:00 - 14:59
springer,2012-12-28,15,74,151,225,3095,15:00 - 16:59
springer,2012-12-28,16,42,208,250,3095,15:00 - 16:59
springer,2012-12-28,17,43,228,271,3095,17:00 - 18:59
springer,2012-12-28,18,16,197,213,3095,17:00 - 18:59
springer,2012-12-28,19,15,113,128,3095,19:00 - 20:59
springer,2012-12-28,20,14,83,97,3095,19:00 - 20:59
springer,2012-12-28,21,17,75,92,3095,21:00 - 22:59
springer,2012-12-28,22,13,49,62,3095,21:00 - 22:59
springer,2012-12-28,23,5,54,59,3095,23:00 - 24:59
springer,2012-12-29,0,1,25,26,1341,
springer,2012-12-29,1,6,31,37,1341,01:00 - 02:59
springer,2012-12-29,2,1,18,19,1341,01:00 - 02:59
springer,2012-12-29,3,1,5,6,1341,03:00 - 04:59
springer,2012-12-29,4,0,3,3,1341,03:00 - 04:59
springer,2012-12-29,5,0,3,3,1341,05:00 - 06:59
springer,2012-12-29,6,0,7,7,1341,05:00 - 06:59
springer,2012-12-29,7,1,17,18,1341,07:00 - 08:59
springer,2012-12-29,8,9,35,44,1341,07:00 - 08:59
springer,2012-12-29,9,16,33,49,1341,09:00 - 10:59
springer,2012-12-29,10,6,35,41,1341,09:00 - 10:59
springer,2012-12-29,11,7,38,45,1341,11:00 - 12:59
springer,2012-12-29,12,5,43,48,1341,11:00 - 12:59
springer,2012-12-29,13,13,71,84,1341,13:00 - 14:59
springer,2012-12-29,14,10,88,98,1341,13:00 - 14:59
springer,2012-12-29,15,19,110,129,1341,15:00 - 16:59
springer,2012-12-29,16,22,125,147,1341,15:00 - 16:59
springer,2012-12-29,17,18,100,118,1341,17:00 - 18:59
springer,2012-12-29,18,8,102,110,1341,17:00 - 18:59
springer,2012-12-29,19,7,90,97,1341,19:00 - 20:59
springer,2012-12-29,20,2,64,66,1341,19:00 - 20:59
springer,2012-12-29,21,4,56,60,1341,21:00 - 22:59
springer,2012-12-29,22,3,51,54,1341,21:00 - 22:59
springer,2012-12-29,23,0,32,32,1341,23:00 - 24:59
springer,2012-12-30,0,0,41,41,1796,
springer,2012-12-30,1,1,27,28,1796,01:00 - 02:59
springer,2012-12-30,2,0,19,19,1796,01:00 - 02:59
springer,2012-12-30,3,1,14,15,1796,03:00 - 04:59
springer,2012-12-30,4,0,7,7,1796,03:00 - 04:59
springer,2012-12-30,5,0,2,2,1796,05:00 - 06:59
springer,2012-12-30,6,1,7,8,1796,05:00 - 06:59
springer,2012-12-30,7,0,13,13,1796,07:00 - 08:59
springer,2012-12-30,8,1,32,33,1796,07:00 - 08:59
springer,2012-12-30,9,9,65,74,1796,09:00 - 10:59
springer,2012-12-30,10,31,91,122,1796,09:00 - 10:59
springer,2012-12-30,11,33,103,136,1796,11:00 - 12:59
springer,2012-12-30,12,47,97,144,1796,11:00 - 12:59
springer,2012-12-30,13,49,120,169,1796,13:00 - 14:59
springer,2012-12-30,14,39,121,160,1796,13:00 - 14:59
springer,2012-12-30,15,37,101,138,1796,15:00 - 16:59
springer,2012-12-30,16,31,102,133,1796,15:00 - 16:59
springer,2012-12-30,17,26,97,123,1796,17:00 - 18:59
springer,2012-12-30,18,12,113,125,1796,17:00 - 18:59
springer,2012-12-30,19,16,86,102,1796,19:00 - 20:59
springer,2012-12-30,20,9,63,72,1796,19:00 - 20:59
springer,2012-12-30,21,5,42,47,1796,21:00 - 22:59
springer,2012-12-30,22,6,30,36,1796,21:00 - 22:59
springer,2012-12-30,23,10,39,49,1796,23:00 - 24:59
springer,2012-12-31,0,4,30,34,2729,
springer,2012-12-31,1,6,13,19,2729,01:00 - 02:59
springer,2012-12-31,2,3,8,11,2729,01:00 - 02:59
springer,2012-12-31,3,0,1,1,2729,03:00 - 04:59
springer,2012-12-31,4,0,3,3,2729,03:00 - 04:59
springer,2012-12-31,5,0,9,9,2729,05:00 - 06:59
springer,2012-12-31,6,0,40,40,2729,05:00 - 06:59
springer,2012-12-31,7,2,83,85,2729,07:00 - 08:59
springer,2012-12-31,8,9,187,196,2729,07:00 - 08:59
springer,2012-12-31,9,13,144,157,2729,09:00 - 10:59
springer,2012-12-31,10,33,87,120,2729,09:00 - 10:59
springer,2012-12-31,11,43,114,157,2729,11:00 - 12:59
springer,2012-12-31,12,52,172,224,2729,11:00 - 12:59
springer,2012-12-31,13,38,165,203,2729,13:00 - 14:59
springer,2012-12-31,14,62,185,247,2729,13:00 - 14:59
springer,2012-12-31,15,69,246,315,2729,15:00 - 16:59
springer,2012-12-31,16,30,184,214,2729,15:00 - 16:59
springer,2012-12-31,17,14,150,164,2729,17:00 - 18:59
springer,2012-12-31,18,10,112,122,2729,17:00 - 18:59
springer,2012-12-31,19,11,108,119,2729,19:00 - 20:59
springer,2012-12-31,20,8,81,89,2729,19:00 - 20:59
springer,2012-12-31,21,7,83,90,2729,21:00 - 22:59
springer,2012-12-31,22,13,48,61,2729,21:00 - 22:59
springer,2012-12-31,23,12,37,49,2729,23:00 - 24:59
